,host_name,neighbourhood_group,room_type,price,availability_365,reviews_per_month,Hotel_value
0,John,2,Private room,149,365,0.21,514
1,Jennifer,1,Entire home/apt,225,355,0.38,580
3,LisaRoxanne,2,Entire home/apt,89,194,4.64,283
4,Laura,1,Entire home/apt,80,0,0.1,80
5,Chris,1,Entire home/apt,200,129,0.59,329
6,Garon,2,Private room,60,0,0.4,60
7,Shunichi,1,Private room,79,220,3.47,299
8,MaryEllen,1,Private room,79,0,0.99,79
9,Ben,1,Entire home/apt,150,188,1.33,338
10,Lena,1,Entire home/apt,135,6,0.43,141
11,Kate,1,Private room,85,39,1.5,124
12,Laurie,2,Private room,89,314,1.34,403
13,Claudio,1,Private room,85,333,0.91,418
14,Alina,1,Entire home/apt,120,0,0.22,120
15,Allen & Irina,2,Entire home/apt,140,46,1.2,186
16,Jane,2,Entire home/apt,215,321,1.72,536
17,Doti,1,Private room,140,12,2.12,152
18,Adam And Charity,2,Entire home/apt,99,21,4.44,120
20,Chaya,2,Entire home/apt,299,0,0.07,299
21,Lisel,2,Private room,130,347,1.09,477
22,Lisel,2,Private room,80,364,0.37,444
23,Lisel,2,Private room,110,304,0.61,414
24,Nathalie,2,Entire home/apt,120,233,0.73,353
25,Gregory,2,Private room,60,85,1.37,145
27,Tommi,1,Entire home/apt,150,75,0.49,225
28,Shon,1,Private room,44,311,1.11,355
29,Dana,1,Entire home/apt,180,67,0.24,247
30,Ssameer Or Trip,1,Private room,50,355,2.04,405
31,Teri,1,Private room,52,255,1.42,307
32,Andrea,2,Private room,55,284,1.65,339
33,Ssameer Or Trip,1,Private room,50,359,2.37,409
34,Angela,2,Private room,70,269,0.66,339
35,Laurie,2,Private room,89,340,1.41,429
37,Tyrome,2,Entire home/apt,85,22,1.96,107
39,Ben,1,Shared room,40,188,1.81,228
40,Edward,1,Private room,68,96,2.08,164
41,Abdul,2,Entire home/apt,120,345,0.39,465
42,Yolande,2,Private room,120,311,0.23,431
43,Cyn,1,Private room,135,273,0.69,408
44,Earl,1,Entire home/apt,150,309,0.84,459
45,Rana,2,Entire home/apt,150,95,0.49,245
46,Orestes,3,Private room,130,215,2.25,345
47,Adreinne,2,Entire home/apt,110,265,0.52,375
48,Jennifer,2,Entire home/apt,115,0,0.1,115
49,Alexander,2,Private room,80,192,1.16,272
50,JT And Tiziana,2,Private room,80,251,1.01,331
51,Joya,1,Entire home/apt,151,302,0.63,453
52,James,2,Entire home/apt,228,140,0.7,368
53,Jeanne,2,Entire home/apt,144,234,2.82,378
54,Francesca,1,Entire home/apt,200,257,0.22,457
55,Joanna,2,Entire home/apt,150,30,0.9,180
56,Bianca,1,Private room,110,301,0.17,411
57,Luiz,1,Private room,69,294,2.49,363
58,Andrea,2,Private room,49,320,1.19,369
59,Ted,1,Entire home/apt,180,154,0.3,334
60,Cristina,2,Private room,80,263,0.38,343
61,Petra,1,Entire home/apt,375,180,0.12,555
62,D,1,Entire home/apt,250,231,0.57,481
63,Dimitri,2,Entire home/apt,200,297,1.33,497
64,Patricia,2,Private room,55,292,0.23,347
65,Mark,1,Private room,52,191,1.65,243
66,Sara,2,Entire home/apt,225,0,0.16,225
67,Reka,1,Private room,80,72,4.72,152
68,Daniel,2,Entire home/apt,275,362,1.4,637
69,Casey,1,Private room,99,336,1.26,435
70,Robin,1,Entire home/apt,225,215,1.64,440
71,Anna,1,Entire home/apt,230,116,0.43,346
72,Enzo,1,Private room,51,88,0.43,139
73,Tye And Etienne,1,Private room,65,336,1.6,401
74,George,2,Private room,105,304,0.92,409
75,Josh,1,Entire home/apt,190,224,0.2,414
76,Victoria,1,Private room,200,322,1.5,522
77,Justin,3,Private room,70,324,0.22,394
78,Blaise,2,Private room,95,132,1.28,227
79,DAVID And RICK,1,Private room,150,295,1.65,445
80,Lulú,2,Private room,145,238,0.54,383
81,Sybilla,1,Entire home/apt,110,209,0.49,319
82,JoLynn,1,Entire home/apt,285,328,0.62,613
83,Gaia,2,Entire home/apt,130,38,0.15,168
84,Ana,1,Private room,94,188,0.84,282
85,Maggie,2,Entire home/apt,800,7,0.24,807
86,Starlee,2,Entire home/apt,105,272,0.53,377
87,Edward,1,Private room,60,26,1.73,86
88,Pas,1,Private room,50,0,0.05,50
89,Lulú,2,Private room,85,288,1.54,373
90,Augustin,2,Private room,65,317,0.28,382
91,Sean & Lynette,2,Entire home/apt,131,207,3.4,338
92,Erica,2,Private room,98,185,0.2,283
93,Tracy,2,Entire home/apt,250,158,0.3,408
94,Christiana,2,Entire home/apt,100,0,1.57,100
95,Tyrome,2,Entire home/apt,105,9,1.05,114
96,Dana,1,Entire home/apt,140,198,0.71,338
97,Elliott,1,Private room,89,365,0.11,454
98,Olan,1,Private room,98,364,0.27,462
99,Shelly,2,Entire home/apt,125,311,1.23,436
100,Ssameer Or Trip,1,Private room,60,219,0.87,279
101,Annette,2,Entire home/apt,175,342,2.09,517
102,Meka,1,Private room,65,312,0.6,377
103,Ann,1,Entire home/apt,500,243,0.55,743
104,Seth,2,Private room,101,152,3.02,253
105,Brenda,2,Entire home/apt,220,9,0.79,229
106,Shelly,2,Entire home/apt,125,137,1.46,262
107,Erik,2,Entire home/apt,80,222,0.4,302
108,Dena,1,Private room,100,346,1.61,446
109,Jessica,2,Entire home/apt,200,208,0.2,408
110,Luiz,1,Private room,59,279,3.0,338
111,Erica,2,Private room,125,250,0.2,375
112,Sally,1,Entire home/apt,140,164,0.13,304
113,Dani,2,Entire home/apt,120,192,4.22,312
114,Bruce,1,Entire home/apt,350,298,0.06,648
115,Nimo,1,Entire home/apt,199,260,0.38,459
116,Alexandra,2,Entire home/apt,325,107,3.01,432
117,Stacy,1,Entire home/apt,235,199,0.27,434
118,Bruce,1,Entire home/apt,225,299,1.05,524
119,Evelyn,2,Private room,99,20,3.2,119
120,Emma,1,Entire home/apt,170,318,2.03,488
121,Vero,2,Entire home/apt,400,216,0.24,616
122,Sylvie,1,Entire home/apt,170,224,0.12,394
123,Jen,1,Entire home/apt,100,0,0.23,100
124,Kay,2,Private room,75,324,0.08,399
125,Jo,2,Private room,90,245,0.08,335
126,Lisa,1,Entire home/apt,150,189,0.19,339
127,Fernando And Lenin,1,Private room,85,307,0.33,392
128,Angela,2,Private room,70,310,0.58,380
129,Laurine,1,Entire home/apt,120,213,1.42,333
130,Chris,2,Private room,89,278,2.35,367
131,Uli,1,Entire home/apt,185,209,0.66,394
132,Sol,2,Private room,50,0,1.86,50
133,Cs,1,Entire home/apt,105,16,0.29,121
134,Lara,1,Private room,130,234,0.45,364
135,Tom,1,Entire home/apt,115,12,0.25,127
136,Sunder,2,Private room,77,178,0.02,255
137,Waldemar,2,Private room,76,275,3.89,351
138,Khem,2,Entire home/apt,125,163,2.09,288
139,Sahr,2,Private room,135,365,0.77,500
140,Ali+Scott,2,Entire home/apt,250,34,0.03,284
141,Elisabeth,2,Entire home/apt,199,280,0.1,479
142,Sarah,2,Entire home/apt,140,0,0.04,140
143,Fredah,3,Private room,140,1,0.01,141
144,Khem,2,Entire home/apt,115,170,1.72,285
145,Katherine,2,Entire home/apt,160,188,0.11,348
146,Ming,2,Entire home/apt,195,214,2.19,409
147,Paula,1,Entire home/apt,195,248,0.28,443
148,Lulú,2,Private room,80,262,1.86,342
149,Obed,2,Private room,44,280,1.05,324
150,Karen,1,Private room,156,307,0.74,463
151,Michael,2,Private room,85,339,0.09,424
152,White,2,Private room,125,1,1.61,126
153,Paz,2,Entire home/apt,115,269,0.05,384
154,Irene,1,Private room,69,10,0.32,79
155,Karene,1,Entire home/apt,225,312,1.24,537
156,Viviana,2,Entire home/apt,125,189,0.25,314
157,Sara,1,Entire home/apt,219,290,1.16,509
158,Sarah,2,Entire home/apt,475,230,0.27,705
159,Marie,1,Entire home/apt,99,164,2.6,263
160,Gus,2,Private room,69,53,1.86,122
161,Myung,3,Private room,79,126,0.26,205
162,Renée,2,Entire home/apt,135,3,2.86,138
163,Henry,2,Private room,250,189,0.13,439
164,Sylvia,1,Entire home/apt,250,365,0.08,615
165,Syl,2,Entire home/apt,250,0,2.17,250
166,Lorenzo,1,Entire home/apt,80,0,0.04,80
167,Waldemar,2,Private room,70,336,3.47,406
168,Annette,2,Entire home/apt,165,342,1.4,507
169,Newyorkroomwithaview,5,Private room,70,312,1.66,382
170,Tessa,2,Private room,50,37,0.94,87
171,Waundell,4,Private room,40,353,2.04,393
172,Young,2,Entire home/apt,150,177,1.78,327
173,Bruce,1,Private room,125,310,0.78,435
174,Coral,1,Entire home/apt,196,0,1.06,196
175,Carol,2,Private room,110,321,2.0,431
176,Sara,1,Entire home/apt,170,246,0.8,416
177,Laurine,1,Entire home/apt,165,231,0.75,396
178,Myrna,1,Entire home/apt,150,225,0.36,375
179,Campbell,1,Entire home/apt,100,0,1.79,100
180,Doug,2,Private room,65,0,1.92,65
181,Mark,3,Entire home/apt,350,365,0.11,715
182,Rahul,1,Private room,99,233,1.18,332
183,Miyoung,2,Entire home/apt,200,1,0.58,201
184,Monica,2,Entire home/apt,150,18,0.5,168
185,Marylyn,2,Private room,90,343,1.17,433
186,Kathleen R.,2,Private room,120,250,0.48,370
187,Teresa,1,Private room,75,326,1.85,401
188,Robert,2,Entire home/apt,175,364,0.29,539
189,Alex,1,Entire home/apt,125,0,0.03,125
190,Claudia,1,Entire home/apt,275,299,0.38,574
191,Shane,1,Entire home/apt,299,207,1.04,506
192,Laurie,2,Entire home/apt,135,162,1.43,297
194,Erina,1,Private room,83,7,2.69,90
195,Lee,1,Private room,123,328,3.52,451
196,Jullett,3,Private room,55,365,0.49,420
197,Marlaine,1,Entire home/apt,195,0,1.01,195
198,Charlotte,2,Private room,80,0,0.48,80
199,Mark,3,Entire home/apt,98,240,0.31,338
200,Mark,3,Private room,140,365,0.06,505
201,Mark,3,Entire home/apt,265,365,0.38,630
202,Bob,2,Entire home/apt,249,164,3.44,413
203,Anka,1,Shared room,105,363,0.09,468
205,Kathleen R.,2,Private room,100,250,2.12,350
206,Wayne,1,Entire home/apt,121,247,1.0,368
207,Waundell,4,Private room,45,323,1.45,368
208,Jenny,1,Private room,100,192,1.92,292
209,Paul,2,Entire home/apt,140,125,3.04,265
210,Tami,2,Private room,71,91,0.22,162
211,Jason,1,Private room,130,75,1.17,205
212,Pete,1,Entire home/apt,199,286,1.22,485
213,Gus,2,Private room,69,60,1.13,129
214,Sally,2,Private room,68,0,0.35,68
215,Leonardo,1,Entire home/apt,130,192,2.04,322
216,Alex,2,Entire home/apt,195,58,0.65,253
217,Wayne,1,Private room,64,245,1.84,309
218,Vasili,3,Entire home/apt,140,292,0.16,432
219,S.M.,2,Entire home/apt,159,279,2.12,438
220,Ori,1,Entire home/apt,189,0,1.96,189
221,Ana,1,Entire home/apt,250,3,0.96,253
222,I,1,Entire home/apt,239,351,0.07,590
223,R,1,Entire home/apt,305,201,1.09,506
224,Simon,1,Entire home/apt,155,232,2.1,387
225,Agnes,1,Private room,60,258,4.58,318
226,Linda,2,Private room,135,272,0.26,407
227,Dave,1,Private room,120,341,0.3,461
228,Drica,1,Entire home/apt,150,244,0.39,394
229,Mark,3,Entire home/apt,140,365,0.01,505
230,Betty,2,Entire home/apt,135,12,0.67,147
231,Ricardo & Ashlie,1,Entire home/apt,250,265,0.18,515
232,Leslie,1,Entire home/apt,250,0,0.78,250
233,Harrison,1,Entire home/apt,500,329,0.99,829
234,Jessica,1,Entire home/apt,225,91,0.1,316
235,Blanca,1,Entire home/apt,125,365,1.83,490
236,Wayne,1,Private room,92,253,1.82,345
237,Cynthia,1,Private room,175,365,0.11,540
238,Mich,1,Entire home/apt,99,320,1.22,419
239,Rachel,1,Entire home/apt,195,0,0.04,195
240,Laurine,1,Entire home/apt,140,192,1.3,332
241,Greta,1,Entire home/apt,135,0,0.2,135
242,Frank,1,Entire home/apt,500,348,0.34,848
243,Bethania,1,Private room,80,0,2.21,80
244,Tunji,1,Private room,120,353,1.8,473
245,Anna/Fonzy,1,Entire home/apt,110,140,0.9,250
246,Colette&Sean,2,Entire home/apt,65,2,2.3,67
247,Brie,1,Entire home/apt,130,56,0.58,186
248,Sheila,2,Entire home/apt,99,68,2.13,167
249,Lissette,5,Private room,36,360,1.85,396
250,Lissette,5,Private room,37,0,1.44,37
251,Lissette,5,Private room,37,320,1.71,357
252,Olivia,1,Entire home/apt,175,326,1.78,501
253,Daniel,1,Entire home/apt,205,76,0.7,281
254,Maya,2,Entire home/apt,285,279,1.22,564
255,Scott,2,Private room,59,15,1.77,74
256,Lissette,5,Private room,36,340,3.19,376
257,Dennis & Naoko,3,Entire home/apt,99,226,4.5,325
258,Antonín,2,Private room,39,365,0.46,404
259,Emily,2,Private room,60,0,0.09,60
261,Vie,4,Entire home/apt,105,365,0.5,470
262,Renée,2,Entire home/apt,135,11,2.39,146
263,Olivia,1,Entire home/apt,390,316,1.38,706
264,Helene,2,Private room,70,281,0.41,351
266,Kristian & Di,2,Private room,60,362,0.14,422
268,Niya,2,Private room,100,301,2.69,401
269,Helene,2,Private room,70,189,0.22,259
270,Debbie,2,Private room,110,0,3.55,110
271,Anthony,2,Private room,60,287,2.27,347
272,Tilly,1,Entire home/apt,90,14,0.16,104
273,Edward,1,Private room,68,86,1.96,154
274,Claire,1,Entire home/apt,115,261,2.1,376
275,Juhli,2,Private room,75,68,0.67,143
277,Mary D,1,Entire home/apt,129,231,0.15,360
278,Valerie,2,Entire home/apt,130,152,0.48,282
279,Larissa,2,Entire home/apt,95,46,1.27,141
280,Eric,1,Private room,75,364,0.26,439
281,Jessica,2,Entire home/apt,175,246,0.11,421
282,Melissa,2,Entire home/apt,190,288,0.57,478
283,Alex,2,Private room,49,331,0.15,380
284,Samir,1,Entire home/apt,212,51,1.31,263
285,Tony,1,Private room,95,364,1.11,459
286,Luis Fernando,2,Entire home/apt,140,254,0.11,394
287,Henning,1,Entire home/apt,135,189,1.87,324
288,Stefano,2,Entire home/apt,150,263,2.08,413
289,Jana,2,Entire home/apt,190,258,0.79,448
290,Per,1,Entire home/apt,124,103,0.26,227
291,Adrienne,2,Entire home/apt,135,42,0.56,177
292,Elise,1,Private room,122,246,0.93,368
293,Deda,1,Private room,109,364,1.05,473
294,Share,1,Private room,85,318,0.68,403
295,Naimah,2,Entire home/apt,145,72,1.25,217
296,Violetta,1,Entire home/apt,195,249,0.32,444
297,Jenna,2,Entire home/apt,250,272,1.34,522
298,Jason,2,Private room,125,325,0.1,450
299,Alicia,1,Entire home/apt,575,298,1.88,873
300,Silvia,1,Entire home/apt,150,35,0.55,185
301,Joab,2,Private room,70,203,0.49,273
302,Mary And Geoff,1,Private room,90,132,1.27,222
303,Eyal,1,Private room,65,5,0.63,70
304,Bruce,1,Entire home/apt,500,297,0.48,797
305,Kurt,1,Entire home/apt,250,276,0.43,526
306,Jennifer,1,Entire home/apt,125,102,0.42,227
307,Ruperto,1,Entire home/apt,200,251,0.44,451
308,Ben,2,Entire home/apt,229,188,0.5,417
309,Thai,4,Entire home/apt,90,346,0.35,436
310,Hudson,1,Entire home/apt,110,0,0.39,110
311,Vanessa,2,Private room,59,15,0.36,74
312,Daniel,2,Entire home/apt,195,71,0.6,266
313,Patty,2,Entire home/apt,169,215,0.67,384
314,Amir,1,Entire home/apt,113,253,0.27,366
315,G & S,1,Entire home/apt,250,78,0.31,328
316,Nazleen,3,Entire home/apt,115,257,2.01,372
317,Allison,2,Private room,55,0,0.01,55
318,Scott,2,Private room,69,8,2.17,77
319,Patricia,1,Entire home/apt,150,191,2.81,341
320,Evelyn,2,Entire home/apt,169,182,3.97,351
321,The Box House Hotel,2,Private room,179,79,0.36,258
322,Moss Owen,1,Private room,150,49,0.36,199
323,Nancy,2,Entire home/apt,135,0,0.1,135
324,Bliss,2,Entire home/apt,350,156,0.3,506
325,Pam,2,Private room,120,343,0.76,463
326,Jennifer,1,Private room,71,200,1.81,271
327,The Box House Hotel,2,Private room,349,60,0.09,409
328,The Box House Hotel,2,Private room,349,60,0.07,409
329,Ellis,2,Entire home/apt,165,189,0.51,354
330,The Box House Hotel,2,Private room,249,60,0.02,309
331,Christopher,2,Private room,100,0,0.68,100
332,Christopher,2,Entire home/apt,200,106,0.85,306
333,Sarah,1,Entire home/apt,169,276,2.4,445
334,Ruthven,2,Entire home/apt,185,248,1.07,433
335,Julian,2,Entire home/apt,65,194,2.27,259
336,Leslie,2,Entire home/apt,130,135,0.05,265
337,Sophie,2,Entire home/apt,199,30,0.11,229
338,Yvette,1,Entire home/apt,225,0,0.33,225
339,The Box House Hotel,2,Private room,179,81,0.14,260
340,Famous,2,Entire home/apt,150,0,0.05,150
341,Kyle,1,Entire home/apt,139,142,3.88,281
342,Ange,1,Private room,95,60,2.22,155
343,Alex,2,Entire home/apt,79,179,0.11,258
344,T,1,Entire home/apt,150,52,1.51,202
346,Marylyn,2,Entire home/apt,90,324,2.26,414
347,Nathalie,2,Entire home/apt,120,237,0.76,357
348,Savannah,3,Private room,80,365,1.21,445
350,Jason,2,Entire home/apt,175,204,3.74,379
351,Keishera,2,Entire home/apt,120,272,1.04,392
352,Tessa,2,Entire home/apt,140,0,0.13,140
353,Eduardo,2,Entire home/apt,200,9,0.07,209
354,Sahr,2,Private room,165,365,0.11,530
355,Shon,1,Entire home/apt,125,181,0.01,306
356,Peter Michael,1,Entire home/apt,130,189,0.19,319
357,Liz And Melissa,1,Shared room,65,0,1.31,65
358,Wanda,2,Entire home/apt,123,189,0.15,312
359,Giorgio,1,Private room,67,296,1.37,363
361,Mi,2,Entire home/apt,130,35,0.99,165
362,Lee And Tara,2,Private room,100,0,0.31,100
363,Chas,1,Entire home/apt,212,35,0.46,247
364,Ade,2,Entire home/apt,190,359,1.76,549
365,The Box House Hotel,2,Private room,599,60,0.09,659
366,Jason,1,Entire home/apt,249,365,1.68,614
367,Michelle,3,Private room,70,335,0.13,405
368,Alex,2,Entire home/apt,100,282,0.16,382
369,Alicia,1,Private room,60,247,3.83,307
370,Olivia,2,Entire home/apt,135,102,0.87,237
371,Maya,2,Entire home/apt,175,274,2.53,449
372,Kai,1,Entire home/apt,120,201,0.56,321
373,Driss,1,Entire home/apt,169,98,0.57,267
374,Marine,2,Entire home/apt,165,157,0.03,322
375,Kelli,1,Private room,90,0,0.02,90
376,Olivia,1,Entire home/apt,225,312,0.57,537
377,Carol,2,Private room,95,331,1.66,426
378,Anthony,2,Private room,55,275,2.51,330
379,Natalia,1,Private room,85,174,1.17,259
380,Susi,2,Entire home/apt,199,223,0.28,422
381,Tony,1,Entire home/apt,211,361,0.6,572
382,Andrey,1,Entire home/apt,145,0,0.4,145
383,Jane,1,Private room,65,283,0.35,348
384,Will,1,Entire home/apt,99,220,3.23,319
385,Lilly,3,Entire home/apt,110,363,0.32,473
386,Marylyn,2,Entire home/apt,80,315,2.27,395
387,LuLu,2,Entire home/apt,150,281,0.96,431
388,Roberta,2,Entire home/apt,110,283,0.75,393
389,Paul,1,Private room,290,20,0.36,310
391,Itamar,2,Entire home/apt,190,331,0.51,521
392,Vikram,2,Entire home/apt,200,36,0.31,236
393,Elizabeth,2,Entire home/apt,165,7,0.23,172
394,Christopher,1,Entire home/apt,110,301,1.44,411
395,Justin,1,Entire home/apt,395,170,0.73,565
396,Rodney,2,Private room,99,307,0.54,406
397,Antonín,2,Private room,39,365,0.94,404
398,Seith,1,Entire home/apt,189,201,4.1,390
399,Eric,1,Private room,85,0,0.03,85
400,Katharine,2,Entire home/apt,260,316,0.03,576
401,Wayne,1,Entire home/apt,122,271,1.18,393
402,Lauren,2,Entire home/apt,165,139,1.79,304
403,Jean,3,Entire home/apt,97,209,1.21,306
404,Catherine,1,Entire home/apt,170,0,0.25,170
405,Holly,2,Entire home/apt,125,0,0.15,125
406,Tracy,1,Private room,130,193,1.07,323
407,Giovanni,2,Entire home/apt,225,52,0.38,277
408,Karen,2,Private room,50,136,2.69,186
409,Christopher,2,Entire home/apt,170,286,0.91,456
410,Jeff,1,Entire home/apt,132,0,0.1,132
411,Irena,2,Entire home/apt,250,18,0.21,268
412,Michael,2,Entire home/apt,141,9,0.21,150
413,Jessica,2,Entire home/apt,64,3,0.73,67
414,Daniel,2,Entire home/apt,249,277,1.55,526
415,Ivy,2,Private room,79,0,1.18,79
416,Dave,1,Entire home/apt,185,233,0.71,418
417,Mark,2,Entire home/apt,120,221,2.41,341
418,Orna,2,Entire home/apt,495,355,0.41,850
419,Allison,1,Entire home/apt,375,0,0.21,375
420,Vanessa,1,Entire home/apt,175,277,0.69,452
421,Josh,1,Entire home/apt,150,0,0.23,150
422,Rinaldo,1,Entire home/apt,259,343,0.17,602
423,Jonathan,1,Private room,96,0,0.58,96
424,Oliver,2,Entire home/apt,145,0,0.08,145
426,Carolyn,1,Entire home/apt,95,0,0.08,95
427,Meighan,2,Entire home/apt,250,188,0.72,438
428,Julie,1,Entire home/apt,295,264,0.76,559
429,John,1,Entire home/apt,175,0,0.19,175
430,Mihalis,2,Entire home/apt,451,331,0.86,782
431,B.,1,Entire home/apt,165,236,2.18,401
433,"Dee, Dre & Mama Shelley",4,Entire home/apt,77,309,2.49,386
434,Peter,1,Entire home/apt,250,0,0.2,250
435,Gladys & Bob,3,Entire home/apt,129,245,4.34,374
436,M,2,Private room,98,0,0.09,98
438,Ewelina,1,Private room,95,359,0.3,454
439,Wayne,1,Private room,55,333,1.22,388
440,William,1,Entire home/apt,300,258,2.14,558
441,Lucy,3,Private room,42,236,0.55,278
442,Pat,2,Entire home/apt,125,22,1.09,147
443,Donna,1,Private room,175,236,1.8,411
444,Kimberly,1,Private room,75,365,0.42,440
445,Meredith,2,Entire home/apt,255,89,0.5,344
446,Tokunbo,2,Entire home/apt,72,164,0.91,236
447,Fred,2,Private room,165,311,0.28,476
448,Laura,2,Entire home/apt,165,23,1.28,188
449,Pepe,2,Private room,75,365,0.44,440
450,Lennny & Megan,2,Entire home/apt,130,0,0.05,130
451,Amia,2,Entire home/apt,139,222,4.0,361
452,JT And Tiziana,2,Private room,88,238,0.68,326
453,JT And Tiziana,2,Private room,80,218,0.41,298
454,Kaye,1,Private room,150,0,1.79,150
455,Ligia,1,Entire home/apt,200,0,0.12,200
456,James,1,Entire home/apt,200,235,1.08,435
457,Lucy,3,Private room,42,246,0.43,288
458,Alain,2,Private room,90,0,0.03,90
459,"Robert ""Bob""",1,Entire home/apt,295,247,2.33,542
460,Andres,2,Entire home/apt,450,15,0.79,465
461,Placid,2,Entire home/apt,130,119,0.35,249
462,Jsun,2,Private room,89,0,2.31,89
463,Jorin,1,Entire home/apt,198,234,0.44,432
464,Seith,1,Entire home/apt,99,257,2.92,356
465,Andrea,2,Private room,46,350,0.89,396
466,Jade,1,Private room,140,221,0.56,361
467,Smadar,2,Entire home/apt,500,0,0.07,500
468,Rahul,1,Private room,75,201,0.59,276
469,Lucy,3,Private room,33,161,0.32,194
470,Giancarlo,1,Entire home/apt,250,259,1.94,509
471,Wanda,2,Private room,60,0,6.7,60
472,Yvette,1,Private room,75,222,0.35,297
473,Jilly,2,Entire home/apt,350,0,0.06,350
474,Daniel,1,Entire home/apt,205,76,0.04,281
475,Adam,2,Entire home/apt,219,0,0.03,219
476,Lisel,2,Private room,60,258,0.21,318
477,Barbara,1,Entire home/apt,185,14,1.33,199
478,Chris,1,Entire home/apt,190,27,1.6,217
479,Sara,2,Entire home/apt,105,167,1.06,272
480,Benton,1,Entire home/apt,250,68,0.12,318
481,Linda & Chris,1,Entire home/apt,175,358,0.12,533
482,Alec,1,Private room,65,59,0.43,124
483,Julia,2,Entire home/apt,75,0,1.09,75
484,Vanessa,4,Private room,37,232,1.21,269
485,Ali & SweetPea,2,Entire home/apt,85,15,0.89,100
487,Lena,1,Entire home/apt,79,0,0.16,79
488,Doug,2,Private room,85,161,0.55,246
489,Benton,1,Private room,170,88,0.18,258
490,Cheryl,1,Private room,115,337,0.04,452
491,Jorin,1,Private room,89,247,0.47,336
492,Lewis,1,Shared room,49,248,4.6,297
493,Jane,2,Private room,91,287,2.49,378
494,Donna,1,Entire home/apt,400,304,1.13,704
495,Kris,2,Entire home/apt,150,0,0.46,150
496,Henry,1,Entire home/apt,2000,0,0.33,2000
497,Jennifer,2,Entire home/apt,97,193,0.32,290
498,Cj,1,Private room,100,43,0.51,143
499,Dani,2,Entire home/apt,179,25,0.24,204
500,Sarah,2,Entire home/apt,500,127,0.21,627
501,Amit,1,Entire home/apt,429,0,0.9,429
502,Kathrine,1,Entire home/apt,189,303,0.95,492
503,Milan,1,Private room,120,345,1.04,465
504,Tony,1,Entire home/apt,300,115,0.06,415
505,Jason,3,Entire home/apt,107,200,0.22,307
506,Jason,3,Entire home/apt,95,271,0.26,366
507,Rosario,1,Entire home/apt,199,12,1.17,211
508,Mat,1,Entire home/apt,120,268,0.91,388
509,Mike,1,Entire home/apt,199,89,0.69,288
510,Christian & Carla,4,Entire home/apt,125,347,2.84,472
511,Obed,2,Private room,70,37,2.4,107
512,Lisa,2,Private room,75,0,1.55,75
513,Village,1,Private room,100,359,0.07,459
514,Andrew & Markus,2,Entire home/apt,99,287,1.97,386
515,Daniel,1,Entire home/apt,250,0,0.02,250
516,Mariana,2,Entire home/apt,350,233,0.02,583
517,Mj,2,Entire home/apt,170,129,0.7,299
518,Leslie,1,Entire home/apt,165,0,0.68,165
519,Michael,1,Private room,99,353,1.0,452
520,David,1,Private room,255,365,0.02,620
521,O'Dell,2,Entire home/apt,169,297,1.86,466
522,Sundiata,2,Entire home/apt,99,56,0.94,155
523,Marina,1,Entire home/apt,169,44,0.41,213
524,Farrah,2,Entire home/apt,160,355,0.44,515
525,Karen,2,Entire home/apt,215,156,0.35,371
526,Alan,2,Entire home/apt,130,273,2.02,403
527,Matthew,1,Private room,110,274,0.85,384
528,Marcela,1,Private room,150,258,0.45,408
529,Melody,2,Private room,65,276,0.54,341
530,Mike,3,Private room,75,65,1.68,140
531,Anastasia,1,Entire home/apt,149,0,0.27,149
532,Elina,1,Private room,89,180,0.37,269
533,Susan,1,Private room,50,343,2.35,393
534,Dennis,2,Private room,43,43,6.62,86
535,Dennis,2,Private room,42,96,0.84,138
536,Erika,2,Private room,85,59,0.97,144
537,Tim,2,Entire home/apt,139,255,1.19,394
538,Elizabeth,2,Private room,105,252,2.21,357
539,Vanessa,2,Entire home/apt,265,0,0.16,265
540,Vlad,1,Entire home/apt,149,20,1.29,169
541,Colin,1,Private room,68,188,3.9,256
542,Toni,2,Entire home/apt,99,304,2.18,403
543,Jabari,1,Private room,75,38,0.65,113
544,Susanne,2,Private room,100,254,2.85,354
546,Simone,1,Entire home/apt,160,46,0.26,206
547,Andrea,2,Entire home/apt,190,328,1.62,518
548,Kestrel,2,Private room,67,0,0.76,67
549,Elizabeth,1,Entire home/apt,190,0,0.08,190
550,Erica,2,Entire home/apt,248,199,0.61,447
551,Melanie,2,Private room,100,249,0.09,349
552,Ange,1,Private room,95,64,1.84,159
553,Welcome To My Place,1,Private room,150,111,7.14,261
554,Zora & Chris,2,Entire home/apt,145,287,1.29,432
555,Danielle,2,Private room,41,286,0.59,327
556,Tiffaney,2,Entire home/apt,120,263,0.99,383
557,Lori,4,Private room,50,276,2.7,326
558,Brett,2,Entire home/apt,157,0,0.18,157
559,Evan,2,Entire home/apt,195,263,0.33,458
560,Angus,2,Entire home/apt,70,90,1.34,160
561,Martina,2,Entire home/apt,185,0,0.15,185
562,Jameelah,2,Entire home/apt,145,11,0.32,156
563,Iulia,3,Private room,50,287,2.9,337
564,Maya,2,Entire home/apt,185,1,2.39,186
565,Goldi,1,Entire home/apt,250,0,0.65,250
566,Susan,1,Private room,80,338,0.2,418
567,Jeremy,1,Entire home/apt,230,44,1.88,274
568,Daniel,2,Entire home/apt,100,0,0.1,100
569,Meli,2,Private room,40,5,0.37,45
570,Nader,1,Private room,200,0,0.49,200
571,Carmel,5,Private room,80,158,0.05,238
572,Mary,2,Private room,79,192,1.6,271
573,Jason,3,Entire home/apt,95,358,0.25,453
574,Keenan & Emily,1,Entire home/apt,300,31,0.47,331
575,Samuel,2,Entire home/apt,100,241,0.08,341
576,Orlando,1,Private room,80,285,0.35,365
577,Yana,2,Entire home/apt,110,183,0.26,293
578,Pepe,2,Entire home/apt,172,189,0.09,361
579,Keera (Jena),1,Entire home/apt,199,162,0.31,361
580,Keera (Jena),1,Entire home/apt,199,158,0.15,357
581,Carmel,1,Private room,100,84,0.38,184
582,Boubacar And Pattee,1,Private room,55,260,1.04,315
583,Kestrel,2,Private room,75,0,0.62,75
584,Lisa,1,Entire home/apt,146,166,1.5,312
586,Deborah,2,Entire home/apt,116,335,0.23,451
587,Gershwyn,1,Private room,150,90,0.87,240
588,Lisel,2,Private room,120,342,0.24,462
589,Anton,1,Entire home/apt,199,28,0.34,227
590,Rosalynn,2,Entire home/apt,150,363,0.25,513
591,Deirdre,1,Private room,69,86,0.63,155
592,Deirdre,1,Private room,300,83,0.08,383
593,Stefania,2,Entire home/apt,230,0,0.21,230
594,Gaya,1,Entire home/apt,125,0,0.03,125
595,Mary,2,Private room,79,264,1.21,343
596,Christopher,2,Private room,130,305,1.63,435
597,Jessica,2,Private room,239,356,1.73,595
598,Marina,5,Entire home/apt,75,278,0.8,353
599,Ryan,2,Entire home/apt,220,135,1.23,355
600,Marylyn,2,Entire home/apt,80,308,2.47,388
601,Daniel,1,Entire home/apt,288,229,1.27,517
602,Lady Jay,2,Entire home/apt,135,273,0.87,408
603,Gordon,1,Entire home/apt,225,83,0.15,308
604,Raven,1,Private room,110,281,0.64,391
605,Marceline,2,Entire home/apt,100,321,1.87,421
606,Tim,1,Private room,130,303,0.55,433
607,Carol,1,Private room,89,192,2.95,281
608,Derrick,2,Entire home/apt,200,0,0.01,200
609,Civan,2,Entire home/apt,80,36,0.4,116
610,Lori,4,Private room,50,271,2.49,321
611,Blanca,1,Entire home/apt,135,341,1.21,476
612,Mark,1,Private room,90,333,1.15,423
613,Roberto,1,Private room,270,210,0.01,480
614,Dee,2,Entire home/apt,110,231,3.24,341
615,Selma,1,Entire home/apt,145,308,1.52,453
616,Michael,1,Entire home/apt,179,292,0.88,471
617,Melody,3,Private room,55,311,0.25,366
618,Tiffany,1,Private room,110,264,0.65,374
619,William,1,Entire home/apt,325,153,0.94,478
620,John,3,Private room,75,219,0.74,294
621,Bertie,2,Entire home/apt,300,0,0.44,300
622,Olan,1,Private room,130,332,0.86,462
623,Dan,1,Entire home/apt,190,120,1.45,310
624,Blue,1,Entire home/apt,200,191,1.06,391
625,Triny,2,Entire home/apt,180,248,1.36,428
626,Nick And Noémie,2,Entire home/apt,350,67,0.5,417
628,Liz,1,Entire home/apt,195,325,1.59,520
630,Ashley & Nir,1,Entire home/apt,300,0,0.03,300
631,Nancy,3,Entire home/apt,75,313,0.53,388
632,Austin,1,Entire home/apt,100,0,0.11,100
634,Li,2,Private room,85,69,1.32,154
635,Todd,2,Entire home/apt,80,0,0.12,80
636,Joseph,2,Private room,55,293,1.57,348
637,Jessica,2,Private room,438,363,0.46,801
638,Ruari,2,Entire home/apt,110,4,0.33,114
639,Mike,1,Entire home/apt,200,257,0.39,457
640,Jessica,2,Private room,279,362,1.28,641
641,Lauryn,2,Entire home/apt,137,0,0.29,137
642,Alon,2,Entire home/apt,280,365,0.05,645
643,Andy,2,Entire home/apt,199,102,2.59,301
644,Baron,1,Private room,71,26,2.45,97
645,Victor,4,Private room,42,302,1.36,344
646,Al-,2,Entire home/apt,180,280,1.92,460
647,Jaidev,1,Entire home/apt,226,302,0.39,528
648,Shelley,2,Private room,85,281,0.05,366
649,Jerry,1,Entire home/apt,135,0,0.06,135
650,Rafael,3,Entire home/apt,79,297,0.64,376
651,Jens,1,Entire home/apt,154,246,2.59,400
652,The Box House Hotel,2,Entire home/apt,199,60,0.37,259
653,West Village,1,Entire home/apt,700,296,1.4,996
654,Andy,1,Entire home/apt,246,0,0.16,246
655,Karina,1,Private room,125,364,0.06,489
656,Fred,2,Private room,100,281,0.08,381
657,Ben,2,Entire home/apt,295,0,3.04,295
659,Christy,1,Entire home/apt,119,0,0.58,119
660,Yvette,1,Private room,125,365,0.12,490
662,Rhona,1,Entire home/apt,850,249,1.15,1099
663,Anne,2,Private room,129,303,2.6,432
664,Carol,1,Private room,140,300,1.89,440
665,Tunji,1,Private room,115,323,1.63,438
666,Chris,1,Entire home/apt,200,0,0.53,200
667,Cynthia,2,Entire home/apt,96,204,0.14,300
668,The Box House Hotel,2,Entire home/apt,199,60,0.47,259
669,The Box House Hotel,2,Entire home/apt,199,84,0.32,283
670,The Box House Hotel,2,Entire home/apt,199,60,0.66,259
671,Olia,2,Private room,69,303,0.04,372
672,G,1,Entire home/apt,185,261,0.23,446
673,Cici,1,Private room,81,0,0.77,81
674,The Box House Hotel,2,Entire home/apt,199,60,0.26,259
675,The Box House Hotel,2,Entire home/apt,199,60,0.26,259
676,The Box House Hotel,2,Entire home/apt,199,60,0.47,259
677,The Box House Hotel,2,Entire home/apt,199,56,0.32,255
678,The Box House Hotel,2,Entire home/apt,199,84,0.44,283
679,The Box House Hotel,2,Private room,349,58,0.09,407
680,The Box House Hotel,2,Private room,249,60,0.03,309
681,The Box House Hotel,2,Private room,299,60,0.1,359
682,The Box House Hotel,2,Private room,179,81,0.05,260
683,Sharma,3,Private room,54,365,0.66,419
684,The Box House Hotel,2,Private room,599,60,0.08,659
685,Stephanie,2,Entire home/apt,110,0,0.03,110
686,Roger,2,Entire home/apt,220,297,2.69,517
687,Bree,2,Private room,89,91,0.8,180
688,Antonio,2,Entire home/apt,170,315,2.04,485
689,Claudia,1,Entire home/apt,495,338,0.27,833
690,Cristina,3,Entire home/apt,80,40,0.98,120
691,Janine,1,Entire home/apt,760,361,0.08,1121
692,Pamela,2,Private room,98,288,2.31,386
693,Jaime,2,Entire home/apt,125,218,0.33,343
694,Adolfo,2,Private room,48,1,0.57,49
695,Daniel,2,Private room,64,117,2.65,181
696,S,2,Entire home/apt,154,0,2.5,154
697,Annie,2,Entire home/apt,139,204,1.45,343
698,Kim,3,Private room,75,0,0.23,75
699,Chad,1,Entire home/apt,325,20,0.5,345
700,Andrea,1,Entire home/apt,195,0,0.12,195
701,Adrienne,1,Private room,58,0,2.83,58
702,Marina,5,Entire home/apt,250,333,0.26,583
704,Marina,5,Entire home/apt,125,353,0.09,478
705,Alexander,2,Entire home/apt,70,0,0.05,70
706,Ro,1,Entire home/apt,189,206,3.45,395
707,Christine,2,Entire home/apt,130,1,0.25,131
708,Keiko,1,Entire home/apt,145,0,0.12,145
709,Liah,1,Private room,101,307,0.55,408
710,Lindsey,1,Private room,95,0,0.33,95
711,Nadya,1,Entire home/apt,375,0,0.12,375
712,Lauren,1,Entire home/apt,153,27,0.63,180
713,Wade,2,Entire home/apt,92,27,0.62,119
714,Juliana,1,Private room,80,348,0.46,428
715,West Village,1,Entire home/apt,300,246,1.66,546
716,Marisa And Colin,2,Entire home/apt,145,15,1.2,160
717,Dominique,1,Private room,88,0,0.91,88
718,Nicole,1,Entire home/apt,155,5,0.18,160
719,Shaun,2,Entire home/apt,185,0,0.26,185
720,Joanne,3,Private room,73,0,1.02,73
721,C,1,Entire home/apt,225,107,1.41,332
722,Allan,1,Private room,85,144,1.84,229
723,Leo,2,Private room,99,98,0.59,197
724,Adolfo,2,Private room,48,0,0.27,48
725,Akiko,1,Entire home/apt,200,0,0.09,200
726,Sandra,1,Entire home/apt,485,0,0.12,485
727,Jen,1,Entire home/apt,310,89,0.09,399
729,Brian,1,Entire home/apt,109,286,0.39,395
730,Brian,1,Entire home/apt,167,252,0.17,419
731,Elena,2,Entire home/apt,147,189,0.12,336
733,Drew,1,Entire home/apt,195,271,0.77,466
734,Roberto  Mike,1,Entire home/apt,199,0,0.99,199
735,Fred,1,Private room,65,0,1.02,65
736,Jocelin,3,Private room,55,0,0.85,55
737,Clara,4,Private room,50,337,0.17,387
738,Janice,2,Private room,60,347,0.42,407
739,Vivianne,1,Private room,99,127,0.96,226
740,Eyal And Amy,1,Entire home/apt,130,41,0.42,171
741,Vishal,2,Entire home/apt,290,0,0.01,290
742,Sergio,1,Entire home/apt,350,18,0.7,368
743,Antoinette,2,Private room,50,158,0.33,208
744,M,3,Private room,96,270,2.74,366
745,Chavisa,2,Private room,45,88,0.29,133
746,Janina,3,Private room,85,306,2.95,391
747,Juliet,2,Private room,34,216,0.19,250
748,Cameron,1,Entire home/apt,250,16,0.26,266
749,Javier Pedraza,2,Private room,190,365,0.33,555
750,Javier Pedraza,2,Private room,75,365,0.06,440
751,Kevin,2,Entire home/apt,93,312,1.25,405
752,Lex,2,Private room,60,33,0.19,93
753,Lex,2,Private room,65,0,0.52,65
754,James,1,Entire home/apt,125,365,0.21,490
755,Max,1,Entire home/apt,300,27,0.08,327
756,Aj,1,Entire home/apt,150,300,2.22,450
757,Arthur,1,Entire home/apt,56,216,0.41,272
758,M,1,Entire home/apt,299,365,0.53,664
759,Diana,2,Private room,60,303,0.07,363
760,Valerie,2,Entire home/apt,88,0,0.08,88
761,Elizabeth,2,Private room,60,161,0.38,221
762,West Village,1,Entire home/apt,1300,297,0.31,1597
764,Stacia,1,Private room,99,50,0.88,149
765,Andrew,2,Entire home/apt,110,28,1.75,138
766,Aaron,2,Entire home/apt,135,317,0.13,452
767,Catherine,1,Entire home/apt,110,275,0.02,385
768,Kwab,2,Entire home/apt,165,80,2.31,245
769,Dena,2,Entire home/apt,127,365,0.03,492
770,Chauncey,2,Entire home/apt,402,340,0.97,742
771,Allan,1,Private room,85,97,1.42,182
772,Rosa,2,Private room,75,365,0.25,440
773,Jim,1,Entire home/apt,139,314,0.6,453
774,Michelle,2,Entire home/apt,70,0,0.63,70
775,Bia,1,Private room,50,339,2.32,389
776,Heidi,3,Private room,30,0,0.03,30
777,Cathryne,1,Entire home/apt,250,35,0.08,285
778,Ally,2,Private room,64,0,0.04,64
779,Erica,1,Entire home/apt,300,365,0.06,665
780,Gordy,2,Entire home/apt,800,257,1.37,1057
781,Naimah,2,Entire home/apt,100,5,0.72,105
782,Gabrielle,2,Entire home/apt,250,0,0.28,250
783,Vimal,1,Entire home/apt,200,0,0.01,200
784,Barbara,2,Entire home/apt,140,0,0.16,140
785,Tw,1,Private room,130,304,2.38,434
786,Dan,2,Entire home/apt,90,286,0.05,376
787,Lydia,1,Entire home/apt,90,0,1.17,90
788,Dian,2,Private room,97,118,1.57,215
789,Kate,2,Entire home/apt,91,265,0.76,356
790,Diana,2,Private room,125,303,2.52,428
792,Luis,1,Entire home/apt,180,125,0.26,305
794,Oz,2,Entire home/apt,100,6,0.06,106
795,Jose,1,Entire home/apt,175,0,0.23,175
796,Louisa,2,Private room,65,80,0.47,145
797,Dara,1,Entire home/apt,240,134,1.1,374
798,Jesper,1,Private room,300,0,0.01,300
799,Eric,1,Entire home/apt,385,364,0.71,749
800,Anamaria,2,Private room,47,0,0.06,47
801,Erika,2,Entire home/apt,110,297,2.6,407
802,Karin,1,Private room,75,0,1.1,75
803,Jameelah,2,Entire home/apt,100,43,0.23,143
804,Carey,1,Entire home/apt,165,10,0.82,175
805,Yvette,2,Entire home/apt,300,0,0.68,300
806,Keow,2,Entire home/apt,140,189,1.13,329
807,Olly,2,Entire home/apt,120,17,0.72,137
808,Hibo,2,Entire home/apt,175,289,0.4,464
809,Paul & Ewa,2,Entire home/apt,275,305,1.33,580
810,Jasmine,1,Entire home/apt,179,0,0.19,179
811,Michael,2,Entire home/apt,189,0,0.18,189
812,Max,1,Entire home/apt,219,220,1.42,439
813,Elle,1,Entire home/apt,450,0,1.71,450
814,Geoff,1,Entire home/apt,249,0,0.11,249
815,Ronaldo,3,Private room,65,362,0.06,427
816,Pia,2,Entire home/apt,250,121,0.52,371
817,Mikki & Bazi,1,Entire home/apt,139,153,0.41,292
818,Philip,1,Entire home/apt,209,205,0.16,414
819,Rohan,2,Entire home/apt,120,310,0.45,430
820,Natalia,3,Entire home/apt,70,0,0.03,70
821,Alejandra,1,Private room,90,236,2.38,326
822,Hubert,1,Entire home/apt,199,200,0.07,399
823,Urszula,2,Private room,50,74,0.19,124
826,Olly,2,Entire home/apt,157,12,0.66,169
827,The Box House Hotel,2,Entire home/apt,199,84,0.49,283
828,Carmen,3,Entire home/apt,192,0,0.08,192
829,The Box House Hotel,2,Entire home/apt,199,84,0.93,283
830,Irina,1,Entire home/apt,150,0,0.99,150
831,The Box House Hotel,2,Entire home/apt,199,56,0.84,255
832,The Box House Hotel,2,Entire home/apt,199,62,1.06,261
833,The Box House Hotel,2,Entire home/apt,199,81,0.26,280
834,Summer,2,Entire home/apt,105,0,0.16,105
835,Pam,2,Private room,135,310,1.12,445
836,The Box House Hotel,2,Entire home/apt,199,60,0.61,259
837,Marissa,2,Private room,125,0,0.19,125
838,Felicia,2,Private room,60,0,0.02,60
839,Ric,2,Entire home/apt,85,0,0.89,85
840,Alan,1,Entire home/apt,300,29,0.47,329
841,Todd,2,Private room,75,264,1.07,339
842,Weiwei,3,Private room,55,341,0.89,396
843,Glenn,2,Private room,44,0,0.09,44
844,Jacques,2,Private room,55,0,0.2,55
845,Brady,2,Private room,30,0,0.28,30
846,Alison,2,Private room,35,0,0.07,35
847,Sergio,2,Private room,70,363,0.05,433
848,Irina,2,Entire home/apt,130,25,0.25,155
849,Edward,2,Private room,52,0,1.12,52
852,L,1,Entire home/apt,250,109,1.69,359
853,Tom,2,Entire home/apt,100,289,1.39,389
854,Eliza,2,Entire home/apt,130,188,0.1,318
855,Ron,1,Private room,140,260,0.49,400
856,Alice,2,Private room,75,168,1.77,243
857,Dimitry,1,Entire home/apt,150,0,0.14,150
858,Ibrahima,1,Entire home/apt,90,311,0.57,401
860,Carolyn,1,Entire home/apt,150,2,0.13,152
861,Kristina,2,Entire home/apt,180,242,2.74,422
862,Tina,2,Private room,135,0,0.18,135
863,Oona,2,Private room,65,46,1.42,111
864,Ben,1,Private room,99,365,0.22,464
865,Magdalena,2,Private room,149,364,0.73,513
866,Jonathan,5,Private room,59,352,0.56,411
867,Kimberly,1,Private room,75,301,0.39,376
868,Kimberly,1,Private room,75,322,0.35,397
869,Mary,2,Private room,75,298,0.15,373
870,Brian,1,Entire home/apt,109,285,0.2,394
871,Karen,2,Entire home/apt,225,342,0.01,567
872,Junior,1,Private room,86,250,2.44,336
873,Richard,3,Private room,52,326,1.09,378
874,P,2,Private room,100,90,0.86,190
875,Ariel,1,Entire home/apt,99,289,0.34,388
876,Chris,1,Private room,89,193,1.52,282
877,Andrew & Markus,2,Entire home/apt,135,293,0.47,428
878,Sean And Kiana,1,Entire home/apt,199,155,0.73,354
879,Jane,2,Entire home/apt,89,189,0.71,278
880,Michael,1,Private room,110,248,0.57,358
881,Ana,2,Entire home/apt,120,238,0.48,358
882,Jason,2,Private room,59,284,2.29,343
883,Maria Luiza,2,Private room,49,343,0.81,392
884,Nora,2,Private room,79,268,0.25,347
885,Katy,1,Entire home/apt,135,249,0.28,384
886,Lillian,2,Entire home/apt,185,291,2.42,476
887,Fabiana,2,Entire home/apt,225,0,0.73,225
888,Erin,1,Entire home/apt,245,0,0.21,245
889,Candice,1,Entire home/apt,115,31,0.21,146
890,James,2,Entire home/apt,325,0,3.6,325
891,Todd,2,Private room,95,79,1.8,174
892,Amanda,1,Private room,120,0,1.22,120
893,Ted And Diane,1,Entire home/apt,499,157,0.72,656
894,Jason,2,Private room,75,277,2.44,352
895,S,1,Private room,109,353,0.94,462
896,Mathias,2,Entire home/apt,160,0,0.29,160
897,Sara,1,Entire home/apt,219,280,1.15,499
898,Nitzan,1,Entire home/apt,159,7,0.47,166
899,Erica,2,Private room,180,266,0.18,446
900,Esther,1,Entire home/apt,150,0,0.02,150
901,Jill,1,Entire home/apt,106,271,0.14,377
902,Robyn,1,Entire home/apt,299,101,0.27,400
903,Joseph,1,Entire home/apt,179,205,3.37,384
904,Duane,2,Entire home/apt,165,343,0.13,508
905,Marc,2,Entire home/apt,500,0,0.11,500
906,Todd,1,Entire home/apt,250,190,0.1,440
907,Paula,1,Private room,87,310,0.62,397
908,Jonathan,2,Private room,79,52,0.47,131
909,Pat,1,Private room,75,312,2.11,387
910,Patrick,2,Entire home/apt,200,0,0.6,200
911,Chryslaine,1,Private room,80,329,0.21,409
912,Steve And Heather,2,Entire home/apt,115,333,0.72,448
913,Steve And Heather,2,Entire home/apt,115,327,0.58,442
914,Steve And Heather,2,Entire home/apt,120,349,0.88,469
915,Jason,1,Private room,125,217,2.29,342
916,Mary,1,Entire home/apt,387,0,0.63,387
917,J,1,Private room,95,80,0.76,175
918,Yj,1,Entire home/apt,99,0,0.45,99
919,Marie,1,Entire home/apt,121,351,0.19,472
920,Gladys,1,Entire home/apt,350,362,0.27,712
921,Laura,1,Private room,75,144,0.88,219
922,J,1,Private room,95,43,1.27,138
923,Ben,1,Private room,89,365,0.64,454
924,R.,1,Private room,195,129,0.08,324
926,Tony,2,Entire home/apt,70,0,0.22,70
927,Julie,1,Private room,100,0,0.09,100
928,Beth,1,Entire home/apt,140,0,0.6,140
929,Jason,1,Entire home/apt,189,355,2.99,544
931,Kate,2,Entire home/apt,178,280,0.1,458
932,Niki & Colin,2,Entire home/apt,145,38,0.52,183
933,Sascha,2,Entire home/apt,125,31,0.08,156
934,Ron,1,Entire home/apt,265,324,0.86,589
935,Marvet,2,Private room,77,365,0.13,442
936,Shai,1,Private room,60,0,1.47,60
937,Marc,1,Entire home/apt,129,171,1.49,300
938,Jared,1,Entire home/apt,199,36,0.47,235
939,Camila,2,Private room,92,332,0.39,424
940,Molly,2,Entire home/apt,185,0,0.39,185
941,Ellie,1,Entire home/apt,110,192,0.31,302
942,Kay,2,Private room,65,139,0.34,204
943,Candice,1,Private room,135,167,2.45,302
944,Jennifer,1,Shared room,115,0,0.14,115
945,Lilly,1,Private room,175,10,0.09,185
947,Rico,2,Private room,72,110,1.8,182
948,Susan,2,Private room,80,0,0.74,80
949,Andre,2,Entire home/apt,125,0,0.02,125
950,Veronika And John,2,Private room,120,242,0.09,362
951,Ginger,2,Private room,94,22,3.18,116
952,Luke,2,Private room,56,0,0.82,56
953,Alix,1,Entire home/apt,549,200,0.66,749
954,Max,2,Entire home/apt,190,0,0.1,190
955,Christina,2,Private room,129,87,0.71,216
956,Mark,2,Entire home/apt,85,202,3.04,287
957,Rimma & Jim,5,Private room,20,226,0.92,246
958,Ido,1,Entire home/apt,145,0,0.25,145
959,Geny,1,Entire home/apt,200,327,0.15,527
960,Ellis,2,Entire home/apt,125,262,0.67,387
961,Alexander,2,Entire home/apt,50,0,0.08,50
962,William,1,Private room,160,359,0.12,519
963,William,1,Private room,180,348,0.16,528
964,Brace,1,Private room,100,0,0.28,100
965,Sophia,2,Private room,70,0,0.02,70
966,Orit,4,Entire home/apt,120,318,1.22,438
967,Nen,5,Private room,110,363,0.19,473
968,Cristina,1,Private room,105,70,1.06,175
969,Jon,1,Entire home/apt,250,0,1.32,250
970,Yogi,1,Private room,74,90,0.17,164
971,Lilly,1,Entire home/apt,165,15,0.8,180
972,Michael & Aleksandra,1,Private room,99,335,0.41,434
973,Liz,1,Entire home/apt,125,0,1.46,125
974,Constance F.,3,Private room,75,0,0.69,75
975,Luana,3,Shared room,45,364,0.11,409
976,Rebecka,2,Entire home/apt,159,34,1.22,193
977,Kristian & Di,2,Private room,45,242,0.57,287
978,Kristina,1,Private room,104,147,1.51,251
979,Alayna,1,Entire home/apt,225,169,0.31,394
980,Paola,1,Private room,100,188,0.7,288
981,Todd,2,Private room,90,89,0.02,179
982,Constance F.,3,Private room,75,189,0.18,264
984,Daniel,1,Entire home/apt,135,253,0.44,388
985,Richelle,1,Private room,125,311,0.28,436
986,Wendy,1,Entire home/apt,225,0,1.05,225
987,Darktalia,1,Private room,85,363,0.07,448
988,Michael,1,Entire home/apt,200,224,0.34,424
989,William,2,Entire home/apt,250,5,0.46,255
990,David,1,Private room,90,301,0.77,391
991,John,2,Entire home/apt,130,0,0.68,130
992,Esther,2,Entire home/apt,90,50,0.37,140
993,Loretta,2,Entire home/apt,298,296,1.84,594
994,Maya,1,Entire home/apt,300,84,0.22,384
996,K. Naomi,1,Private room,125,212,0.84,337
997,Candice,1,Private room,145,181,1.88,326
998,Katya,1,Entire home/apt,147,0,0.18,147
999,Jsun,2,Private room,123,158,3.09,281
1000,Jeruschka,2,Entire home/apt,88,217,2.75,305
1001,Megan,3,Entire home/apt,215,335,0.94,550
1002,M. C.,1,Entire home/apt,225,231,1.53,456
1003,Marie-Helene,1,Entire home/apt,269,122,0.93,391
1004,Erin,2,Entire home/apt,145,270,0.08,415
1005,Majar,2,Private room,75,330,1.28,405
1007,Andre,2,Entire home/apt,229,321,1.05,550
1008,Elizabeth,2,Entire home/apt,300,312,0.26,612
1009,K. Naomi,1,Private room,100,345,0.76,445
1010,Olga,2,Entire home/apt,75,2,0.1,77
1011,Jennifer,1,Entire home/apt,225,252,2.81,477
1012,Jonathan,2,Private room,120,15,0.7,135
1013,Verena,2,Entire home/apt,160,169,1.47,329
1014,Linda,2,Entire home/apt,125,212,0.67,337
1015,Kim,2,Entire home/apt,95,0,0.1,95
1016,Omri,2,Private room,119,296,1.57,415
1017,Cary,1,Entire home/apt,275,167,0.24,442
1018,Dan,1,Entire home/apt,160,365,0.57,525
1019,Shell,2,Entire home/apt,500,365,0.65,865
1020,Martis,1,Entire home/apt,175,0,0.03,175
1021,Jasmine,2,Entire home/apt,87,258,0.47,345
1022,Vero,2,Entire home/apt,160,257,1.76,417
1023,Marshall,1,Private room,125,364,0.33,489
1024,Eada,2,Entire home/apt,90,236,2.4,326
1025,Maddine,1,Entire home/apt,200,0,0.22,200
1026,Richard,2,Entire home/apt,250,54,0.52,304
1027,Lynda,1,Private room,99,189,0.31,288
1028,Jasen,1,Entire home/apt,325,364,0.21,689
1029,Jj,1,Private room,99,265,1.54,364
1030,Akari,1,Entire home/apt,325,207,2.25,532
1031,Shelley,1,Entire home/apt,129,0,0.09,129
1032,Supriya,2,Entire home/apt,130,196,0.06,326
1033,Rafil,2,Entire home/apt,190,0,0.09,190
1034,Rachael,2,Private room,55,57,0.71,112
1035,Elaine,1,Private room,60,0,0.15,60
1036,Kishore,1,Entire home/apt,250,0,0.09,250
1037,Kurt,1,Entire home/apt,275,277,0.87,552
1038,Grace,3,Private room,50,0,0.79,50
1039,Miya,2,Entire home/apt,125,10,0.47,135
1040,David,2,Entire home/apt,150,247,1.04,397
1041,Terrance,2,Entire home/apt,70,273,0.46,343
1042,Joe,2,Entire home/apt,138,189,1.22,327
1043,Suzanne,1,Entire home/apt,265,0,0.39,265
1044,Robert,1,Private room,145,365,0.09,510
1045,Andrew,1,Entire home/apt,151,249,0.22,400
1046,Alda,1,Entire home/apt,208,310,1.14,518
1047,Jennifer,2,Entire home/apt,200,291,0.19,491
1048,Cp,1,Private room,110,74,0.76,184
1049,Laetitia,1,Private room,58,289,0.31,347
1050,Serge,1,Private room,55,0,0.08,55
1051,Seth,2,Entire home/apt,105,219,0.17,324
1052,Ralph,1,Entire home/apt,350,0,0.07,350
1053,Marc,2,Entire home/apt,150,73,1.0,223
1054,Haley,2,Private room,55,97,0.14,152
1056,Joris,3,Entire home/apt,77,85,3.3,162
1057,Rachel,1,Entire home/apt,125,0,0.11,125
1058,Michelle,1,Entire home/apt,395,50,0.45,445
1059,James,2,Entire home/apt,189,303,0.1,492
1060,Danielle,4,Private room,49,333,0.27,382
1061,Joy,1,Entire home/apt,90,239,0.27,329
1062,Mark,1,Private room,100,6,0.02,106
1063,Jsun,2,Entire home/apt,299,0,0.06,299
1064,Sharma,3,Private room,75,180,0.37,255
1065,Sharma,3,Private room,69,318,0.64,387
1066,Alex,2,Private room,90,328,1.78,418
1067,Yamil,1,Private room,94,18,1.09,112
1068,Liz,2,Private room,80,353,1.35,433
1069,Karen,4,Entire home/apt,100,63,0.96,163
1070,Natalie,2,Private room,39,34,1.21,73
1071,Marjorie,1,Entire home/apt,250,284,0.84,534
1072,Maria Luiza,2,Private room,55,333,0.32,388
1074,Tamara,2,Entire home/apt,200,0,0.06,200
1075,Helen,2,Entire home/apt,142,222,1.4,364
1076,Waldemar,2,Private room,70,333,3.88,403
1077,Laura,2,Entire home/apt,260,0,0.09,260
1078,Stephanie,1,Entire home/apt,225,195,0.15,420
1079,Jacques,2,Private room,59,0,0.07,59
1080,Toni,1,Private room,65,0,0.03,65
1081,Felo,1,Entire home/apt,99,249,0.18,348
1082,Alex,1,Entire home/apt,239,78,1.33,317
1083,Laura,1,Entire home/apt,50,21,1.47,71
1084,Jeanine,1,Private room,65,0,1.25,65
1085,Daniel,1,Entire home/apt,139,0,0.27,139
1086,Gary,1,Entire home/apt,174,167,3.15,341
1087,David,1,Entire home/apt,315,0,0.08,315
1088,Kaye,1,Private room,75,47,1.76,122
1089,Lorena,1,Entire home/apt,210,0,2.06,210
1090,Javier & Jorge,2,Private room,55,195,1.51,250
1091,Sarah,2,Entire home/apt,229,319,0.15,548
1092,Ivana,1,Entire home/apt,150,0,0.27,150
1093,Jan,1,Entire home/apt,129,177,0.55,306
1094,Sara,1,Entire home/apt,100,0,0.11,100
1095,Sarah,2,Entire home/apt,200,67,0.2,267
1096,Sunserae,1,Private room,89,0,0.06,89
1097,Miryam,2,Entire home/apt,250,311,0.22,561
1098,Jacques,2,Private room,65,0,0.02,65
1099,Ora & Scout,2,Entire home/apt,68,0,0.54,68
1100,Ryan,2,Entire home/apt,235,144,1.25,379
1101,Nicole Lavonne,2,Entire home/apt,100,220,2.15,320
1102,Rj,1,Entire home/apt,311,28,0.41,339
1103,Lloyd,3,Shared room,39,353,5.27,392
1104,David,1,Private room,100,19,2.3,119
1106,Murch,1,Entire home/apt,210,319,2.65,529
1107,Sue,2,Private room,55,170,1.19,225
1108,Filip,1,Private room,65,0,0.13,65
1109,Diana,2,Entire home/apt,165,157,1.87,322
1110,Aram,1,Private room,89,80,0.81,169
1111,Francesca,1,Entire home/apt,500,0,0.05,500
1112,Verena  And Dylan,2,Entire home/apt,145,0,0.04,145
1113,Stephen,2,Private room,110,330,0.16,440
1114,George,1,Entire home/apt,180,0,0.15,180
1115,Rich,2,Entire home/apt,115,0,0.17,115
1116,Sweet Home,2,Entire home/apt,82,311,0.06,393
1117,Massi & Ray,3,Private room,70,340,1.68,410
1118,Koren,2,Entire home/apt,155,0,0.12,155
1120,Kara,2,Entire home/apt,100,0,0.2,100
1121,Adam,1,Entire home/apt,89,0,0.67,89
1122,Adam,1,Entire home/apt,89,4,0.83,93
1123,Adam,1,Entire home/apt,99,8,0.74,107
1124,Teresa,1,Entire home/apt,155,0,0.2,155
1125,Agnes,1,Private room,85,238,5.12,323
1126,Kristine,1,Private room,80,96,0.56,176
1127,Jimmy,1,Entire home/apt,135,236,1.56,371
1128,Jennifer,2,Entire home/apt,150,0,0.03,150
1129,Samir,1,Entire home/apt,380,0,0.19,380
1130,Josh,2,Entire home/apt,450,30,1.14,480
1131,Jaime,2,Entire home/apt,145,342,0.42,487
1132,Jazmin,3,Private room,80,330,0.01,410
1133,Hannah,2,Entire home/apt,225,225,3.9,450
1134,Ron,1,Private room,99,0,1.41,99
1135,Candice,1,Entire home/apt,125,212,3.24,337
1136,Lior,1,Entire home/apt,80,365,0.37,445
1137,Megan,2,Private room,100,12,1.3,112
1138,Edward,2,Private room,55,297,0.26,352
1139,Wallace,1,Entire home/apt,328,112,3.78,440
1140,Jodi,2,Entire home/apt,142,261,0.85,403
1141,John,2,Entire home/apt,350,0,0.12,350
1142,Hana,2,Entire home/apt,300,23,0.39,323
1143,Alex,2,Entire home/apt,105,30,0.05,135
1144,Jackie'S Place,2,Private room,125,331,0.2,456
1145,Michael,2,Entire home/apt,225,0,0.15,225
1146,Keith,2,Entire home/apt,92,0,0.67,92
1147,Mick & Heidi,1,Entire home/apt,185,0,0.74,185
1148,Carter,2,Entire home/apt,226,38,2.85,264
1149,Kelly,2,Private room,50,20,0.39,70
1150,Clara,1,Private room,80,0,0.66,80
1152,A.B.,1,Entire home/apt,99,317,0.35,416
1153,Andy,2,Entire home/apt,68,0,0.05,68
1154,Ada,2,Private room,102,361,1.6,463
1155,Julie,2,Entire home/apt,220,68,0.45,288
1156,Carly,1,Entire home/apt,199,0,0.3,199
1157,Christine,1,Entire home/apt,165,316,0.26,481
1158,Gelya,1,Entire home/apt,150,231,1.92,381
1159,Ute,2,Entire home/apt,385,363,0.76,748
1161,Jean-Marie,1,Entire home/apt,499,26,0.76,525
1162,Biren,3,Private room,85,305,2.63,390
1163,Megan,2,Entire home/apt,160,34,0.03,194
1164,D,2,Entire home/apt,249,26,0.27,275
1165,Elizabeth (And Jeff Too),2,Private room,80,189,0.41,269
1166,Regina,2,Private room,120,292,1.46,412
1167,Ellen,4,Private room,35,90,0.17,125
1168,Dimitry,2,Entire home/apt,169,323,1.27,492
1169,Bojan+Margaret,1,Entire home/apt,220,341,1.88,561
1170,James,2,Private room,85,344,1.25,429
1172,Joyce,1,Private room,79,302,2.15,381
1173,Fanny,2,Private room,90,30,2.54,120
1174,Patrick,1,Private room,99,246,3.51,345
1175,Anastasia,1,Shared room,50,0,0.71,50
1176,Gina,2,Private room,46,362,2.14,408
1177,Elodie,2,Entire home/apt,325,203,1.37,528
1178,Caitlin,5,Private room,68,88,0.24,156
1179,Eric,1,Entire home/apt,198,0,0.1,198
1180,Rebecca (Marks),2,Entire home/apt,100,0,0.05,100
1181,Theresa,2,Entire home/apt,175,64,0.29,239
1182,Michele,1,Entire home/apt,130,77,0.28,207
1183,Mahalia,1,Entire home/apt,180,0,0.21,180
1184,Eric,2,Entire home/apt,209,160,0.65,369
1185,Erin,1,Entire home/apt,150,141,0.03,291
1186,Mariana,1,Entire home/apt,104,6,0.7,110
1187,Ann,1,Entire home/apt,175,0,0.17,175
1188,Catherine,1,Private room,80,0,0.01,80
1189,Kelly,2,Private room,68,23,0.49,91
1190,John,1,Private room,72,13,5.26,85
1191,Jason,3,Entire home/apt,107,262,0.29,369
1192,Anthony,1,Entire home/apt,150,24,0.32,174
1193,Jose And Ysaira,4,Private room,45,329,2.21,374
1194,Edward,2,Private room,49,301,0.54,350
1195,Rick,2,Entire home/apt,349,344,2.08,693
1196,Margaret,1,Entire home/apt,185,259,1.92,444
1197,Jacqueline,1,Entire home/apt,145,0,0.02,145
1198,Darya,2,Entire home/apt,96,0,0.07,96
1199,Samantha,2,Entire home/apt,120,0,0.04,120
1200,Gay,1,Entire home/apt,160,0,0.18,160
1201,Amy,2,Entire home/apt,800,67,0.7,867
1202,Rich,2,Entire home/apt,349,260,3.85,609
1203,Richard,3,Entire home/apt,350,272,2.2,622
1204,Dennis,2,Entire home/apt,125,341,0.01,466
1205,Tiffany,2,Entire home/apt,350,56,1.56,406
1206,Richard,2,Entire home/apt,150,185,0.17,335
1208,Michael,1,Entire home/apt,200,260,0.78,460
1209,Catrinel,2,Entire home/apt,99,242,0.06,341
1210,Aaron,1,Entire home/apt,130,0,0.1,130
1211,Stephane,2,Entire home/apt,150,0,0.01,150
1212,Bethany,2,Entire home/apt,90,269,0.39,359
1213,Walker,2,Private room,95,0,0.14,95
1214,Joni,3,Entire home/apt,70,0,0.04,70
1215,Andrea,1,Private room,82,251,0.13,333
1216,Stephanie,2,Entire home/apt,250,292,0.73,542
1217,Federico,1,Entire home/apt,90,150,3.17,240
1218,Janina,3,Private room,75,317,2.92,392
1219,Brendan,2,Entire home/apt,160,0,0.04,160
1220,Ghislaine,1,Private room,115,178,0.09,293
1221,Amelia,2,Private room,150,0,0.06,150
1222,Glace,2,Private room,89,23,1.92,112
1223,Anya,3,Entire home/apt,69,4,0.1,73
1224,Asher,1,Private room,170,254,2.19,424
1225,Carl,2,Entire home/apt,375,43,0.23,418
1226,Leigh,1,Entire home/apt,118,13,1.66,131
1227,Noele,1,Entire home/apt,135,170,0.49,305
1228,Chris,4,Entire home/apt,250,339,1.41,589
1229,Jenna,2,Entire home/apt,200,365,0.24,565
1230,Robert,1,Entire home/apt,150,0,0.06,150
1231,Kim,1,Private room,50,60,0.62,110
1233,Reena,1,Entire home/apt,100,0,0.29,100
1234,Lisbeth,1,Entire home/apt,265,341,0.32,606
1235,Wendy,1,Private room,90,128,0.04,218
1237,Sing,2,Private room,36,44,0.07,80
1238,Lane,1,Entire home/apt,250,0,0.03,250
1239,Larah,1,Entire home/apt,220,338,2.42,558
1240,Sandy,1,Private room,93,176,1.03,269
1241,Justine,2,Entire home/apt,275,357,0.1,632
1242,Dragan,3,Private room,109,0,3.7,109
1243,Sofia,2,Entire home/apt,450,0,0.13,450
1244,Alexandra,1,Entire home/apt,165,259,0.23,424
1245,Gita,2,Entire home/apt,80,20,0.27,100
1246,Thomas,1,Private room,295,350,1.25,645
1247,Matthew,2,Entire home/apt,280,41,0.98,321
1248,Olivia,1,Entire home/apt,300,106,1.09,406
1249,Adam,1,Entire home/apt,99,0,0.77,99
1250,Liz,2,Entire home/apt,175,0,0.35,175
1251,Michael,1,Entire home/apt,225,205,2.03,430
1252,Judith & Reid,1,Entire home/apt,230,0,0.09,230
1253,Maite & Javi,2,Private room,90,38,0.52,128
1254,Dawn,1,Entire home/apt,102,21,0.5,123
1255,Fabrizio,2,Private room,59,0,0.27,59
1256,David,1,Entire home/apt,195,68,2.31,263
1257,De & Claudia,3,Entire home/apt,150,365,0.87,515
1258,Michelle,1,Entire home/apt,170,17,0.58,187
1259,Stefanie,1,Entire home/apt,217,0,0.51,217
1260,Kareem,1,Entire home/apt,185,91,1.19,276
1261,Anton,1,Private room,58,0,0.21,58
1262,Christina,2,Entire home/apt,189,1,0.44,190
1263,Adam,1,Entire home/apt,88,0,0.72,88
1264,Kj,1,Entire home/apt,195,59,1.61,254
1265,Sharon And Tom,3,Entire home/apt,110,276,1.25,386
1267,F,1,Private room,79,30,1.02,109
1268,Srdjan,1,Entire home/apt,110,0,0.2,110
1269,Tom,2,Private room,200,365,0.02,565
1270,Marvet,2,Private room,69,43,0.24,112
1271,Linda,3,Private room,55,332,5.53,387
1272,Jeff,2,Entire home/apt,135,0,0.06,135
1273,Mickey,1,Entire home/apt,500,79,0.75,579
1275,Shontae,2,Entire home/apt,135,211,0.4,346
1277,James,1,Entire home/apt,90,0,0.09,90
1278,Brian,1,Entire home/apt,160,0,0.2,160
1279,Huxley,2,Private room,65,311,0.32,376
1280,Kathleen,1,Entire home/apt,210,347,0.3,557
1281,Henrik,1,Entire home/apt,399,0,0.31,399
1282,Greg,1,Entire home/apt,300,111,0.62,411
1283,Maurice,2,Entire home/apt,185,348,2.55,533
1284,Historic Harlem,1,Entire home/apt,220,174,0.51,394
1285,Jennie,2,Entire home/apt,121,0,0.54,121
1286,Yah,1,Entire home/apt,120,129,0.3,249
1287,Steve,2,Private room,152,365,0.27,517
1288,Maayan,2,Entire home/apt,250,25,0.67,275
1289,Evan,1,Private room,99,0,1.01,99
1290,Lindsey,2,Entire home/apt,104,0,0.26,104
1291,Jessica,2,Entire home/apt,120,0,0.54,120
1292,Vana,1,Entire home/apt,295,261,1.02,556
1293,Annie,2,Entire home/apt,90,0,0.01,90
1294,Laura,1,Entire home/apt,197,0,0.36,197
1295,Aaron,1,Entire home/apt,145,0,0.01,145
1296,Mathilde,1,Entire home/apt,90,0,0.27,90
1297,David,1,Private room,125,172,0.5,297
1298,Matt,1,Entire home/apt,190,69,2.83,259
1299,Kalae,1,Shared room,76,324,1.91,400
1300,Heather,2,Private room,50,0,0.03,50
1301,Marianna,1,Private room,107,85,1.4,192
1302,Sajjad,2,Entire home/apt,80,245,0.49,325
1303,Erin,2,Entire home/apt,150,0,0.04,150
1304,Jason,2,Entire home/apt,110,330,0.4,440
1305,Alessandra,2,Entire home/apt,115,365,0.09,480
1306,Seith,1,Entire home/apt,151,256,2.53,407
1307,Christopher,2,Entire home/apt,130,0,0.13,130
1308,Noemie,2,Entire home/apt,180,264,2.6,444
1309,Ana,2,Private room,95,359,1.47,454
1310,Ny,1,Private room,79,335,1.56,414
1311,Ollie,2,Private room,60,245,0.65,305
1312,Nkosi,2,Entire home/apt,133,338,1.32,471
1313,Brian,1,Entire home/apt,120,337,0.22,457
1314,Katherine,2,Private room,120,102,4.14,222
1315,Sheri,1,Private room,700,22,0.05,722
1316,Goran,1,Entire home/apt,165,0,0.3,165
1317,Alexandra,1,Entire home/apt,165,0,0.05,165
1318,Dustin,3,Entire home/apt,54,80,2.33,134
1319,Ina,1,Entire home/apt,100,0,0.07,100
1320,Stephon & Luke,2,Private room,80,365,0.48,445
1321,Edel,1,Private room,96,165,0.36,261
1322,Gideon,2,Entire home/apt,159,0,0.08,159
1323,Mark And Stoph,2,Private room,50,54,2.42,104
1324,Melanie,1,Private room,75,77,0.61,152
1325,Dana,2,Entire home/apt,155,249,0.75,404
1326,Bekah,2,Private room,150,72,0.59,222
1327,Jeanmarie,3,Entire home/apt,92,8,0.66,100
1328,Raziel,2,Private room,75,0,0.13,75
1329,Tim,3,Private room,69,207,0.27,276
1330,Ibie,2,Entire home/apt,115,15,0.72,130
1331,Nitin,1,Entire home/apt,120,0,0.06,120
1332,Gio/Joey,1,Private room,120,179,0.8,299
1333,Anna,1,Entire home/apt,215,332,1.3,547
1334,Kanan & Tobias,2,Entire home/apt,195,255,1.95,450
1335,Alex,2,Entire home/apt,175,215,1.23,390
1336,Helene,2,Private room,80,311,0.08,391
1337,Tim,2,Private room,48,0,0.02,48
1338,Josefina,1,Entire home/apt,200,217,0.41,417
1339,John,2,Entire home/apt,275,363,0.07,638
1340,Jeffrey,2,Private room,72,335,0.81,407
1341,Tom & Jennifer,1,Entire home/apt,199,281,0.13,480
1342,Michael,2,Entire home/apt,250,250,0.01,500
1343,Wowa,1,Private room,75,343,0.6,418
1344,T,1,Private room,125,365,1.75,490
1345,Lisa,1,Private room,229,36,0.73,265
1346,Theodore,2,Entire home/apt,175,0,0.17,175
1347,Stephanie,2,Entire home/apt,140,0,0.27,140
1348,Chris,2,Private room,54,220,0.23,274
1349,Valerie,3,Entire home/apt,75,0,0.2,75
1350,Marie-Jeanne,1,Entire home/apt,110,0,0.14,110
1351,Hillary,1,Entire home/apt,165,185,3.93,350
1352,Chris,1,Private room,55,79,1.89,134
1353,Chris,1,Private room,55,179,1.68,234
1354,Bill,1,Entire home/apt,300,0,0.06,300
1355,Markus,1,Entire home/apt,275,69,0.73,344
1357,Kelly,2,Private room,77,0,0.08,77
1358,Ana,1,Private room,60,365,0.44,425
1359,Angela,2,Entire home/apt,129,261,1.51,390
1360,Nancy,3,Private room,100,188,0.38,288
1361,Onur,2,Entire home/apt,120,0,0.16,120
1362,Fabio,2,Entire home/apt,500,307,2.99,807
1363,Amy,1,Entire home/apt,179,11,0.25,190
1364,Chris,2,Entire home/apt,149,4,0.24,153
1365,George,2,Entire home/apt,180,312,0.36,492
1366,Kathleen R.,2,Private room,100,257,0.89,357
1367,Kevin + Casey,2,Entire home/apt,180,0,0.05,180
1368,Zach,2,Entire home/apt,128,20,0.45,148
1369,Kyle,2,Entire home/apt,260,0,0.07,260
1371,Nat,2,Private room,65,22,0.5,87
1372,Lauren,1,Entire home/apt,200,0,0.21,200
1373,Heather,1,Entire home/apt,249,38,0.42,287
1374,Wendy,2,Entire home/apt,300,365,0.77,665
1375,Eric,1,Entire home/apt,120,16,1.78,136
1376,Silvia,1,Private room,120,144,1.29,264
1377,Marta,2,Entire home/apt,125,0,0.08,125
1378,Rafael,3,Entire home/apt,99,301,0.58,400
1379,Jonathan,2,Entire home/apt,115,3,0.65,118
1380,Andrew And Kat,2,Entire home/apt,275,364,0.2,639
1381,"Christopher, Samantha And Mason",2,Entire home/apt,198,299,1.62,497
1382,Deborah,1,Entire home/apt,199,142,2.95,341
1384,Lori & John,1,Private room,125,58,1.17,183
1385,Historic Harlem,1,Entire home/apt,80,193,0.74,273
1386,Mike,1,Entire home/apt,130,116,0.03,246
1387,Masud,2,Private room,35,326,1.05,361
1388,Bradley,2,Entire home/apt,90,0,0.18,90
1389,Bob,2,Entire home/apt,250,188,0.3,438
1391,Cath,2,Entire home/apt,200,0,0.13,200
1392,Zack,2,Private room,64,230,0.26,294
1393,Hayley,2,Private room,65,341,0.06,406
1395,Mauricio,1,Private room,90,358,0.34,448
1398,Laura And Bernard,1,Entire home/apt,50,91,0.11,141
1399,Aida,1,Entire home/apt,136,6,0.18,142
1400,Gina,2,Entire home/apt,400,83,0.17,483
1401,Zhenia,2,Entire home/apt,125,29,0.57,154
1402,Carlita,1,Entire home/apt,165,32,0.68,197
1404,Dennis,1,Entire home/apt,105,0,0.07,105
1405,Sag,1,Entire home/apt,148,0,0.69,148
1406,Lauren,2,Entire home/apt,120,189,0.27,309
1407,Ian,1,Entire home/apt,99,0,0.07,99
1408,Zachary,1,Entire home/apt,175,0,0.2,175
1409,Niral,2,Private room,85,0,0.19,85
1410,Ken,1,Private room,80,319,1.9,399
1411,Lascell,2,Entire home/apt,119,338,1.02,457
1412,Karl & Catherine,3,Private room,89,50,1.99,139
1413,Paul,1,Shared room,195,0,0.16,195
1414,Henry,1,Entire home/apt,1000,364,0.53,1364
1415,Peter,1,Entire home/apt,225,172,0.62,397
1416,Misty,2,Entire home/apt,165,0,2.2,165
1417,Jose,2,Private room,60,86,2.49,146
1418,Sharon,1,Entire home/apt,165,87,0.05,252
1419,Daniel,2,Private room,80,67,0.11,147
1420,Tony,3,Private room,52,0,0.08,52
1421,Cortney,1,Entire home/apt,160,0,0.02,160
1422,Jonny,2,Entire home/apt,110,15,0.04,125
1423,Jeffrey,1,Private room,60,0,0.23,60
1424,Marina,5,Entire home/apt,299,245,0.82,544
1425,Jack,1,Entire home/apt,200,128,0.16,328
1426,Gina,1,Entire home/apt,700,365,0.01,1065
1427,Chris & Don,2,Private room,120,271,3.05,391
1428,Diego,1,Private room,65,32,1.56,97
1429,Dee,1,Entire home/apt,263,33,0.13,296
1430,Mateo And Anna,2,Entire home/apt,120,149,0.68,269
1431,Evan,1,Entire home/apt,150,0,0.12,150
1432,Grace,1,Private room,60,156,3.16,216
1433,Ryan,2,Private room,350,365,0.04,715
1434,Vadim,5,Private room,71,352,0.33,423
1435,James,1,Entire home/apt,433,318,1.44,751
1436,Steven,1,Private room,79,329,0.11,408
1437,Brian,1,Private room,140,0,2.99,140
1438,Daniel,3,Private room,61,335,1.29,396
1439,Gal,1,Private room,100,0,0.52,100
1440,Mathilde,1,Entire home/apt,250,347,0.52,597
1441,Andrea,1,Private room,145,44,0.47,189
1442,Mary,2,Shared room,45,0,0.37,45
1443,Carmen,2,Private room,73,310,0.07,383
1444,Ede,2,Entire home/apt,150,68,0.26,218
1445,Jon,1,Entire home/apt,234,302,0.37,536
1446,Moira,1,Entire home/apt,150,0,0.13,150
1447,Jernee,1,Private room,65,182,1.92,247
1448,Karina,2,Entire home/apt,195,270,0.47,465
1450,Christina,2,Entire home/apt,90,0,0.03,90
1451,Lisa,1,Entire home/apt,595,169,0.77,764
1452,Casper,1,Private room,109,276,3.89,385
1453,Edward,2,Entire home/apt,200,365,0.96,565
1454,Mike,1,Entire home/apt,90,358,0.05,448
1455,Mike,1,Entire home/apt,100,342,0.04,442
1456,Mike,1,Entire home/apt,85,223,0.04,308
1457,Mike,1,Entire home/apt,87,363,0.05,450
1458,Mike,1,Entire home/apt,95,365,0.01,460
1459,Kate,1,Entire home/apt,349,341,0.7,690
1460,Noel,1,Entire home/apt,99,0,0.14,99
1461,Kathleen,1,Entire home/apt,160,105,1.01,265
1462,Connie,1,Entire home/apt,149,203,0.14,352
1463,Nick,2,Entire home/apt,60,0,0.01,60
1464,Alana,1,Entire home/apt,285,0,3.53,285
1465,Manon,2,Private room,72,312,0.59,384
1466,Horatio,1,Entire home/apt,150,339,0.06,489
1467,Charlotte,2,Entire home/apt,200,0,0.18,200
1468,Olga,1,Private room,79,247,4.24,326
1469,Mariko,1,Entire home/apt,197,269,1.31,466
1470,Claire,2,Entire home/apt,75,218,1.96,293
1471,Dawn,1,Entire home/apt,127,264,2.3,391
1472,Jay,1,Private room,110,365,0.45,475
1473,Erika,3,Private room,69,0,0.4,69
1474,Ruth,2,Private room,100,365,0.04,465
1475,Ben,1,Entire home/apt,99,31,0.56,130
1476,Sean - Hygge Stay,2,Entire home/apt,139,19,2.57,158
1477,Lynne,1,Private room,113,2,1.12,115
1478,Nika,1,Entire home/apt,250,0,0.13,250
1479,Clara,1,Entire home/apt,295,122,1.02,417
1480,Henry,1,Entire home/apt,2000,364,0.71,2364
1481,Carl,1,Entire home/apt,220,0,0.24,220
1482,Matteo,1,Private room,75,0,0.07,75
1483,Carlo,2,Entire home/apt,100,223,0.18,323
1484,Valentin,2,Entire home/apt,199,65,1.26,264
1485,Nic,1,Entire home/apt,200,5,0.21,205
1486,Lina,2,Entire home/apt,140,365,0.18,505
1487,Martina,1,Private room,50,0,0.02,50
1488,Kate,2,Private room,45,223,0.89,268
1489,Jackie'S Place,2,Entire home/apt,109,110,1.38,219
1490,Roxanne,1,Private room,108,24,1.98,132
1491,Kate,2,Private room,42,236,0.88,278
1493,Camille,1,Entire home/apt,141,346,0.57,487
1494,Elizabeth,2,Entire home/apt,355,301,0.24,656
1495,Claire,2,Entire home/apt,80,249,1.97,329
1496,Natalie,2,Private room,250,0,0.85,250
1497,Francesca,3,Private room,75,332,0.15,407
1498,Callie,1,Private room,88,348,0.05,436
1499,Ouii,1,Private room,65,318,0.55,383
1500,Jullett,3,Private room,58,365,0.67,423
1501,Glauce,3,Entire home/apt,75,0,0.01,75
1502,James,3,Private room,100,144,0.42,244
1503,Stephen,1,Private room,167,341,0.39,508
1504,Alice,3,Private room,65,0,0.05,65
1505,Laila,1,Entire home/apt,125,267,0.15,392
1506,Kalae,1,Private room,95,126,2.54,221
1507,Maria,5,Private room,54,232,0.59,286
1508,Yolanda,2,Entire home/apt,89,319,2.63,408
1509,Roxanne,1,Private room,92,12,2.63,104
1510,Danny,1,Entire home/apt,199,0,0.5,199
1511,Jeff,1,Entire home/apt,179,284,0.46,463
1512,John,3,Private room,65,188,0.34,253
1513,Mie,1,Private room,55,13,0.8,68
1514,George Steven,1,Entire home/apt,129,256,0.67,385
1515,George Steven,1,Entire home/apt,134,313,0.11,447
1516,Maria Daniela,2,Private room,35,2,0.16,37
1517,Daniel,1,Private room,250,148,0.93,398
1518,Andrew,2,Entire home/apt,249,362,0.23,611
1519,Biren,3,Private room,62,234,3.92,296
1520,Katherine,1,Private room,119,0,1.16,119
1521,Peter,2,Entire home/apt,179,0,0.97,179
1522,Collin,2,Entire home/apt,220,96,1.4,316
1523,Ethan And Wray,2,Entire home/apt,198,233,3.59,431
1524,Maurice,2,Entire home/apt,155,309,1.75,464
1525,Slava,2,Entire home/apt,199,0,0.09,199
1526,Daniel,1,Entire home/apt,95,15,0.47,110
1527,Yves,2,Entire home/apt,550,258,2.12,808
1528,Ingrid,2,Private room,60,210,3.56,270
1529,Phillip,2,Entire home/apt,380,170,0.75,550
1530,Lindsay,2,Private room,84,225,1.69,309
1531,Larysa,1,Entire home/apt,165,128,0.34,293
1532,Pavel,1,Entire home/apt,105,295,1.17,400
1533,Natalie,2,Entire home/apt,134,0,1.46,134
1534,Boris,2,Private room,68,281,0.1,349
1535,John,1,Entire home/apt,73,3,1.25,76
1536,Karin,2,Entire home/apt,150,27,0.02,177
1537,Charlie,1,Entire home/apt,100,0,1.12,100
1538,Kevin,1,Private room,75,23,2.22,98
1539,Kristen,1,Private room,120,0,0.38,120
1540,Eric,2,Entire home/apt,85,1,2.89,86
1541,Abby,1,Entire home/apt,55,3,0.96,58
1542,Joseph,1,Private room,95,51,0.33,146
1543,Nina,1,Private room,72,297,0.16,369
1544,Kristin,1,Entire home/apt,250,78,0.06,328
1545,Devin  & Justin,2,Private room,69,0,0.37,69
1546,Chantille & Linda,2,Private room,78,188,2.3,266
1547,Janet-David,2,Entire home/apt,220,341,4.9,561
1548,Christos,1,Entire home/apt,230,101,1.4,331
1549,Gabriela,2,Entire home/apt,150,246,0.97,396
1550,Afaliah,2,Private room,80,364,0.17,444
1551,Roberto,2,Private room,150,365,0.42,515
1552,Gisela,2,Entire home/apt,150,266,0.98,416
1553,Mathew,1,Entire home/apt,900,365,0.09,1265
1554,Ori,1,Entire home/apt,130,0,0.14,130
1555,Marvet,2,Private room,70,365,0.22,435
1556,Paul,3,Entire home/apt,120,281,1.59,401
1557,Marianne,5,Private room,75,354,0.72,429
1558,Katherine / François,2,Entire home/apt,100,5,0.47,105
1559,Brady,2,Private room,69,284,0.03,353
1560,Ari,1,Entire home/apt,399,42,1.28,441
1561,Jeff,1,Entire home/apt,299,348,0.09,647
1562,Arlette,1,Private room,100,90,3.96,190
1563,Eugenia,3,Private room,68,89,0.67,157
1565,Alejandra,1,Entire home/apt,175,263,0.79,438
1566,Isabelle,2,Entire home/apt,330,19,0.62,349
1567,Amy,1,Entire home/apt,425,0,0.09,425
1568,Barry,1,Entire home/apt,240,344,1.15,584
1569,Marianne,5,Private room,75,362,0.44,437
1570,Paul And Debra,2,Private room,210,309,0.92,519
1571,Alison,2,Entire home/apt,175,323,4.55,498
1572,Giorgia & Benjamin,2,Private room,85,46,1.78,131
1573,Paul,3,Entire home/apt,120,253,1.52,373
1574,Paul,3,Entire home/apt,120,289,0.67,409
1575,Enid,2,Private room,75,0,0.01,75
1576,Radan,1,Entire home/apt,495,22,0.38,517
1577,Florencia,2,Private room,65,38,0.76,103
1578,Enrique,4,Private room,39,306,2.07,345
1579,Melissa,2,Entire home/apt,93,0,0.02,93
1580,M,2,Private room,146,88,0.11,234
1581,Silvia,2,Entire home/apt,120,15,0.18,135
1582,Crystal,1,Private room,79,365,0.3,444
1583,Adam,2,Entire home/apt,100,0,0.11,100
1584,Jo,1,Private room,120,0,0.06,120
1585,John,1,Entire home/apt,150,36,0.26,186
1586,Dk,1,Entire home/apt,144,198,0.86,342
1588,Dustin,1,Entire home/apt,350,0,0.02,350
1589,Enid,2,Private room,85,189,0.16,274
1590,Ellen,1,Entire home/apt,195,26,0.43,221
1591,Neill,1,Entire home/apt,200,0,0.73,200
1592,Andrea,1,Entire home/apt,169,249,0.75,418
1593,Bethania,1,Private room,95,63,0.07,158
1594,Alexander,1,Entire home/apt,375,346,0.84,721
1595,Ari,2,Entire home/apt,168,253,1.93,421
1596,Natalia,2,Entire home/apt,50,220,0.12,270
1597,Elli,2,Private room,129,36,1.67,165
1598,Remo,3,Entire home/apt,245,164,0.02,409
1599,The Box House Hotel,2,Entire home/apt,199,47,0.67,246
1600,The Box House Hotel,2,Entire home/apt,199,36,1.56,235
1601,Glasshouse,2,Private room,99,89,1.09,188
1602,Tari,2,Entire home/apt,160,0,0.21,160
1603,AJ And Freddy,2,Private room,65,0,2.07,65
1604,Clement & Natalia,1,Private room,70,0,0.87,70
1605,Lex And Derek,1,Private room,80,365,1.67,445
1606,Mike,1,Entire home/apt,100,365,0.12,465
1607,"Porfirio ""Firo"" & Maria",2,Private room,70,364,1.7,434
1608,Melinda,1,Entire home/apt,200,0,0.32,200
1609,Jonathan,2,Private room,66,329,0.64,395
1610,R And R,1,Entire home/apt,200,260,2.53,460
1611,Alessandra,2,Private room,95,93,2.07,188
1612,Christa,1,Entire home/apt,140,0,0.07,140
1613,Cleveland,1,Private room,65,287,4.01,352
1614,Reshma,1,Entire home/apt,106,0,10.0,106
1615,Shahar,1,Entire home/apt,155,188,1.07,343
1616,Megan,1,Entire home/apt,249,28,4.44,277
1617,Hallie,1,Entire home/apt,120,0,0.08,120
1618,Dawn,2,Private room,52,1,0.44,53
1619,Stephanie,1,Private room,75,98,0.7,173
1620,Eric,2,Shared room,195,364,0.98,559
1621,Marina,5,Entire home/apt,625,335,0.02,960
1622,Izi,1,Entire home/apt,171,346,0.06,517
1623,Izi,1,Entire home/apt,185,346,0.1,531
1624,Sol,3,Private room,55,46,0.48,101
1625,Eldad & Paulina,2,Private room,50,2,0.35,52
1626,Mike,1,Entire home/apt,120,365,0.05,485
1627,Nancy,1,Entire home/apt,210,0,10.0,210
1628,Nicolas,1,Entire home/apt,133,50,0.09,183
1629,Ella,2,Entire home/apt,73,251,0.26,324
1630,Neil & Katie,1,Entire home/apt,350,0,2.96,350
1631,Oly,1,Entire home/apt,259,17,0.25,276
1632,Viva,1,Private room,97,87,0.06,184
1633,Rachel,1,Entire home/apt,199,142,0.83,341
1634,Stacey,1,Entire home/apt,125,358,0.09,483
1635,Elizabeth,2,Entire home/apt,100,45,3.35,145
1636,Natalie,2,Private room,39,34,0.95,73
1637,Kjersti,1,Entire home/apt,125,267,0.25,392
1638,Charlotte,1,Entire home/apt,150,0,0.03,150
1639,Page,1,Entire home/apt,170,203,1.04,373
1640,Robert,1,Entire home/apt,199,212,2.68,411
1642,Kedin,2,Private room,125,300,3.34,425
1643,Erik,1,Private room,155,90,0.24,245
1644,Jackson,1,Private room,120,267,1.62,387
1645,Ellie,2,Entire home/apt,220,115,1.86,335
1646,Corina,2,Entire home/apt,90,0,0.06,90
1647,Nick,2,Private room,61,320,4.16,381
1648,Jack,1,Entire home/apt,179,277,2.62,456
1649,Aimée,3,Shared room,108,0,0.08,108
1650,Molly,2,Entire home/apt,575,0,0.15,575
1651,Kevin,1,Private room,99,73,4.33,172
1652,Phil,2,Entire home/apt,175,0,0.05,175
1653,Amber,2,Entire home/apt,110,0,0.05,110
1654,Philippa,2,Entire home/apt,250,0,0.05,250
1655,Emily,2,Private room,100,0,1.43,100
1656,Cristiana,1,Entire home/apt,200,259,0.14,459
1657,Dana,3,Entire home/apt,89,0,0.31,89
1658,Boris,1,Entire home/apt,400,175,0.57,575
1659,Eric And Aoife,2,Entire home/apt,149,0,0.64,149
1660,Philip,1,Entire home/apt,500,33,0.22,533
1661,Karen,1,Private room,95,316,0.88,411
1662,Nicole,2,Entire home/apt,125,275,1.36,400
1663,Shaina,1,Private room,80,15,0.93,95
1664,Mark,2,Entire home/apt,105,234,2.79,339
1665,Petya,3,Private room,39,360,0.16,399
1666,Enrique,4,Entire home/apt,49,238,2.32,287
1667,Sandra,1,Entire home/apt,187,0,0.01,187
1668,Oliver,2,Private room,55,0,0.15,55
1669,Randy,2,Entire home/apt,250,0,0.76,250
1670,Sara,1,Entire home/apt,125,0,0.04,125
1671,Tania,2,Entire home/apt,100,159,0.33,259
1672,Chanelle,2,Entire home/apt,175,0,0.02,175
1673,Jorge,2,Private room,50,347,0.4,397
1674,Kiovanna,1,Entire home/apt,133,5,0.33,138
1675,Jenni,1,Entire home/apt,155,235,0.78,390
1676,Pasha,3,Entire home/apt,140,260,0.19,400
1677,Joao Lucas,3,Private room,80,364,0.89,444
1678,Clay,2,Private room,103,69,0.94,172
1679,Mariko,1,Entire home/apt,600,353,0.12,953
1680,Jenny,2,Private room,70,188,3.07,258
1681,Anthony,2,Private room,75,0,0.03,75
1682,Jenny,2,Private room,55,264,1.16,319
1683,Mariko,1,Entire home/apt,50,25,0.3,75
1684,Sabrina,3,Entire home/apt,390,89,0.03,479
1685,Jenny & Jose,2,Entire home/apt,82,238,1.33,320
1686,Debbie,2,Shared room,52,88,0.44,140
1687,Susan,2,Private room,115,258,1.18,373
1688,Norman,3,Entire home/apt,299,322,0.95,621
1689,Anna,2,Entire home/apt,175,116,0.8,291
1690,Ana,2,Entire home/apt,100,250,0.05,350
1692,Jenna,3,Private room,55,119,0.04,174
1693,Kyla,2,Private room,45,167,0.95,212
1694,Nathaniel,2,Entire home/apt,165,19,0.52,184
1695,Lior,1,Entire home/apt,105,0,0.5,105
1696,Miki & Yacine,2,Entire home/apt,200,0,0.05,200
1697,Amy,1,Private room,65,249,0.04,314
1698,Sasha,1,Private room,100,0,0.03,100
1699,Ian,2,Entire home/apt,312,246,4.18,558
1700,Niki,1,Entire home/apt,195,0,0.02,195
1701,Victoria,1,Entire home/apt,100,301,0.11,401
1702,Stephane & Hana,2,Entire home/apt,155,0,0.16,155
1704,Frank,1,Entire home/apt,165,146,3.44,311
1705,Tauheed,1,Entire home/apt,120,365,0.31,485
1706,Enrique,4,Private room,38,241,2.34,279
1708,Hannah,2,Private room,90,0,0.11,90
1709,Santina,1,Private room,85,196,2.06,281
1710,Weiwei,3,Private room,55,282,0.53,337
1711,Charles,1,Shared room,350,0,0.17,350
1712,Michelle,1,Private room,59,12,0.16,71
1713,Marie,1,Entire home/apt,280,48,1.25,328
1714,Karl & Catherine,3,Private room,69,132,1.89,201
1715,Sean,2,Entire home/apt,230,325,0.91,555
1716,Jennifer,2,Entire home/apt,200,52,0.95,252
1717,Nataliya,2,Entire home/apt,150,311,0.65,461
1718,Aziza,2,Private room,75,365,0.36,440
1719,Keenan & Emily,1,Private room,120,0,0.02,120
1720,Daniel,1,Entire home/apt,140,182,0.29,322
1721,Vance,1,Entire home/apt,200,337,0.53,537
1722,Eddie,1,Entire home/apt,225,189,0.07,414
1723,Peter,2,Entire home/apt,145,36,0.05,181
1724,Libertad,4,Private room,60,1,1.13,61
1725,Joseph,2,Entire home/apt,119,0,0.09,119
1726,Adela,1,Entire home/apt,189,63,0.92,252
1727,Evelyn,1,Entire home/apt,190,0,2.3,190
1728,Jennifer,1,Private room,69,235,0.61,304
1729,Massi & Ray,3,Private room,70,303,1.9,373
1730,Anthony,2,Entire home/apt,155,0,0.1,155
1731,Aswad,2,Entire home/apt,149,329,0.88,478
1732,Nathalie,1,Private room,160,295,1.83,455
1733,Pam,2,Private room,100,214,0.02,314
1734,Mark,1,Entire home/apt,220,350,0.01,570
1735,Christian & Carla,1,Private room,85,339,2.63,424
1736,Wiebke,1,Entire home/apt,135,0,0.24,135
1737,Gina,2,Private room,45,359,2.3,404
1738,Lauren,1,Entire home/apt,225,265,0.72,490
1739,Alison,1,Entire home/apt,100,0,0.18,100
1740,Mariana,2,Entire home/apt,145,45,1.51,190
1741,Dawn,1,Entire home/apt,210,305,1.35,515
1742,Rita,2,Entire home/apt,195,95,0.13,290
1743,Luis,1,Private room,95,0,0.57,95
1744,Carl,1,Entire home/apt,140,159,0.43,299
1745,Kiersten,1,Private room,95,0,0.48,95
1746,Adam,1,Entire home/apt,295,0,0.14,295
1748,Michelle,1,Entire home/apt,250,126,0.2,376
1749,Claudia,4,Entire home/apt,60,311,0.67,371
1750,Meredith,1,Entire home/apt,150,0,0.06,150
1751,Martin,1,Entire home/apt,159,141,3.58,300
1753,Cruz,1,Private room,78,0,0.66,78
1754,Linna,1,Entire home/apt,210,36,0.6,246
1755,Hayley,2,Private room,60,0,0.22,60
1756,Amir,1,Entire home/apt,220,0,0.29,220
1757,David,2,Entire home/apt,199,90,0.32,289
1758,David,2,Entire home/apt,225,0,0.23,225
1759,Jo,1,Entire home/apt,350,0,0.16,350
1760,Greer,1,Private room,65,0,1.16,65
1761,Raquel,1,Entire home/apt,225,250,0.06,475
1762,Rachel,2,Private room,82,247,0.8,329
1763,Stephanie,1,Private room,75,129,0.73,204
1765,Fran,1,Entire home/apt,105,84,0.16,189
1766,Alexandra,2,Entire home/apt,115,0,0.18,115
1767,D,1,Entire home/apt,150,207,0.05,357
1768,Mike,2,Private room,65,0,0.14,65
1769,Doris,2,Entire home/apt,150,15,0.3,165
1770,Suzanne,2,Private room,101,0,0.4,101
1771,Ms,1,Entire home/apt,130,19,0.32,149
1773,Alex,1,Entire home/apt,175,0,0.03,175
1774,Martin,1,Entire home/apt,115,237,2.32,352
1775,Sarah,2,Entire home/apt,128,301,1.93,429
1776,Mike,1,Entire home/apt,116,311,0.09,427
1777,Ted,1,Entire home/apt,192,0,0.6,192
1778,Nora,2,Entire home/apt,150,0,0.07,150
1779,Tommy,2,Entire home/apt,163,0,0.04,163
1780,Obed,2,Private room,40,284,0.4,324
1781,Zoe,2,Entire home/apt,200,174,0.09,374
1782,Stefan,1,Entire home/apt,158,0,0.55,158
1783,Lisel,2,Private room,115,89,0.36,204
1784,Michelle,1,Private room,85,178,3.7,263
1785,Adam,1,Entire home/apt,173,0,0.2,173
1786,Arsenio,2,Entire home/apt,250,250,0.08,500
1787,Jenny,1,Entire home/apt,465,277,0.67,742
1788,Sigfus,2,Entire home/apt,275,0,0.03,275
1789,Michael,1,Private room,195,134,0.77,329
1790,Karen,2,Entire home/apt,63,0,0.06,63
1791,Tiffany,1,Private room,36,211,0.77,247
1792,Doug,2,Entire home/apt,130,0,0.04,130
1793,Patrick,2,Entire home/apt,200,0,0.22,200
1794,Leah & Reed,2,Private room,85,278,0.45,363
1796,Jacqueline & Tyas,3,Private room,45,213,1.12,258
1797,Jacqueline & Tyas,3,Private room,45,208,1.57,253
1798,Martina,2,Private room,79,198,0.21,277
1799,Brandon,2,Entire home/apt,149,0,0.01,149
1800,Suzana,1,Entire home/apt,200,0,0.04,200
1801,Wendee,1,Private room,85,365,0.01,450
1802,Renee,3,Private room,60,351,0.31,411
1803,Karen,1,Entire home/apt,139,0,0.21,139
1804,Julia,2,Entire home/apt,160,59,0.26,219
1805,Jhon,1,Private room,95,192,1.88,287
1806,Luka,2,Private room,80,0,0.3,80
1807,Said,2,Entire home/apt,250,0,0.03,250
1808,Justin,1,Entire home/apt,349,0,0.07,349
1809,Connie & Michael,1,Entire home/apt,165,234,0.1,399
1810,Darren,2,Entire home/apt,119,0,0.53,119
1811,Bryan,1,Entire home/apt,240,0,0.1,240
1812,Jo,2,Private room,79,359,0.02,438
1813,Debbie,2,Entire home/apt,215,300,0.01,515
1814,Jesse,2,Private room,49,100,0.95,149
1815,Angelina,2,Entire home/apt,190,48,0.95,238
1816,Jason,1,Entire home/apt,99,30,0.65,129
1817,Obed,2,Private room,68,280,0.5,348
1818,Valeria,2,Entire home/apt,185,358,0.58,543
1819,Peter,1,Entire home/apt,225,67,1.47,292
1820,Jefry,1,Private room,81,311,0.93,392
1821,Alta,1,Entire home/apt,199,0,0.38,199
1822,Albert,2,Private room,55,0,0.03,55
1823,Marina,1,Entire home/apt,340,302,0.54,642
1824,Jennifer,1,Entire home/apt,135,184,3.19,319
1825,Alvaro,3,Entire home/apt,85,0,1.35,85
1826,Elise,2,Entire home/apt,65,0,0.09,65
1827,Tristan,1,Entire home/apt,100,219,0.18,319
1828,Ana,2,Private room,109,284,0.92,393
1829,Annie,1,Entire home/apt,290,339,0.92,629
1831,Shane,1,Entire home/apt,148,188,0.37,336
1832,Celeste,3,Private room,57,308,0.21,365
1833,Nathalie,1,Entire home/apt,150,0,0.31,150
1834,Ale,1,Private room,60,117,0.88,177
1835,Ale,1,Private room,60,114,0.61,174
1836,Christopher,1,Shared room,45,313,1.5,358
1837,Ale,1,Private room,60,211,0.46,271
1838,Tanjila,2,Entire home/apt,125,158,1.56,283
1839,Ale,1,Private room,60,133,0.54,193
1840,Jerbean,2,Private room,75,365,0.51,440
1841,Thomas,1,Entire home/apt,121,156,0.09,277
1842,Autumn,2,Private room,89,318,1.12,407
1843,LeeAnn,2,Entire home/apt,300,0,0.02,300
1844,Annie,2,Private room,110,0,0.18,110
1845,Amanda,2,Entire home/apt,99,81,0.13,180
1846,Owen,2,Entire home/apt,170,0,0.55,170
1847,Seema,2,Private room,90,30,0.3,120
1848,Arthur,1,Private room,179,157,3.15,336
1849,Ettice,1,Private room,80,119,0.52,199
1850,Ettice,1,Private room,65,186,0.4,251
1851,Anja,1,Private room,69,84,4.46,153
1852,Kamollio,2,Private room,42,60,0.35,102
1853,Dina,2,Private room,70,0,0.1,70
1854,Jon,2,Entire home/apt,155,189,0.28,344
1855,Francesco,1,Entire home/apt,135,19,2.83,154
1856,Mike,1,Private room,120,34,1.04,154
1857,Jeff,2,Entire home/apt,135,0,0.14,135
1858,Anna,5,Private room,47,323,0.26,370
1859,Adrian,1,Private room,69,280,0.23,349
1860,Kat,2,Private room,100,2,0.52,102
1861,Keithan,2,Private room,51,32,3.04,83
1863,Marie,1,Private room,65,263,0.07,328
1864,Shahar,2,Private room,60,120,3.59,180
1865,Monica,2,Private room,70,188,1.06,258
1866,Ms,1,Entire home/apt,130,23,0.41,153
1867,Kayla,2,Private room,70,325,0.48,395
1868,Gabe And Jane,2,Entire home/apt,200,266,3.37,466
1869,Jennifer,2,Entire home/apt,150,0,0.14,150
1870,Bob,1,Entire home/apt,130,9,0.59,139
1871,Anna,2,Private room,68,87,0.01,155
1872,Rebecca,1,Private room,79,298,1.98,377
1873,Ef,1,Entire home/apt,149,0,0.19,149
1875,Nick,1,Entire home/apt,250,0,0.03,250
1876,Scott,1,Entire home/apt,175,0,0.29,175
1877,Vero,1,Private room,40,353,0.05,393
1878,O.,2,Private room,55,11,0.23,66
1879,Carol,1,Private room,99,179,6.95,278
1881,Jh,1,Entire home/apt,240,330,0.37,570
1882,Manuel Alberto,3,Entire home/apt,400,361,0.61,761
1884,Jared,1,Entire home/apt,235,177,0.08,412
1885,Eileen,1,Entire home/apt,130,0,0.05,130
1886,Casey,2,Entire home/apt,96,77,2.82,173
1887,Antonio,3,Private room,63,249,0.33,312
1888,Katherine / François,2,Entire home/apt,150,176,0.17,326
1889,Ronny,2,Entire home/apt,200,0,0.23,200
1890,Laura,2,Entire home/apt,90,0,0.08,90
1891,David,1,Entire home/apt,269,0,0.22,269
1893,Holly,2,Private room,80,0,0.33,80
1894,Fiona,1,Entire home/apt,400,365,0.1,765
1895,Jeffrey,1,Entire home/apt,349,356,0.21,705
1896,Joanna,1,Entire home/apt,495,334,0.93,829
1897,Todd,2,Entire home/apt,85,22,0.17,107
1898,John,2,Entire home/apt,85,0,0.28,85
1899,Joseph,1,Private room,999,365,0.4,1364
1900,Aaron,1,Private room,109,18,0.36,127
1901,Andrew,1,Entire home/apt,175,1,0.63,176
1902,Melanie,1,Entire home/apt,150,18,0.31,168
1903,Pierre  & Amira,2,Private room,80,245,1.08,325
1904,Lisa,1,Entire home/apt,150,0,0.01,150
1905,Ashley,1,Entire home/apt,175,0,0.44,175
1906,Jason,3,Entire home/apt,107,268,0.19,375
1907,Roman,1,Entire home/apt,80,226,0.28,306
1908,Celeste,3,Private room,80,342,0.17,422
1909,Stav,1,Private room,75,0,0.06,75
1910,Alex & Britta,2,Entire home/apt,800,365,0.45,1165
1911,Camille,2,Entire home/apt,130,237,2.91,367
1913,Felix,1,Entire home/apt,260,0,0.3,260
1914,Ian,2,Private room,36,83,0.1,119
1915,Lewis,2,Entire home/apt,140,35,0.18,175
1916,Ren,1,Entire home/apt,145,268,2.97,413
1917,Clara,2,Entire home/apt,120,0,0.13,120
1918,Pam,2,Private room,75,112,0.06,187
1919,Luis Alejandro,2,Private room,60,0,0.04,60
1920,Maddy,2,Private room,69,7,0.67,76
1921,Jb,1,Private room,95,0,0.12,95
1922,Dirk,1,Entire home/apt,300,284,1.24,584
1923,Dee,1,Private room,131,1,2.85,132
1924,Oded,2,Entire home/apt,120,0,0.1,120
1925,Luca,2,Entire home/apt,100,94,0.25,194
1926,Rohit,2,Entire home/apt,100,0,0.26,100
1928,Gregory,1,Entire home/apt,160,221,2.36,381
1929,Celeste,3,Private room,60,314,0.22,374
1930,Keturah,2,Private room,75,311,0.82,386
1931,Celeste,3,Private room,45,292,0.52,337
1932,Stella,1,Private room,65,361,0.2,426
1933,Bernard,2,Entire home/apt,120,0,1.82,120
1934,Geraldine,1,Entire home/apt,80,0,0.2,80
1935,Ayana,2,Entire home/apt,100,56,0.67,156
1936,Ceci,2,Entire home/apt,250,0,1.08,250
1937,Taleah,1,Entire home/apt,235,40,1.47,275
1938,Julie,2,Private room,85,365,0.55,450
1939,Zs,1,Entire home/apt,195,273,0.1,468
1940,Thomas,2,Entire home/apt,145,151,2.15,296
1942,Brendan,2,Entire home/apt,289,354,0.51,643
1943,Mario,1,Entire home/apt,120,231,0.27,351
1944,Julie,2,Entire home/apt,149,14,0.41,163
1945,Tiziana,1,Shared room,100,364,0.4,464
1946,Ari,1,Entire home/apt,166,188,0.19,354
1947,Ks & Eli,1,Entire home/apt,99,331,1.43,430
1948,Hannah,2,Entire home/apt,150,230,0.58,380
1949,Raymond,2,Shared room,44,325,2.11,369
1950,Sandi,1,Entire home/apt,195,90,0.18,285
1952,Eddie,1,Private room,100,7,0.11,107
1953,Cristian,2,Entire home/apt,60,189,0.06,249
1954,Samuel,1,Private room,62,310,0.64,372
1955,Sunny,1,Private room,99,0,0.14,99
1956,Stefan,1,Private room,90,35,0.46,125
1957,Robert,1,Private room,88,98,1.41,186
1958,Marina,1,Entire home/apt,125,135,1.37,260
1959,Alicia,2,Private room,74,283,0.1,357
1960,Peter,1,Entire home/apt,176,0,0.42,176
1961,Karen,2,Private room,62,158,0.14,220
1962,Sergio,1,Private room,51,0,0.1,51
1963,Tara,2,Entire home/apt,249,365,0.4,614
1964,Ally,1,Entire home/apt,200,157,2.02,357
1965,Douglas,4,Private room,30,208,3.69,238
1966,Erica,2,Entire home/apt,240,280,0.29,520
1967,Aaron,1,Private room,100,316,0.83,416
1968,Judith,1,Entire home/apt,125,199,0.9,324
1969,James,2,Entire home/apt,149,125,1.1,274
1970,Claire,2,Entire home/apt,170,275,4.03,445
1971,Rachel...You Can Call Me Kaya :),1,Private room,150,365,0.15,515
1972,Nicole,1,Private room,125,326,0.99,451
1973,Chandle,2,Private room,68,282,0.56,350
1974,George,1,Private room,90,312,0.48,402
1975,Ben,1,Private room,65,361,0.88,426
1976,O.,2,Private room,50,193,0.25,243
1977,Ines,2,Private room,65,35,1.68,100
1978,Chiara,2,Entire home/apt,200,283,0.02,483
1979,Ines,2,Private room,65,73,1.47,138
1980,Seth,2,Private room,58,0,0.1,58
1981,Nick,1,Private room,65,0,0.05,65
1982,Jessica,2,Entire home/apt,185,8,0.22,193
1983,Clare,2,Entire home/apt,115,0,0.08,115
1986,Maria,2,Entire home/apt,115,282,0.25,397
1987,Becky,2,Entire home/apt,140,239,1.6,379
1988,Alvin,2,Private room,62,87,0.37,149
1989,Joan,2,Entire home/apt,95,310,2.0,405
1990,Michael,2,Entire home/apt,100,0,0.11,100
1991,Marise,1,Entire home/apt,113,343,0.95,456
1992,Vivian,1,Entire home/apt,108,230,0.07,338
1993,Ines,2,Private room,62,59,1.43,121
1994,Hoonju / Co Host: Jose,2,Entire home/apt,95,89,0.95,184
1995,Alana,2,Entire home/apt,200,0,0.42,200
1996,Rochelle,1,Entire home/apt,165,347,0.3,512
1997,Jeremy,2,Private room,60,2,1.52,62
1998,Nikki,2,Private room,80,89,0.56,169
1999,Jake,2,Entire home/apt,100,0,1.07,100
2000,Idan,1,Private room,110,281,2.79,391
2001,Vivian,2,Shared room,50,365,0.2,415
2002,Autumn,2,Private room,79,361,1.41,440
2003,Antoinette,2,Entire home/apt,140,65,1.24,205
2004,Julie,1,Entire home/apt,339,167,0.37,506
2005,Christina,3,Private room,55,298,1.51,353
2006,Christina,3,Entire home/apt,81,263,4.09,344
2007,Jon,2,Entire home/apt,191,21,2.08,212
2008,Robert,2,Entire home/apt,139,248,1.42,387
2009,D,1,Entire home/apt,500,281,0.02,781
2010,Caroline,2,Entire home/apt,120,280,0.35,400
2011,Elisa,1,Private room,60,0,0.86,60
2013,Andrew,2,Entire home/apt,295,365,0.11,660
2014,Magera,2,Entire home/apt,100,0,0.13,100
2015,Jj,1,Private room,49,339,7.57,388
2016,Wil,1,Entire home/apt,150,0,0.12,150
2017,Richelle & Neil,2,Entire home/apt,120,161,2.12,281
2018,Martin,1,Entire home/apt,2500,89,0.26,2589
2019,Kristen,1,Entire home/apt,175,188,0.63,363
2020,Damon And Kent,2,Entire home/apt,107,27,1.89,134
2021,Lacey,2,Private room,98,268,1.01,366
2022,Sheena,3,Private room,47,0,1.05,47
2024,Jeanine,1,Entire home/apt,170,29,1.13,199
2025,Brian,1,Entire home/apt,150,184,1.17,334
2026,Jeanette & Henry,3,Entire home/apt,63,256,1.35,319
2027,Selam,2,Shared room,110,34,0.36,144
2029,Christine & Philip,2,Entire home/apt,329,0,0.05,329
2030,Jj,1,Private room,49,342,7.72,391
2031,Jj,1,Private room,49,293,7.75,342
2032,Howard,2,Entire home/apt,165,343,0.47,508
2033,Painter,2,Entire home/apt,160,281,2.1,441
2034,Shelley,2,Private room,38,283,0.93,321
2035,Joy,1,Entire home/apt,170,333,0.37,503
2036,Irene,1,Private room,105,294,3.01,399
2037,Joseph,2,Private room,50,249,0.42,299
2039,Toby,1,Entire home/apt,100,0,0.06,100
2040,Laurence,2,Entire home/apt,890,341,0.34,1231
2041,Gershwyn,1,Private room,160,352,0.31,512
2042,Darina,1,Entire home/apt,145,221,2.03,366
2043,Maria,2,Private room,51,188,0.06,239
2044,Roslyn,2,Entire home/apt,150,301,1.8,451
2045,Luis,1,Private room,180,31,0.08,211
2046,Darla,1,Entire home/apt,225,188,0.04,413
2047,Liz,1,Entire home/apt,250,217,0.66,467
2048,Rachel,2,Private room,56,65,1.6,121
2049,Mitty,2,Private room,70,212,0.94,282
2050,Kevin,2,Private room,70,163,2.13,233
2051,Eduardo,1,Private room,125,161,2.17,286
2052,Time Square,1,Entire home/apt,399,284,3.69,683
2053,Sarah,2,Entire home/apt,157,24,0.03,181
2054,Meryl,2,Entire home/apt,145,188,0.39,333
2055,Michelle,1,Private room,75,90,1.89,165
2056,Stelian & Deanna,2,Entire home/apt,280,280,0.89,560
2057,Emmanuel,2,Entire home/apt,220,8,0.3,228
2058,George,1,Entire home/apt,190,283,0.41,473
2059,Cody,1,Entire home/apt,200,354,0.28,554
2060,Tzvi,3,Entire home/apt,77,168,1.02,245
2061,Gloria,2,Private room,35,244,0.91,279
2062,Gloria,2,Shared room,30,248,1.18,278
2063,Christian,1,Entire home/apt,199,31,0.17,230
2064,Paul & Elena,1,Entire home/apt,140,157,0.33,297
2065,Karla,1,Entire home/apt,124,42,0.07,166
2066,Jonathan,1,Entire home/apt,295,316,1.23,611
2067,L,1,Entire home/apt,160,335,0.17,495
2068,Harry,3,Private room,349,365,0.39,714
2069,Erica,2,Private room,98,158,0.5,256
2070,Terri,3,Private room,76,0,1.0,76
2071,Meg,1,Entire home/apt,230,282,0.26,512
2072,Lucas,2,Private room,60,0,0.66,60
2074,Min,1,Private room,118,228,1.93,346
2075,Kate,2,Private room,125,311,0.45,436
2076,Sandra,2,Entire home/apt,195,233,0.72,428
2077,Nick & Jim,1,Private room,85,63,1.31,148
2078,Anthony,1,Private room,55,41,0.23,96
2079,Michael,2,Entire home/apt,155,0,0.26,155
2080,Gregory,2,Private room,99,358,1.22,457
2081,Diane And Craig,1,Entire home/apt,140,194,1.05,334
2082,Kayla,2,Private room,85,340,0.43,425
2083,Ni,2,Entire home/apt,75,178,0.23,253
2084,Chandle,2,Private room,53,282,0.52,335
2085,Michael,2,Entire home/apt,150,365,0.72,515
2086,Rod,1,Entire home/apt,179,202,2.7,381
2087,Rusty,2,Entire home/apt,135,348,0.87,483
2088,Andrew,1,Entire home/apt,200,48,0.59,248
2089,Lindsay,1,Entire home/apt,200,0,0.05,200
2090,William M.,2,Entire home/apt,100,73,1.61,173
2091,Kevin,2,Entire home/apt,134,0,0.18,134
2092,Seth,1,Private room,100,231,5.39,331
2093,Georgina,1,Private room,50,269,0.16,319
2094,Brian,2,Private room,50,324,0.21,374
2095,Tal,2,Entire home/apt,400,67,0.39,467
2096,Alice,3,Entire home/apt,115,314,0.96,429
2097,Dom,1,Entire home/apt,235,44,0.94,279
2098,Alain,1,Entire home/apt,125,188,0.66,313
2099,Nicole,1,Entire home/apt,250,134,0.73,384
2100,Ben,1,Entire home/apt,650,90,0.09,740
2101,Mitty,2,Private room,97,204,0.17,301
2102,Dikla,2,Entire home/apt,189,279,3.08,468
2103,Sabrina,1,Entire home/apt,100,281,1.76,381
2104,Natasha,2,Private room,49,323,1.49,372
2105,Noelva,4,Entire home/apt,84,0,0.91,84
2106,Daniel,2,Entire home/apt,165,0,0.09,165
2107,Michelle,1,Entire home/apt,87,0,0.66,87
2108,Derek,2,Private room,120,9,0.21,129
2109,Lauren,1,Entire home/apt,195,270,0.13,465
2110,Kayla,2,Private room,89,365,0.3,454
2111,Deanna,2,Private room,62,267,4.3,329
2112,Rosana,2,Entire home/apt,130,340,0.69,470
2113,Javier,1,Private room,75,127,0.7,202
2114,Mark,2,Private room,64,329,0.46,393
2115,Patrick And Erin,2,Entire home/apt,150,364,0.14,514
2116,Liya,1,Private room,100,350,0.7,450
2117,Larry,1,Entire home/apt,190,244,2.09,434
2118,M,2,Private room,98,273,0.09,371
2119,Patricia,2,Entire home/apt,150,0,0.63,150
2120,Gonzalo And Nora,3,Entire home/apt,99,322,2.08,421
2122,Timothy,1,Entire home/apt,159,1,0.85,160
2123,Deacon,2,Private room,70,146,0.32,216
2124,John,1,Private room,91,1,5.16,92
2125,Gerard,2,Entire home/apt,325,363,0.19,688
2126,Simo,2,Entire home/apt,149,313,0.46,462
2127,Anna,1,Entire home/apt,200,51,0.46,251
2128,Matthew,1,Entire home/apt,169,59,0.8,228
2129,Betsy,1,Entire home/apt,249,5,0.3,254
2130,Yiota,3,Entire home/apt,85,254,3.44,339
2131,Rosa,3,Private room,81,326,2.45,407
2132,Lynn,1,Entire home/apt,199,322,0.72,521
2133,Alix,1,Entire home/apt,88,47,0.48,135
2134,Maria,1,Entire home/apt,170,273,0.01,443
2136,Eileen,2,Entire home/apt,130,329,0.04,459
2137,Brinton,1,Entire home/apt,135,253,2.63,388
2138,Rosana,2,Entire home/apt,65,188,0.36,253
2140,Adrianne,1,Entire home/apt,165,177,3.68,342
2141,Rosa,3,Private room,78,348,1.64,426
2142,Emily,2,Entire home/apt,350,0,0.17,350
2143,Rose,3,Entire home/apt,160,298,1.29,458
2144,Nikolai,2,Entire home/apt,225,188,0.08,413
2145,Lauri,1,Entire home/apt,170,177,0.34,347
2146,Dn,1,Private room,349,87,0.04,436
2147,Elisa,1,Private room,65,251,0.78,316
2148,Sascha,1,Private room,420,301,2.39,721
2149,Brian,1,Entire home/apt,119,0,0.22,119
2150,Shahdiya,2,Entire home/apt,100,365,0.01,465
2151,Barbara,1,Entire home/apt,97,6,2.46,103
2152,Izi,1,Entire home/apt,191,346,0.11,537
2153,Izi,1,Entire home/apt,187,346,0.2,533
2154,Izi,1,Entire home/apt,172,346,0.08,518
2155,Ricky,1,Entire home/apt,950,357,1.52,1307
2156,Charlotta,2,Entire home/apt,275,310,1.07,585
2157,Karen,1,Entire home/apt,99,113,0.02,212
2158,Nick,1,Entire home/apt,334,238,0.24,572
2159,Sanya,1,Private room,60,0,0.02,60
2160,Darnell And Allison,2,Entire home/apt,145,303,2.62,448
2161,Casey,3,Private room,75,10,0.52,85
2162,Mischa,1,Entire home/apt,130,11,0.43,141
2163,Jon,1,Entire home/apt,575,207,5.89,782
2164,Jennifer,1,Entire home/apt,295,0,0.03,295
2165,Linda,1,Entire home/apt,300,318,1.44,618
2166,Priscilla,2,Entire home/apt,120,280,0.02,400
2167,Kate,2,Private room,50,171,1.22,221
2168,Pete & Marcos,1,Shared room,56,303,1.53,359
2169,Ellen,1,Entire home/apt,191,347,0.94,538
2170,Greta,1,Private room,135,44,0.93,179
2171,Finola,2,Entire home/apt,195,94,1.39,289
2172,Michael,1,Shared room,75,9,0.61,84
2173,Yakov & Cynthia,1,Private room,99,83,0.6,182
2174,Jana,2,Entire home/apt,350,22,0.59,372
2175,Chris,2,Entire home/apt,40,365,0.13,405
2176,Ahmed,3,Entire home/apt,130,301,0.77,431
2177,Nate,2,Entire home/apt,225,339,0.64,564
2178,Vera,2,Entire home/apt,225,342,0.11,567
2179,Lou,3,Shared room,38,55,1.67,93
2180,Paul,2,Entire home/apt,200,11,0.17,211
2182,Sabrina And Eduardo,2,Entire home/apt,235,3,0.07,238
2183,Alicia,2,Private room,75,365,0.11,440
2184,Pete,2,Entire home/apt,249,273,0.94,522
2185,Heather,2,Entire home/apt,120,0,0.1,120
2186,Jen,2,Private room,50,343,0.03,393
2187,Sabrina,2,Entire home/apt,85,149,0.85,234
2188,Cynthia,2,Private room,78,95,0.14,173
2189,Keith,1,Private room,110,0,0.69,110
2190,Mitty,2,Private room,50,315,1.82,365
2191,Sarah,1,Private room,52,0,2.17,52
2193,Melissa,1,Entire home/apt,105,109,0.26,214
2194,Livia,3,Private room,75,333,1.74,408
2195,Atlanta,3,Private room,69,365,0.18,434
2196,Sam,1,Entire home/apt,165,311,0.15,476
2197,Meredith,2,Entire home/apt,125,0,0.66,125
2198,Julio,4,Private room,85,363,0.18,448
2199,East Village Loft,1,Entire home/apt,499,341,0.63,840
2200,Claudia,1,Private room,60,232,0.87,292
2201,Kelly,1,Private room,95,320,0.46,415
2202,Hayley,2,Entire home/apt,105,0,1.01,105
2203,Kyla,2,Private room,55,235,0.86,290
2204,M,2,Entire home/apt,289,88,0.58,377
2205,Audrey,2,Private room,70,0,0.6,70
2207,Sandrine,1,Entire home/apt,130,231,0.16,361
2208,Rachael,2,Entire home/apt,125,3,0.61,128
2209,Christine,2,Entire home/apt,150,23,0.23,173
2210,Daniel,3,Private room,46,173,0.93,219
2211,Mary,1,Entire home/apt,100,221,2.97,321
2212,Alexander,2,Private room,90,0,0.11,90
2213,Marc,2,Entire home/apt,90,104,2.21,194
2214,Fabia,1,Entire home/apt,220,0,0.02,220
2215,Jon,1,Entire home/apt,1000,37,0.36,1037
2216,Jeffrey,2,Entire home/apt,130,171,0.72,301
2217,S,1,Entire home/apt,499,303,1.68,802
2218,Colin,1,Private room,45,197,3.05,242
2219,Elizabeth,2,Entire home/apt,70,288,2.79,358
2220,Linda,3,Private room,59,322,3.7,381
2221,Lindsay,1,Entire home/apt,160,0,1.16,160
2222,Obora & Michael,1,Entire home/apt,195,278,1.76,473
2223,Nigel,2,Private room,96,364,0.77,460
2224,Daniel,2,Private room,75,136,2.39,211
2225,Brady,2,Entire home/apt,195,273,2.34,468
2226,Chris,3,Private room,200,364,0.68,564
2227,Elise,2,Entire home/apt,139,205,0.38,344
2228,Laura,1,Entire home/apt,190,84,0.43,274
2229,Lisa,1,Private room,95,320,0.57,415
2230,Jose,1,Entire home/apt,350,364,0.1,714
2231,Kristin,1,Private room,80,217,0.1,297
2232,L.A.,1,Entire home/apt,120,242,1.11,362
2233,Emilie,1,Private room,42,357,0.79,399
2234,Clyde,2,Entire home/apt,116,127,1.49,243
2235,Chris And Zach,2,Private room,60,19,4.72,79
2236,Loretta,2,Entire home/apt,1395,362,0.73,1757
2237,Marina,1,Entire home/apt,425,358,0.91,783
2238,Noreen,2,Entire home/apt,225,251,1.26,476
2239,Shunan,1,Entire home/apt,159,0,0.25,159
2241,Anthony,1,Private room,150,365,0.74,515
2242,Mark,1,Entire home/apt,199,300,1.54,499
2243,Candace,2,Private room,70,0,0.06,70
2244,Amy,1,Entire home/apt,110,84,3.14,194
2245,Aurora,2,Private room,60,18,0.13,78
2246,Nevena,2,Private room,50,0,0.08,50
2247,Tim,1,Private room,120,240,4.79,360
2249,Rachael,2,Private room,60,57,0.68,117
2250,Michael,1,Entire home/apt,145,148,1.94,293
2251,Stephanie,2,Entire home/apt,83,26,0.21,109
2252,Swetha,1,Private room,100,355,0.87,455
2253,Tara,2,Entire home/apt,200,0,0.08,200
2254,Eo,1,Private room,50,211,1.97,261
2255,Michael,1,Private room,70,15,2.72,85
2256,Emma,2,Entire home/apt,175,218,3.68,393
2257,Alex,2,Entire home/apt,149,265,0.36,414
2258,Orren,2,Entire home/apt,125,300,2.15,425
2259,Nancy,1,Private room,58,284,4.3,342
2260,Kia,3,Entire home/apt,160,56,0.26,216
2261,Sen,3,Entire home/apt,150,365,0.12,515
2262,Shayne,1,Entire home/apt,131,33,0.61,164
2263,Shayne,1,Entire home/apt,250,327,0.39,577
2264,Edward,3,Private room,70,359,1.81,429
2265,Michael,1,Entire home/apt,149,0,0.35,149
2266,Doug,2,Entire home/apt,109,339,0.96,448
2267,Maja & Pierre,1,Private room,185,127,3.22,312
2268,Hasan,2,Entire home/apt,138,356,0.1,494
2269,David,1,Private room,150,0,0.48,150
2270,Verna,2,Private room,80,283,0.2,363
2271,Leigh,2,Entire home/apt,75,0,0.03,75
2272,George,1,Entire home/apt,300,87,0.62,387
2273,D. Anthony,1,Private room,176,268,1.63,444
2274,Karen,2,Private room,47,0,3.27,47
2275,Gen,1,Private room,40,272,0.67,312
2277,Devi,2,Private room,89,24,0.66,113
2278,Elisa,1,Private room,75,12,2.03,87
2279,Michelle,2,Entire home/apt,110,284,2.72,394
2280,Mary Anne,1,Entire home/apt,85,0,0.47,85
2281,Susan,2,Private room,72,71,0.72,143
2283,Ife,1,Private room,85,72,3.12,157
2284,Steve And Heather,2,Entire home/apt,325,328,0.31,653
2285,Wilfredo,2,Entire home/apt,125,365,1.55,490
2286,Chris,1,Entire home/apt,200,0,0.06,200
2287,Lelia,2,Entire home/apt,195,345,0.51,540
2289,Judy,2,Entire home/apt,189,247,3.01,436
2290,Teedo,2,Entire home/apt,182,23,0.37,205
2291,Eric,2,Entire home/apt,105,277,4.73,382
2292,Scooter,1,Entire home/apt,240,321,0.89,561
2293,Ingrid,2,Entire home/apt,185,215,1.33,400
2294,Yuko,1,Entire home/apt,160,168,0.07,328
2295,James,1,Entire home/apt,250,11,0.31,261
2296,Victoria,1,Entire home/apt,650,256,0.48,906
2297,Devika,3,Private room,35,250,1.76,285
2298,Angus,2,Entire home/apt,85,360,0.97,445
2299,Evelyn,2,Entire home/apt,550,1,0.3,551
2300,Gee,2,Private room,80,159,0.62,239
2301,Greg,2,Entire home/apt,175,291,0.43,466
2302,Autumn,2,Private room,95,354,1.75,449
2303,George,1,Entire home/apt,158,314,0.49,472
2304,Loli,1,Private room,85,5,0.58,90
2305,David,1,Entire home/apt,209,365,0.46,574
2306,Marta,2,Entire home/apt,150,3,0.29,153
2307,Marta,2,Private room,70,13,0.88,83
2308,William,3,Private room,73,363,0.13,436
2309,Kamala,2,Private room,85,0,0.02,85
2310,Trevor,2,Entire home/apt,95,246,2.92,341
2311,Simona,2,Entire home/apt,125,0,0.26,125
2312,Sky,1,Private room,89,190,0.41,279
2313,Joseph,2,Private room,50,232,0.51,282
2314,Todd,2,Private room,75,307,0.99,382
2315,@ Art House Monique,2,Private room,60,26,0.87,86
2316,Gen,1,Private room,45,244,0.54,289
2317,Bjarke And Holly,2,Entire home/apt,130,296,0.02,426
2318,Gita,1,Private room,70,365,0.22,435
2319,Meredith,1,Private room,125,216,3.3,341
2320,Izz,1,Entire home/apt,140,228,1.68,368
2321,Christy,2,Entire home/apt,120,201,0.18,321
2322,Andrian,2,Private room,99,250,0.17,349
2323,Tina,2,Entire home/apt,300,15,0.02,315
2325,Craig,1,Private room,47,285,0.81,332
2326,Cheryl,1,Private room,115,339,0.48,454
2327,Serge,2,Entire home/apt,90,0,0.05,90
2328,Brian,1,Entire home/apt,199,330,0.63,529
2329,Marianna,1,Entire home/apt,110,15,1.09,125
2330,Madison,2,Entire home/apt,100,99,4.11,199
2331,Matt,2,Private room,90,336,1.09,426
2332,@ Art House Monique,2,Private room,40,118,0.89,158
2333,Timothy,1,Entire home/apt,133,279,0.26,412
2334,Erin,2,Private room,130,0,0.11,130
2335,Karen,1,Entire home/apt,79,36,0.16,115
2336,Tim,1,Entire home/apt,200,188,0.35,388
2337,Raquel,1,Entire home/apt,175,194,0.25,369
2338,Jeffrey,2,Entire home/apt,200,0,0.52,200
2340,Paresh,2,Entire home/apt,300,365,0.46,665
2341,Audra,1,Private room,135,219,0.17,354
2342,Jenny,2,Entire home/apt,189,265,2.36,454
2344,Dan,2,Private room,65,0,0.11,65
2345,Erica,1,Entire home/apt,179,0,0.36,179
2346,Stuart,1,Entire home/apt,90,279,0.18,369
2347,Katie,2,Private room,49,98,0.19,147
2348,Elon,2,Entire home/apt,140,197,1.19,337
2349,Samuel,1,Entire home/apt,115,120,0.95,235
2350,Lucien,2,Entire home/apt,190,238,3.0,428
2351,Summer,2,Private room,99,0,2.61,99
2352,Mike,1,Entire home/apt,110,365,0.06,475
2353,Jc,1,Private room,109,231,3.9,340
2354,Stephen,1,Private room,64,0,0.56,64
2355,Henry,1,Entire home/apt,1000,364,0.33,1364
2356,Mark,1,Entire home/apt,750,364,0.18,1114
2357,Litza,3,Entire home/apt,175,8,0.03,183
2358,Sergio,1,Private room,47,353,0.08,400
2359,Yoki,2,Private room,60,189,1.87,249
2360,Marcelo,1,Private room,48,287,0.62,335
2361,Suzanne,1,Entire home/apt,100,0,0.75,100
2362,Alex,2,Private room,105,88,1.72,193
2363,Eliza,2,Entire home/apt,138,0,0.01,138
2364,Mickey,1,Entire home/apt,129,324,1.31,453
2365,Neni,1,Entire home/apt,170,1,0.07,171
2366,Lisa,2,Entire home/apt,139,160,3.8,299
2367,Alex,1,Private room,94,218,0.4,312
2368,Katie,1,Private room,115,0,0.03,115
2369,Jon,2,Entire home/apt,499,256,1.75,755
2370,Shaila & Alex,2,Entire home/apt,79,250,2.66,329
2371,Derek,1,Entire home/apt,200,0,1.34,200
2372,LiVi,2,Private room,152,241,0.17,393
2373,Radium,2,Private room,50,205,0.13,255
2374,Liza,2,Entire home/apt,212,147,0.91,359
2375,K. Naomi,1,Private room,108,38,0.06,146
2376,Kurt,1,Private room,89,282,0.18,371
2377,LaNola,1,Private room,89,47,3.66,136
2378,John,3,Private room,65,332,0.16,397
2379,Ali,1,Entire home/apt,239,184,0.04,423
2380,Eric,2,Entire home/apt,99,280,0.25,379
2381,Celine,1,Private room,80,249,0.76,329
2383,Patricia,2,Private room,55,308,1.57,363
2384,Alyssia,2,Entire home/apt,160,0,0.42,160
2385,Pierre,1,Private room,100,197,0.08,297
2387,Jon,1,Entire home/apt,225,10,1.83,235
2389,Erin,1,Entire home/apt,275,191,0.08,466
2390,Ana,2,Entire home/apt,200,109,3.93,309
2391,Jorge,1,Entire home/apt,190,0,0.34,190
2392,Heather And John,2,Private room,117,88,0.59,205
2393,Chris,1,Shared room,80,365,0.89,445
2394,Sharon,2,Entire home/apt,99,311,1.28,410
2395,Adam,1,Entire home/apt,70,188,0.26,258
2396,Sergio,1,Private room,44,325,0.03,369
2397,Clotaire,1,Private room,125,301,1.15,426
2398,Parker (& Juan),1,Entire home/apt,130,184,0.44,314
2399,Aryn,1,Entire home/apt,130,332,0.11,462
2400,George,1,Private room,125,53,3.07,178
2401,Alex,1,Entire home/apt,199,184,0.52,383
2403,Zach,2,Entire home/apt,155,297,1.68,452
2405,Nicki,1,Entire home/apt,248,363,0.12,611
2406,Kinneret,1,Entire home/apt,85,9,1.44,94
2407,William,1,Private room,85,0,1.61,85
2408,Jason,2,Entire home/apt,80,192,0.53,272
2409,Ari,1,Private room,79,106,0.6,185
2410,Robert,3,Private room,55,356,3.87,411
2411,Daniel,4,Private room,65,307,0.87,372
2412,Sean,1,Entire home/apt,150,188,0.1,338
2413,Norwin,1,Entire home/apt,285,131,1.7,416
2414,Joseph,3,Entire home/apt,119,143,0.63,262
2415,Al,2,Entire home/apt,137,80,0.81,217
2416,Dana,1,Entire home/apt,190,282,2.6,472
2417,Mar,1,Private room,80,0,0.03,80
2418,Shannon And Dahrehn,2,Entire home/apt,120,18,2.39,138
2419,MarQuerite,2,Entire home/apt,95,333,1.42,428
2420,Caits & Taf,1,Private room,90,189,0.48,279
2421,Gillian,2,Private room,75,318,0.16,393
2423,Beca,2,Private room,103,2,0.21,105
2424,Emma,1,Entire home/apt,125,179,0.45,304
2425,Allon,2,Entire home/apt,150,288,2.87,438
2427,Kevin,1,Private room,148,365,0.24,513
2428,Tamar,1,Entire home/apt,120,3,0.17,123
2429,Rodney,2,Entire home/apt,99,270,0.97,369
2430,Alia,3,Private room,69,124,1.39,193
2431,Nim,1,Entire home/apt,200,358,0.1,558
2432,Karen,1,Private room,55,218,0.07,273
2433,Carlos,1,Entire home/apt,175,68,0.04,243
2434,Steve,1,Private room,240,21,1.81,261
2435,Emmett,1,Private room,95,365,0.03,460
2436,Ingrid,3,Entire home/apt,150,358,1.49,508
2437,Ryan,2,Entire home/apt,150,0,0.04,150
2438,Dave & Theresa,2,Entire home/apt,179,282,2.08,461
2439,Martin,2,Private room,105,69,5.06,174
2440,Joshua,2,Entire home/apt,84,244,0.61,328
2441,Verena,3,Entire home/apt,90,298,0.46,388
2442,Jeremiah,1,Entire home/apt,53,0,0.33,53
2443,Sergio,1,Private room,41,217,0.09,258
2444,Karim,1,Private room,135,365,0.25,500
2445,Yolanda,3,Entire home/apt,84,345,2.32,429
2446,Jacqueline,1,Entire home/apt,290,128,0.29,418
2447,Andy & Friends,2,Shared room,35,0,1.49,35
2448,Inga,3,Entire home/apt,110,14,0.67,124
2449,Alex,2,Entire home/apt,350,0,0.06,350
2450,Guillaume,2,Private room,60,294,0.22,354
2452,Christine,2,Entire home/apt,275,197,0.37,472
2453,Amy,2,Entire home/apt,142,188,0.11,330
2454,Leanne,2,Private room,38,0,0.02,38
2456,Dan,1,Entire home/apt,200,193,0.71,393
2457,Tad,2,Entire home/apt,225,55,0.79,280
2458,Susie,1,Entire home/apt,135,105,2.57,240
2459,Gia,1,Private room,72,179,0.05,251
2460,Ryan,2,Private room,59,100,0.26,159
2461,Livia,2,Entire home/apt,350,188,0.37,538
2462,Jessica,2,Private room,75,312,0.11,387
2463,Thomas,2,Private room,70,0,0.65,70
2464,Joel,1,Entire home/apt,99,0,0.09,99
2465,Yvette,2,Private room,42,355,0.74,397
2466,Aurora,2,Private room,60,296,0.15,356
2467,Joseph,2,Entire home/apt,125,1,2.21,126
2468,Alex,2,Private room,99,252,2.09,351
2469,Dayna,2,Entire home/apt,99,0,0.25,99
2470,Karece,2,Entire home/apt,165,0,1.84,165
2471,Margarita,2,Entire home/apt,250,34,0.15,284
2472,Matt,2,Private room,135,365,0.17,500
2473,Jordan,1,Private room,58,242,0.91,300
2475,Caitlin,1,Private room,95,207,2.61,302
2476,Mayrav,1,Entire home/apt,125,247,1.27,372
2477,Lenny,2,Entire home/apt,147,365,0.61,512
2478,Margo,1,Entire home/apt,300,286,1.62,586
2479,Adam,1,Entire home/apt,350,5,0.06,355
2480,Thomas,2,Entire home/apt,102,0,0.34,102
2481,Carlos,1,Private room,95,252,2.89,347
2482,Randy,2,Private room,65,345,1.16,410
2484,Ray,1,Entire home/apt,595,247,1.51,842
2485,Patricia,1,Shared room,165,363,0.29,528
2486,Phillip + Zack,2,Entire home/apt,181,174,3.17,355
2487,Wilson,1,Private room,110,0,0.05,110
2488,Randy,2,Private room,65,313,1.61,378
2489,Liz,2,Entire home/apt,155,314,1.82,469
2490,Jen,2,Private room,50,253,0.03,303
2491,Marcelle,3,Entire home/apt,85,0,0.02,85
2492,Masako,2,Private room,120,66,0.26,186
2493,Nerenda,2,Private room,75,0,0.03,75
2494,Randy,2,Private room,55,318,1.77,373
2495,Marisa,2,Private room,200,0,0.05,200
2496,Sego,2,Entire home/apt,75,0,0.15,75
2497,Cathy,2,Entire home/apt,150,129,0.02,279
2498,Roque,4,Private room,60,213,2.02,273
2499,Ezequiel,2,Entire home/apt,150,312,0.07,462
2500,Jon Paul,2,Entire home/apt,240,116,1.08,356
2501,Sullivan,1,Private room,150,0,0.25,150
2503,Elena,1,Entire home/apt,269,179,0.29,448
2504,Sarah,2,Private room,112,0,0.37,112
2505,Angus,2,Entire home/apt,250,0,0.67,250
2507,Chris,1,Entire home/apt,350,22,0.37,372
2508,André,1,Entire home/apt,80,85,0.92,165
2509,Triny,2,Entire home/apt,295,79,1.59,374
2510,Eleni,2,Private room,160,39,1.0,199
2511,Andy,1,Entire home/apt,399,0,0.05,399
2512,Light,1,Entire home/apt,150,35,0.22,185
2513,Randy,2,Private room,60,321,1.95,381
2514,Deborah,1,Entire home/apt,219,188,0.64,407
2515,Aaron,1,Private room,119,23,1.47,142
2516,Jesse,2,Entire home/apt,190,0,0.02,190
2517,Jeffrey,1,Private room,140,16,1.37,156
2518,Laura,2,Private room,125,364,0.08,489
2519,Tege,1,Entire home/apt,144,0,0.39,144
2521,Giovanni,3,Entire home/apt,100,33,1.73,133
2522,Jackie,2,Private room,115,288,2.67,403
2523,Ben And Jess,1,Entire home/apt,1899,0,0.28,1899
2524,Jeff,1,Entire home/apt,110,205,0.14,315
2525,Dee,1,Entire home/apt,140,298,0.7,438
2526,Ikk,1,Entire home/apt,94,3,0.12,97
2527,Michel Fabrice,1,Private room,50,14,0.91,64
2528,Paco & Pamela,2,Entire home/apt,131,5,1.06,136
2529,Jackie,2,Private room,175,334,0.13,509
2530,Dennis,2,Entire home/apt,299,321,0.06,620
2531,Chris,1,Entire home/apt,145,342,0.17,487
2532,Anthony,1,Entire home/apt,145,132,0.91,277
2533,Jonathan,1,Entire home/apt,175,0,0.03,175
2534,Alec,1,Private room,109,22,0.07,131
2535,Deborah,1,Private room,150,364,0.51,514
2537,Ty,1,Entire home/apt,399,351,1.51,750
2538,Martin,2,Private room,48,311,0.06,359
2539,Majar,2,Private room,75,341,1.0,416
2540,Walter,2,Private room,55,343,0.06,398
2541,Michelle,2,Private room,75,255,1.7,330
2542,Ruby,1,Entire home/apt,465,273,0.18,738
2543,Kiriko,2,Entire home/apt,151,213,2.36,364
2544,Hank,2,Entire home/apt,199,12,0.08,211
2545,Randy,2,Private room,45,236,1.61,281
2546,Jesse,2,Entire home/apt,160,365,0.33,525
2547,Gina,2,Private room,36,360,2.38,396
2548,Patricia,1,Entire home/apt,235,345,0.2,580
2549,Peter,2,Entire home/apt,225,365,0.07,590
2550,Vanessa,1,Entire home/apt,300,0,0.27,300
2551,Andy & Friends,2,Shared room,35,0,1.66,35
2552,Nicholas,3,Entire home/apt,80,198,0.61,278
2553,Seth,3,Private room,79,353,0.93,432
2554,Lee,1,Private room,82,334,0.1,416
2555,Lee,1,Private room,82,311,0.07,393
2556,Mitty,2,Entire home/apt,215,189,0.09,404
2557,Emily,2,Entire home/apt,147,0,0.2,147
2558,Raul,1,Entire home/apt,145,269,0.43,414
2559,Emily,2,Private room,65,157,1.22,222
2560,Vanessa,2,Private room,78,28,0.33,106
2561,Erik,3,Entire home/apt,120,0,0.05,120
2562,Hadar,2,Entire home/apt,120,327,0.28,447
2563,Nami,1,Private room,95,86,2.87,181
2564,Alex,2,Private room,90,359,1.63,449
2565,Amy,2,Entire home/apt,95,168,0.15,263
2566,Wendy,2,Entire home/apt,100,45,0.58,145
2567,Richard,1,Entire home/apt,350,351,0.22,701
2568,Savannah,2,Entire home/apt,188,261,0.54,449
2569,Deidra,3,Private room,80,363,0.07,443
2570,Joe,1,Entire home/apt,175,0,0.07,175
2571,Karen,2,Entire home/apt,495,256,0.08,751
2572,Magi,1,Entire home/apt,250,159,2.18,409
2573,John,2,Entire home/apt,115,0,0.04,115
2574,Randy,2,Private room,55,285,1.04,340
2575,Michael,1,Entire home/apt,93,245,0.35,338
2576,Michael,1,Entire home/apt,93,316,0.47,409
2577,Erin,1,Entire home/apt,199,69,0.49,268
2578,Heather,2,Private room,70,0,0.1,70
2580,Mike,1,Entire home/apt,125,282,0.04,407
2581,Olya,1,Entire home/apt,169,24,0.2,193
2582,Fabiano,2,Entire home/apt,150,296,0.53,446
2583,Christian,1,Private room,61,233,1.83,294
2584,Olivia,2,Private room,40,221,0.2,261
2585,Amith,2,Entire home/apt,150,342,0.72,492
2586,Brooke,2,Private room,65,275,0.2,340
2588,London,1,Entire home/apt,190,248,1.73,438
2589,Kristin,2,Private room,79,73,0.8,152
2590,Lise,2,Entire home/apt,225,259,3.31,484
2591,London,1,Entire home/apt,185,258,2.0,443
2592,Dayna,2,Private room,100,156,0.11,256
2593,Smyles And Diara,1,Private room,85,129,2.01,214
2594,Jiajia,1,Private room,75,29,0.33,104
2595,Alessio,2,Private room,85,89,0.32,174
2596,Stacey & Anthony,2,Entire home/apt,98,249,2.87,347
2597,Arza,2,Entire home/apt,262,16,0.02,278
2598,Aviva,3,Entire home/apt,145,278,0.42,423
2599,Maya,1,Entire home/apt,280,365,0.11,645
2600,Tim & MaryAnn,1,Entire home/apt,210,8,0.18,218
2601,Irina,2,Entire home/apt,70,0,0.03,70
2602,Michelle,2,Entire home/apt,100,141,2.24,241
2604,Marialuisa,2,Private room,59,336,2.23,395
2605,Kim,1,Private room,199,130,4.51,329
2606,Carlos,1,Entire home/apt,219,301,1.1,520
2607,Giovanna,2,Private room,100,333,1.36,433
2608,Daniel,2,Entire home/apt,175,220,0.81,395
2609,Tana,1,Private room,220,364,0.03,584
2610,Masud,2,Private room,40,325,1.25,365
2612,Julia,2,Entire home/apt,140,255,0.38,395
2613,Esef,1,Private room,105,308,0.23,413
2614,Brandy,2,Entire home/apt,110,13,0.08,123
2615,Dominik,2,Entire home/apt,131,32,1.94,163
2616,James,1,Entire home/apt,265,257,1.31,522
2617,Marilyn,1,Private room,54,2,0.15,56
2618,Tana,1,Entire home/apt,800,364,0.03,1164
2619,Chris And Zach,2,Private room,53,90,3.41,143
2620,Shamara,1,Entire home/apt,99,365,0.07,464
2621,Kerry,2,Private room,65,187,0.56,252
2623,Rocco,1,Private room,120,173,1.25,293
2624,Badrul,1,Entire home/apt,169,36,0.04,205
2625,Alessandro,1,Entire home/apt,180,280,0.4,460
2626,Tyler,2,Private room,67,14,1.0,81
2627,Lola,1,Private room,111,259,1.1,370
2628,Alexandra,1,Private room,90,269,2.0,359
2629,Jennifer,2,Entire home/apt,259,0,0.04,259
2630,Nicole,1,Private room,89,38,4.67,127
2631,Vida,2,Entire home/apt,129,189,0.11,318
2632,Travis,2,Private room,69,20,1.36,89
2633,Carrie,1,Private room,75,0,0.23,75
2634,Jill,2,Entire home/apt,250,220,0.35,470
2635,Verna,2,Entire home/apt,120,274,3.22,394
2636,Vida,2,Entire home/apt,129,249,0.09,378
2637,Zoesarah (And) Anu,2,Entire home/apt,199,315,0.47,514
2638,Matthieu,2,Entire home/apt,450,258,1.19,708
2641,Hannah,1,Entire home/apt,350,87,0.79,437
2642,Menny,1,Entire home/apt,160,218,0.18,378
2643,Walter,2,Private room,45,88,0.21,133
2644,Christine,2,Private room,70,316,0.77,386
2645,Zev,1,Entire home/apt,260,253,5.68,513
2646,Brett,3,Entire home/apt,100,250,0.06,350
2647,Louise,2,Entire home/apt,125,77,0.64,202
2648,Robert,2,Entire home/apt,195,287,3.1,482
2649,Julian,2,Private room,58,297,0.43,355
2650,Lucy,1,Private room,75,0,0.16,75
2651,Beth,1,Entire home/apt,200,21,0.95,221
2652,Christine,2,Private room,75,201,0.52,276
2653,Christine,2,Private room,95,47,0.64,142
2654,Ehren,2,Private room,99,0,2.63,99
2655,Ruty,2,Private room,275,257,0.34,532
2656,Kappie,2,Entire home/apt,162,0,0.44,162
2658,Lysa,1,Entire home/apt,285,173,0.16,458
2659,L.A.,1,Entire home/apt,120,184,0.91,304
2660,Candy,1,Entire home/apt,120,314,1.07,434
2661,Evelyn,1,Entire home/apt,210,319,2.1,529
2662,Rosa,2,Private room,160,363,0.35,523
2663,Jesse,1,Entire home/apt,110,0,0.1,110
2665,Tom,3,Entire home/apt,138,41,0.06,179
2666,Tamara,1,Private room,90,0,0.11,90
2667,Cristie,2,Private room,45,21,0.45,66
2668,Anastasia,2,Entire home/apt,80,161,0.31,241
2670,Jennifer,2,Private room,72,68,0.58,140
2671,Brooke & Terry,1,Private room,95,14,2.39,109
2672,Aurelio,2,Private room,75,3,0.56,78
2673,Gabor,3,Entire home/apt,70,364,1.05,434
2674,Elizabeth,2,Entire home/apt,160,0,0.01,160
2675,Tangier,2,Shared room,29,321,0.07,350
2676,Linda,2,Entire home/apt,175,213,1.46,388
2678,Leah,1,Private room,110,0,0.12,110
2679,Jean & Gabriel,2,Entire home/apt,175,272,2.78,447
2680,Brent,1,Private room,99,245,1.99,344
2681,Brian,1,Private room,100,36,0.15,136
2682,Kamaya,2,Entire home/apt,144,0,0.06,144
2683,Mark,2,Entire home/apt,171,243,1.47,414
2684,Karen,1,Entire home/apt,99,89,0.32,188
2685,Roxanne,1,Entire home/apt,270,0,0.06,270
2686,Arielle,1,Entire home/apt,160,24,3.19,184
2687,Celin,1,Private room,65,64,0.86,129
2688,Geraldine,2,Entire home/apt,99,206,2.89,305
2689,Laura,1,Entire home/apt,125,47,3.22,172
2691,Eric,2,Entire home/apt,300,41,0.24,341
2692,Ron,1,Private room,112,71,5.4,183
2693,Lancelot,2,Entire home/apt,100,321,0.06,421
2694,Liam,2,Private room,60,87,0.89,147
2695,Henry,1,Entire home/apt,232,234,0.03,466
2697,Donna,1,Entire home/apt,140,16,2.41,156
2698,Jessica,1,Entire home/apt,5000,365,0.03,5365
2699,Zachary,2,Entire home/apt,168,0,0.03,168
2702,Alonzo,2,Entire home/apt,95,98,0.29,193
2703,Abigail,1,Entire home/apt,175,0,0.05,175
2704,Mark,1,Entire home/apt,220,3,0.23,223
2705,Thomas,1,Entire home/apt,178,211,1.84,389
2706,Dee,2,Entire home/apt,85,8,0.97,93
2707,King,3,Private room,35,5,1.07,40
2708,Vida,2,Entire home/apt,129,277,0.08,406
2709,Bobi,1,Private room,55,363,2.78,418
2710,Jenny,2,Private room,69,68,0.72,137
2711,Chantille & Linda,2,Private room,68,187,0.33,255
2712,Gya,2,Private room,69,186,1.25,255
2713,Jorion,1,Entire home/apt,300,365,0.32,665
2714,Raymond,1,Entire home/apt,175,248,4.54,423
2715,Enyinne,3,Private room,59,359,2.64,418
2716,Enyinne,3,Private room,59,359,0.26,418
2717,Ty,1,Private room,169,340,0.47,509
2718,Jp,2,Entire home/apt,120,0,0.02,120
2719,Diavanna,2,Entire home/apt,155,244,3.16,399
2720,Kristen & Corey,2,Entire home/apt,165,188,1.28,353
2721,Maxime,1,Private room,60,167,1.77,227
2722,Matthew,2,Entire home/apt,190,0,0.26,190
2723,Adam,1,Entire home/apt,150,0,0.13,150
2724,Olivier,1,Entire home/apt,150,135,0.29,285
2725,Keiko & Ilya,2,Entire home/apt,120,10,0.53,130
2726,Harry,3,Private room,349,365,0.36,714
2727,Enyinne,3,Private room,59,359,0.19,418
2728,Rocio,1,Shared room,99,21,2.22,120
2729,Enyinne,3,Private room,59,359,0.45,418
2730,Ange,2,Private room,110,159,0.32,269
2731,Karen,1,Private room,73,21,0.16,94
2732,Ana,1,Entire home/apt,179,256,2.84,435
2733,Daveyjoe!,3,Private room,102,0,0.24,102
2734,Majar,2,Private room,62,338,1.32,400
2735,Rickey,3,Entire home/apt,140,0,0.18,140
2736,Buke,1,Entire home/apt,300,98,0.58,398
2737,Steven,1,Entire home/apt,299,88,0.37,387
2738,Tessa,2,Entire home/apt,104,15,0.15,119
2739,Michael,1,Entire home/apt,98,290,0.54,388
2740,Gil,1,Private room,49,0,1.29,49
2741,Michael,1,Entire home/apt,96,210,0.63,306
2742,Nicole,2,Private room,80,0,1.85,80
2743,Brian,2,Private room,89,362,2.05,451
2744,Daren,1,Private room,125,364,0.01,489
2745,Megan,2,Entire home/apt,345,185,2.49,530
2746,Mark,2,Entire home/apt,150,0,0.43,150
2747,Michelle,1,Private room,100,326,0.21,426
2748,Lucie,1,Entire home/apt,120,0,0.16,120
2749,Vida,2,Entire home/apt,149,343,0.13,492
2750,Sam,2,Entire home/apt,145,0,0.25,145
2751,Justin,1,Entire home/apt,390,0,0.1,390
2752,Martine,4,Private room,60,178,0.28,238
2753,Molly,2,Entire home/apt,190,167,0.28,357
2754,Abby,1,Private room,80,276,0.79,356
2755,Randy,2,Private room,55,334,2.26,389
2756,Moses,2,Entire home/apt,275,331,2.74,606
2757,Rebecca,2,Entire home/apt,250,272,1.23,522
2758,Naima,1,Entire home/apt,100,270,3.85,370
2759,Tilia,1,Entire home/apt,600,0,0.1,600
2760,Irene,2,Private room,66,365,0.08,431
2761,Lisa,2,Private room,65,333,0.83,398
2762,Omar,1,Entire home/apt,220,332,0.85,552
2763,Jason,1,Entire home/apt,159,46,1.62,205
2764,Tov,2,Private room,70,20,0.44,90
2765,Natasha,2,Private room,49,296,1.17,345
2766,Jordan,2,Private room,47,56,0.36,103
2767,Kiki,1,Entire home/apt,299,100,2.8,399
2768,Jon,2,Entire home/apt,79,0,0.43,79
2769,Lee,2,Entire home/apt,115,0,0.17,115
2770,Habib,2,Entire home/apt,229,364,0.54,593
2771,Romi,2,Entire home/apt,115,0,0.04,115
2772,Jonathan,1,Entire home/apt,1100,364,0.25,1464
2773,Angelo,2,Entire home/apt,165,49,0.14,214
2774,Jenn,2,Entire home/apt,67,0,0.39,67
2775,Cat,2,Private room,68,72,2.44,140
2776,Cynthia And Froebel,2,Private room,85,132,0.16,217
2777,Jullien,2,Entire home/apt,170,209,2.0,379
2778,Charlotte & Aaron,2,Private room,95,86,0.76,181
2779,Ivey,2,Private room,45,0,0.05,45
2780,Amanda,2,Private room,178,0,0.06,178
2781,Tabita,1,Entire home/apt,140,328,0.91,468
2782,Vida,2,Entire home/apt,149,281,0.11,430
2783,Tee,2,Entire home/apt,89,223,1.29,312
2784,Milena,3,Entire home/apt,108,0,0.06,108
2785,Victoria,1,Entire home/apt,138,13,0.3,151
2786,Andrea,2,Entire home/apt,115,39,1.7,154
2787,Ari,1,Shared room,69,103,2.13,172
2788,Nikhil,1,Entire home/apt,269,311,1.14,580
2789,Will And Jo,2,Entire home/apt,160,252,0.18,412
2790,Manuel,1,Entire home/apt,150,207,0.03,357
2791,Mari,1,Entire home/apt,121,151,1.11,272
2792,Kris,2,Entire home/apt,95,20,0.49,115
2793,Alex,2,Entire home/apt,99,365,1.05,464
2794,Leonice,2,Private room,40,65,1.1,105
2795,Stephanie,1,Private room,89,125,0.38,214
2796,Valerie,2,Private room,50,157,0.16,207
2797,Randy,2,Private room,55,343,1.77,398
2798,Brennan,2,Entire home/apt,224,257,3.28,481
2799,Malik,3,Entire home/apt,120,0,0.19,120
2800,Terri,3,Private room,59,0,1.63,59
2801,Brinton,1,Entire home/apt,135,340,2.49,475
2802,Tommy,1,Entire home/apt,175,274,1.49,449
2803,Jessica,3,Entire home/apt,250,84,2.65,334
2804,Anna,1,Entire home/apt,156,3,0.44,159
2805,Alisha,2,Entire home/apt,75,0,0.66,75
2806,Kevin,1,Entire home/apt,79,0,0.13,79
2807,Karen,1,Entire home/apt,104,137,0.38,241
2808,Andrew And Stine,2,Entire home/apt,280,359,1.77,639
2809,Madeleine,1,Private room,80,34,1.88,114
2810,Bertte,2,Entire home/apt,136,0,0.72,136
2811,Matthew,1,Entire home/apt,550,201,0.27,751
2812,Jed,2,Entire home/apt,190,349,1.65,539
2813,Shervin,1,Entire home/apt,199,361,0.47,560
2814,Jorge,3,Private room,75,365,0.4,440
2815,Alexandre,1,Private room,100,278,3.05,378
2816,Drica 2017,1,Entire home/apt,125,362,0.21,487
2817,Julie,2,Private room,75,0,0.24,75
2818,Steph,1,Private room,99,24,2.61,123
2819,Eric,2,Private room,35,97,0.07,132
2820,Beatrix,3,Private room,51,361,2.36,412
2821,Ryan,3,Entire home/apt,188,312,3.97,500
2822,Stephan,1,Entire home/apt,90,0,0.04,90
2823,Am,2,Entire home/apt,279,0,0.19,279
2824,Raj,1,Entire home/apt,350,13,0.14,363
2825,William,1,Private room,125,360,0.84,485
2826,Charlotte & Aaron,2,Private room,85,81,0.56,166
2827,Macit,3,Private room,48,297,0.46,345
2828,Macit,3,Private room,56,310,0.2,366
2829,C S,2,Private room,84,362,0.96,446
2830,Wendy,1,Entire home/apt,155,170,1.74,325
2832,Ernesto,1,Entire home/apt,300,278,0.45,578
2833,Kate,2,Entire home/apt,140,0,0.02,140
2834,Thomas,1,Private room,120,245,0.27,365
2835,Jae,2,Entire home/apt,99,89,2.78,188
2836,Stephen,1,Entire home/apt,240,158,0.27,398
2837,Stephen,1,Entire home/apt,72,73,0.46,145
2838,Rosemary,3,Private room,45,0,0.96,45
2839,Mary,5,Entire home/apt,250,0,0.02,250
2840,Wes,1,Private room,100,78,0.9,178
2841,Maria,1,Entire home/apt,175,299,1.65,474
2842,Tanya,1,Entire home/apt,200,0,0.14,200
2843,Enyinne,3,Private room,59,359,0.12,418
2844,Chandler,1,Entire home/apt,420,294,4.02,714
2845,Bernardo & Andressa,2,Private room,120,37,2.01,157
2846,Jon,1,Entire home/apt,295,235,0.04,530
2847,Shana,2,Entire home/apt,200,306,0.17,506
2848,Joseph,2,Private room,48,0,0.87,48
2849,Rodrigo,1,Entire home/apt,99,182,0.78,281
2850,Vida,2,Entire home/apt,129,344,0.12,473
2851,Chara,1,Entire home/apt,160,0,0.64,160
2852,Randy,2,Entire home/apt,142,151,0.58,293
2853,Marinez,3,Private room,120,365,0.17,485
2855,Sara,2,Entire home/apt,130,182,0.41,312
2856,Pavel,1,Shared room,85,157,0.56,242
2857,Stephanie,2,Entire home/apt,600,89,0.68,689
2858,Chikie,1,Private room,69,110,2.14,179
2859,Karlee,2,Entire home/apt,150,0,0.03,150
2861,Bahiyyah,2,Private room,87,12,2.26,99
2862,Dn,1,Private room,249,87,0.02,336
2863,Nathan,2,Private room,65,115,2.03,180
2864,Marlyn,2,Entire home/apt,175,317,2.27,492
2865,Shane,1,Private room,79,1,1.59,80
2866,Andrew,1,Private room,194,340,2.0,534
2867,Matthew,1,Entire home/apt,150,9,0.27,159
2868,Malcolm,2,Entire home/apt,241,0,0.15,241
2869,Tia,1,Private room,80,309,1.08,389
2870,Zaire,2,Entire home/apt,120,284,1.02,404
2871,Agnes,1,Entire home/apt,155,0,0.22,155
2872,Adam,1,Entire home/apt,150,0,0.57,150
2873,Natalie,1,Entire home/apt,140,71,0.69,211
2874,ELouise,2,Entire home/apt,90,361,0.08,451
2875,Rachel,2,Entire home/apt,150,250,1.33,400
2876,Nehprii,2,Entire home/apt,135,354,1.8,489
2877,Sean,2,Entire home/apt,140,31,1.64,171
2878,Ravanna,2,Entire home/apt,130,0,3.11,130
2879,Ruth,1,Private room,150,225,1.72,375
2880,Lisa,2,Entire home/apt,115,163,2.62,278
2881,Ravanna,2,Entire home/apt,130,259,3.32,389
2882,Caspar,1,Entire home/apt,380,365,0.43,745
2883,Kali,2,Entire home/apt,115,0,0.02,115
2884,Olubode Shawn,1,Entire home/apt,125,363,0.3,488
2885,Rebecca,2,Private room,65,169,0.02,234
2886,Augusto M Gallardo,3,Entire home/apt,110,362,0.16,472
2887,Lord Daniel,2,Private room,31,55,0.58,86
2888,Shean,2,Entire home/apt,135,277,2.47,412
2889,Billy,1,Entire home/apt,200,0,0.29,200
2890,Robb,2,Private room,212,109,0.33,321
2891,Chris,2,Shared room,40,75,0.48,115
2892,Lior,1,Entire home/apt,80,365,0.18,445
2893,Shelley,2,Entire home/apt,95,275,2.09,370
2894,Host,1,Entire home/apt,185,347,0.13,532
2895,@ Art House Monique,2,Entire home/apt,100,165,0.84,265
2897,Vida,2,Entire home/apt,149,341,0.14,490
2898,Ann,1,Private room,139,32,2.87,171
2899,Molly,1,Entire home/apt,226,80,0.36,306
2900,Elizabeth,2,Entire home/apt,74,131,3.02,205
2901,Jonathan,1,Entire home/apt,195,0,0.74,195
2902,Danielle,2,Entire home/apt,104,122,0.69,226
2903,Tanya,1,Entire home/apt,275,5,0.51,280
2904,Rebecca,1,Private room,310,358,0.18,668
2905,Julia,1,Entire home/apt,145,35,0.04,180
2906,Lynn,5,Entire home/apt,75,258,0.28,333
2907,Jae,2,Entire home/apt,99,106,2.85,205
2908,Carlos,1,Entire home/apt,250,137,1.12,387
2909,Karen,1,Entire home/apt,104,57,0.34,161
2910,Pat,1,Entire home/apt,250,358,0.07,608
2911,Host,1,Entire home/apt,150,340,0.27,490
2912,Host,1,Entire home/apt,195,333,0.35,528
2913,Host,1,Entire home/apt,350,327,0.22,677
2914,Charles,2,Private room,75,0,0.33,75
2915,Jenny,2,Private room,80,167,0.4,247
2916,Mel,2,Entire home/apt,96,50,4.62,146
2918,Facundo Martin /Teresa,1,Private room,90,293,2.38,383
2919,Rocio & James,3,Private room,79,308,4.02,387
2921,Sabina Giovanna,2,Entire home/apt,224,219,0.2,443
2922,Christopher,3,Private room,35,88,3.28,123
2923,Amara,3,Private room,70,140,0.48,210
2924,Caroline,2,Private room,85,293,0.83,378
2925,Joy,1,Entire home/apt,110,314,1.82,424
2926,Yvonne,2,Private room,65,365,0.06,430
2927,Mike,3,Entire home/apt,200,157,0.38,357
2928,Golan,1,Entire home/apt,249,365,0.09,614
2929,Majar,2,Private room,62,361,0.74,423
2930,Theodore,4,Private room,50,311,0.83,361
2931,Majar,2,Private room,62,340,0.68,402
2932,Joseph,2,Private room,50,282,0.22,332
2934,Samuel,1,Private room,71,18,1.02,89
2935,Ellen,1,Private room,75,139,0.53,214
2936,Lynne,2,Private room,115,277,2.08,392
2937,Molly,2,Private room,82,0,3.37,82
2938,Majar,2,Private room,75,341,0.49,416
2939,Shane,1,Private room,60,340,1.44,400
2940,Clay,1,Entire home/apt,200,11,1.17,211
2942,Mr. Williams,2,Entire home/apt,215,356,0.84,571
2943,Ed &Alexa,1,Private room,100,52,3.49,152
2944,Maria,3,Private room,38,137,0.19,175
2945,Emilia,2,Entire home/apt,159,77,0.2,236
2946,Rob,2,Private room,64,296,1.61,360
2947,Ronak,2,Entire home/apt,125,5,0.75,130
2948,Daniel,1,Entire home/apt,120,72,2.6,192
2949,Koji & H,1,Private room,76,27,2.34,103
2950,Megan,1,Private room,175,0,0.1,175
2951,Robin,2,Private room,110,300,0.1,410
2952,Lindsey,2,Private room,75,49,4.43,124
2953,Ric,1,Private room,80,327,0.4,407
2954,Sarah,2,Private room,110,0,0.06,110
2955,Alison,2,Private room,89,354,3.07,443
2956,Eydie,2,Entire home/apt,110,67,0.33,177
2957,Amikole,1,Private room,96,145,3.94,241
2958,Lydiah,1,Entire home/apt,75,0,0.49,75
2959,Raynald,1,Entire home/apt,185,106,1.04,291
2960,Patrick,2,Entire home/apt,49,262,3.5,311
2961,Liam,1,Entire home/apt,440,70,0.09,510
2962,Amy,2,Entire home/apt,220,156,0.27,376
2963,Kindra,1,Private room,99,365,0.18,464
2964,Lynn,1,Private room,85,15,1.93,100
2965,Isabelle,2,Entire home/apt,98,0,0.1,98
2966,Caroline,2,Private room,84,302,1.05,386
2967,Caroline,2,Private room,65,239,0.6,304
2968,Todd,2,Entire home/apt,160,0,0.32,160
2969,Deborah,2,Private room,115,256,3.16,371
2970,Helga,1,Private room,59,36,0.43,95
2971,Alex,1,Private room,119,325,0.58,444
2972,Sophie,2,Entire home/apt,120,311,1.37,431
2973,Francesca,1,Entire home/apt,439,154,1.15,593
2974,Jay,1,Private room,99,278,0.42,377
2975,Clarissa & Rich,2,Entire home/apt,199,5,0.44,204
2976,John,2,Private room,99,263,4.9,362
2977,Myrna And David,3,Private room,195,304,3.51,499
2978,Lane,2,Entire home/apt,180,0,2.63,180
2979,Paul,3,Private room,100,182,0.75,282
2980,Jay,2,Entire home/apt,115,106,3.58,221
2981,Debbie,2,Entire home/apt,115,0,0.03,115
2982,Krista,1,Entire home/apt,180,72,0.26,252
2983,Ronald,4,Private room,45,249,0.82,294
2984,Sarah,1,Entire home/apt,300,350,0.96,650
2985,Art,1,Entire home/apt,90,203,0.29,293
2987,Tavia,3,Entire home/apt,140,20,0.6,160
2988,Melissa,1,Entire home/apt,123,0,0.2,123
2989,Jon,1,Entire home/apt,200,216,1.89,416
2990,Marinez,3,Private room,100,364,0.07,464
2991,Irie,2,Entire home/apt,250,128,2.06,378
2992,Charles,2,Private room,85,206,4.1,291
2993,Timothy,1,Entire home/apt,100,0,0.05,100
2994,Soren,1,Entire home/apt,109,139,0.49,248
2995,Vida,2,Entire home/apt,159,310,0.1,469
2996,James,1,Entire home/apt,260,167,0.21,427
2997,Kris,1,Entire home/apt,555,191,1.63,746
2998,Samantha,1,Private room,87,23,3.37,110
2999,Alex Nova York,4,Private room,43,338,0.16,381
3000,Carlos,1,Entire home/apt,199,339,0.42,538
3001,Ryan,1,Private room,90,177,0.24,267
3002,Dahlia,2,Entire home/apt,195,312,1.13,507
3003,Althea,2,Entire home/apt,185,314,2.09,499
3004,Alexana,1,Entire home/apt,400,46,0.28,446
3005,Yvonne,1,Entire home/apt,200,263,2.07,463
3006,Aaron,1,Private room,100,355,0.87,455
3007,Lynne,1,Entire home/apt,225,348,0.17,573
3008,Maurice,2,Entire home/apt,450,364,0.25,814
3009,Angelo,2,Private room,80,0,1.61,80
3010,Gordon,2,Entire home/apt,89,18,1.76,107
3011,Simon,1,Entire home/apt,179,17,1.83,196
3012,Yair,1,Private room,90,11,0.1,101
3014,Beth,2,Private room,35,0,0.12,35
3015,DeLex,3,Private room,86,0,1.58,86
3016,David,3,Entire home/apt,95,177,0.59,272
3017,Edon,1,Private room,116,0,0.63,116
3018,Anthony,1,Private room,80,23,1.72,103
3019,S & G,1,Entire home/apt,110,17,3.39,127
3020,Antonio,3,Private room,29,50,5.53,79
3021,Sophie,1,Entire home/apt,200,233,1.08,433
3022,Francesca,1,Entire home/apt,390,156,2.63,546
3023,Aude,1,Shared room,55,326,3.04,381
3024,Fernando,3,Shared room,75,19,0.91,94
3026,Liz,2,Entire home/apt,120,50,0.91,170
3027,Pk,1,Private room,143,364,0.53,507
3028,Colleen,1,Entire home/apt,250,0,0.02,250
3029,Allison,2,Private room,99,310,0.41,409
3030,Zuffina,1,Entire home/apt,150,152,0.74,302
3031,Adriana,2,Private room,55,184,0.29,239
3032,Claudia,2,Entire home/apt,175,287,1.31,462
3033,Tom & Lily,2,Private room,69,329,2.12,398
3034,Anne,1,Entire home/apt,184,12,0.33,196
3035,Mike,2,Entire home/apt,145,0,0.09,145
3036,Rock,1,Private room,100,256,3.01,356
3037,Natasha,2,Private room,44,251,1.14,295
3040,Tanja,1,Entire home/apt,225,0,0.15,225
3041,Shane,1,Entire home/apt,199,0,0.03,199
3042,Ephraim,1,Private room,60,301,0.91,361
3043,Ana Maria,1,Entire home/apt,175,235,3.8,410
3044,Ki,1,Entire home/apt,199,0,0.06,199
3045,Ana,2,Private room,65,73,0.44,138
3046,Cory,2,Entire home/apt,190,331,0.24,521
3047,Mike,2,Entire home/apt,107,23,2.07,130
3048,Maegan,1,Entire home/apt,150,0,0.38,150
3050,Vie,4,Private room,75,363,0.46,438
3051,Valerie,2,Private room,45,36,0.2,81
3052,Isaac,2,Entire home/apt,179,0,0.22,179
3053,John,3,Entire home/apt,110,147,6.3,257
3054,Lauren,2,Entire home/apt,245,65,0.76,310
3055,Lo,1,Entire home/apt,799,365,0.58,1164
3056,Katy,1,Private room,100,252,0.17,352
3057,Randy,2,Private room,61,314,1.06,375
3059,Sherief,2,Entire home/apt,275,12,0.23,287
3060,Claudia And Leo,2,Entire home/apt,250,222,1.95,472
3061,Allison,2,Entire home/apt,120,0,0.03,120
3062,Danielle,2,Entire home/apt,135,267,2.77,402
3063,Hakan,1,Entire home/apt,199,3,0.06,202
3064,Christine,2,Private room,75,289,0.29,364
3065,Christine,2,Private room,75,216,0.43,291
3066,Ryan,1,Private room,75,177,0.32,252
3068,Brian,1,Private room,90,282,1.2,372
3069,Jennifer,1,Private room,80,0,0.02,80
3070,Nikki,2,Entire home/apt,115,0,0.05,115
3071,Andre,1,Private room,60,358,1.34,418
3072,Drew,1,Entire home/apt,175,273,0.36,448
3073,Eric,2,Entire home/apt,125,242,3.53,367
3074,Ilana,1,Entire home/apt,185,0,1.16,185
3075,Carlos,3,Private room,56,298,1.16,354
3076,Charisse,2,Private room,64,133,4.83,197
3077,Mark,2,Entire home/apt,300,214,0.15,514
3078,Liam,1,Entire home/apt,455,332,1.36,787
3079,Nancy,2,Private room,37,353,0.78,390
3080,Michael,2,Entire home/apt,193,256,2.39,449
3081,Michael,2,Private room,53,113,0.72,166
3082,Nayef,1,Entire home/apt,161,0,0.18,161
3083,Marek,1,Entire home/apt,99,0,0.04,99
3084,Chris,1,Entire home/apt,420,250,1.04,670
3086,Liz,1,Entire home/apt,195,333,1.51,528
3087,Jenelle & Michael,2,Private room,81,0,0.53,81
3088,Emmett,1,Private room,65,332,0.14,397
3089,Lana,2,Private room,70,188,0.04,258
3090,Aimee,1,Entire home/apt,400,190,0.63,590
3091,Ines,2,Entire home/apt,170,190,0.9,360
3092,Jessica,1,Entire home/apt,175,0,0.79,175
3093,Michael,2,Private room,41,0,0.11,41
3094,David,1,Entire home/apt,149,16,0.52,165
3095,Emily,2,Private room,87,38,1.35,125
3097,Michael,1,Entire home/apt,92,327,0.21,419
3100,Cris,2,Entire home/apt,300,188,0.22,488
3101,Gwen,1,Entire home/apt,139,0,0.48,139
3102,Taran Pal,1,Private room,90,0,0.18,90
3103,Y&Y,1,Private room,118,201,0.76,319
3105,Megan,2,Entire home/apt,125,357,8.52,482
3106,Mick,2,Entire home/apt,122,364,1.91,486
3107,Ayse Sera,1,Entire home/apt,280,98,0.34,378
3108,Evan & Maria,1,Entire home/apt,215,270,1.92,485
3109,Reginald,2,Private room,89,365,0.73,454
3110,Teresa,1,Private room,130,0,0.03,130
3111,Kali,2,Entire home/apt,201,177,0.12,378
3112,Carol-Anne,2,Private room,119,311,0.34,430
3113,Esther & Aaron,1,Entire home/apt,103,55,0.86,158
3114,Frederick,2,Private room,72,78,2.49,150
3115,Camille,1,Entire home/apt,169,0,0.13,169
3116,Genevieve,1,Entire home/apt,240,348,0.91,588
3117,Shane,2,Entire home/apt,180,45,0.63,225
3118,Mick,2,Entire home/apt,150,359,1.72,509
3119,Roberto,1,Entire home/apt,120,0,0.07,120
3120,Will And Jo,2,Entire home/apt,345,213,2.69,558
3121,Dorcas,2,Entire home/apt,95,281,2.0,376
3123,Sherry,1,Entire home/apt,150,260,0.43,410
3124,Peter,1,Private room,95,11,1.45,106
3125,Anthony,1,Private room,90,316,1.04,406
3127,Ross,1,Entire home/apt,225,0,0.15,225
3128,Amber,1,Entire home/apt,240,0,0.1,240
3129,Amanda,1,Entire home/apt,150,188,0.68,338
3130,Alex,1,Private room,44,191,1.15,235
3132,Kristie,1,Entire home/apt,299,3,0.56,302
3133,Kris,2,Entire home/apt,120,0,1.51,120
3134,Coats,1,Entire home/apt,525,80,0.61,605
3135,David,1,Entire home/apt,600,210,0.67,810
3136,J.D. & Stephanie,2,Private room,88,100,3.53,188
3138,Brian,1,Entire home/apt,200,0,0.05,200
3139,Mich,1,Entire home/apt,100,0,0.28,100
3140,Melissa,1,Entire home/apt,209,265,0.1,474
3141,Mary,2,Entire home/apt,240,199,0.21,439
3142,Idoline,2,Entire home/apt,90,301,0.35,391
3143,Antonio,3,Private room,73,359,1.44,432
3144,Asuka,1,Private room,90,0,0.07,90
3145,Frederic,1,Entire home/apt,200,20,0.09,220
3146,Natalie,2,Entire home/apt,94,0,0.72,94
3148,Dan,1,Entire home/apt,199,152,3.49,351
3150,Denise,1,Private room,85,108,1.96,193
3151,Ronald,1,Entire home/apt,195,78,0.46,273
3152,Andrea,1,Entire home/apt,173,144,2.13,317
3153,Vida,2,Entire home/apt,159,346,0.07,505
3154,Naomi,2,Private room,85,123,1.57,208
3155,Ayana,2,Entire home/apt,120,237,3.04,357
3156,Joel,1,Entire home/apt,225,0,0.05,225
3157,Christian,2,Entire home/apt,175,108,2.4,283
3158,Ahmed,1,Private room,130,294,1.88,424
3160,Nancy,2,Private room,38,349,1.11,387
3161,David,2,Private room,53,312,0.55,365
3162,LoftMidtownNYC,1,Private room,125,285,1.69,410
3165,Nancy,2,Private room,32,155,1.25,187
3166,Ana,1,Entire home/apt,160,188,2.33,348
3169,Erica And Jorel,2,Private room,58,350,3.45,408
3170,Bud,2,Entire home/apt,149,355,0.31,504
3171,Pavel,1,Entire home/apt,200,0,0.55,200
3172,Cassi,2,Entire home/apt,100,0,0.24,100
3173,Daniel,2,Private room,50,0,0.12,50
3174,Stephanie,2,Entire home/apt,97,66,1.5,163
3175,Anya,1,Private room,84,311,2.13,395
3176,Helena,2,Entire home/apt,275,205,0.28,480
3177,Ksenia,1,Entire home/apt,99,172,3.63,271
3178,Kevin,2,Entire home/apt,70,26,0.06,96
3179,Vida,2,Entire home/apt,149,340,0.11,489
3180,Izzy,1,Entire home/apt,399,36,0.49,435
3181,Cristobal,2,Entire home/apt,145,224,4.49,369
3183,Erica And Jorel,2,Private room,59,320,3.46,379
3184,Nes,2,Private room,70,364,0.6,434
3185,Damian,1,Entire home/apt,249,281,0.62,530
3186,Patrick,2,Entire home/apt,70,81,0.39,151
3187,Devika,3,Private room,45,250,2.23,295
3188,Michelle,1,Private room,75,0,3.19,75
3189,Nicholas,2,Private room,70,0,0.04,70
3190,Alison,2,Entire home/apt,159,194,0.22,353
3191,Jonathan,1,Entire home/apt,499,0,0.12,499
3192,Erica And Jorel,2,Private room,55,341,3.31,396
3193,Jonathan,1,Private room,228,365,0.22,593
3194,Anthony,2,Private room,67,308,0.25,375
3195,Jessica,1,Private room,119,0,0.01,119
3196,Alana,1,Entire home/apt,189,0,0.13,189
3198,Sunita,2,Entire home/apt,450,1,0.21,451
3199,Rani,2,Private room,45,337,0.18,382
3200,Michael,1,Entire home/apt,175,342,0.04,517
3201,Amy,2,Entire home/apt,83,0,0.03,83
3202,Ashley,2,Entire home/apt,120,0,0.03,120
3203,Idoline,2,Private room,35,318,0.15,353
3204,Ferris,1,Entire home/apt,140,258,4.71,398
3205,Nicole,1,Private room,45,32,2.26,77
3206,Arlene,1,Private room,90,310,0.11,400
3207,Rocio & James,3,Private room,79,313,2.68,392
3208,Charlotte And Pierre,2,Private room,100,0,0.22,100
3210,Carlos,3,Private room,66,301,1.39,367
3211,Christine & James,2,Entire home/apt,140,244,1.8,384
3212,Lorelei & Alex,2,Private room,98,247,3.61,345
3213,R,2,Entire home/apt,140,230,2.36,370
3214,Evan,1,Entire home/apt,195,222,1.04,417
3215,Andre,1,Private room,60,336,3.6,396
3216,Nico,2,Entire home/apt,150,0,0.16,150
3217,John,3,Private room,40,0,0.12,40
3218,Lauren,3,Entire home/apt,130,347,0.25,477
3219,Angelica,2,Private room,75,0,0.02,75
3220,Donald P.,2,Entire home/apt,248,344,0.9,592
3221,Sasha,1,Entire home/apt,450,363,0.28,813
3222,Ellen,2,Entire home/apt,120,0,0.43,120
3223,Susan,2,Entire home/apt,250,78,1.16,328
3224,Amarie2131,1,Private room,80,0,0.02,80
3225,Zoey,1,Entire home/apt,140,2,0.25,142
3226,Jose C.,2,Entire home/apt,120,0,0.26,120
3227,Gaudhi,1,Shared room,45,312,3.36,357
3228,Gianni,2,Private room,100,44,0.02,144
3229,Susan,2,Entire home/apt,175,264,1.26,439
3230,Erika,2,Entire home/apt,130,0,0.38,130
3231,Stefano,1,Entire home/apt,175,0,0.13,175
3233,Miriam,2,Entire home/apt,650,215,2.87,865
3234,Anya,1,Private room,85,13,0.42,98
3235,Herman  F,1,Private room,175,83,0.31,258
3236,Mac,1,Private room,105,0,0.2,105
3237,Cj,2,Private room,80,0,0.07,80
3238,Bryan,2,Entire home/apt,150,39,0.6,189
3239,Karmesha,4,Entire home/apt,195,0,0.02,195
3240,Deborah,2,Entire home/apt,750,141,1.66,891
3241,Zi Ying,1,Entire home/apt,249,166,3.39,415
3242,Lauren,2,Entire home/apt,140,0,0.03,140
3243,Brandon,2,Entire home/apt,180,290,3.12,470
3244,Ryan,1,Private room,90,177,0.02,267
3245,Alex,4,Entire home/apt,120,16,1.26,136
3246,Kerri & Steve,3,Entire home/apt,85,230,1.43,315
3247,Grover,1,Entire home/apt,174,165,2.62,339
3248,Judson,1,Entire home/apt,150,203,0.04,353
3249,Matthew,1,Entire home/apt,295,245,3.82,540
3250,Michelangelo,3,Entire home/apt,180,254,1.35,434
3251,Stephanie,1,Entire home/apt,172,0,0.27,172
3252,Laurence,2,Entire home/apt,130,224,0.53,354
3253,Lilia,1,Private room,52,324,0.28,376
3254,Flick,2,Entire home/apt,220,0,0.03,220
3256,Rani,2,Private room,37,179,0.24,216
3257,Veronica,1,Private room,85,288,0.53,373
3258,"Julia, Anthony, Apollo & Atlas",2,Entire home/apt,249,40,1.13,289
3259,Maria,2,Entire home/apt,150,0,0.21,150
3260,Henri-Leon,2,Entire home/apt,119,0,0.25,119
3262,Minetta,1,Private room,90,74,2.67,164
3263,Trevor,1,Entire home/apt,200,0,0.06,200
3264,Dawn & Vernon,2,Entire home/apt,97,272,2.64,369
3265,Ryan,2,Entire home/apt,399,363,0.19,762
3266,Hannah,2,Entire home/apt,151,0,0.58,151
3268,Brian,1,Entire home/apt,200,0,0.6,200
3269,Daan,3,Entire home/apt,82,0,0.03,82
3270,Christine,1,Entire home/apt,130,5,1.42,135
3271,Alex,2,Private room,69,6,0.18,75
3272,A,3,Entire home/apt,150,148,1.32,298
3274,Erika,1,Entire home/apt,150,215,3.3,365
3275,Jennifer,1,Entire home/apt,100,0,0.03,100
3276,Graham,1,Entire home/apt,195,4,0.45,199
3277,Otilia,1,Entire home/apt,251,14,0.43,265
3278,Marc,2,Entire home/apt,200,320,0.02,520
3279,Shira,2,Entire home/apt,100,0,0.07,100
3280,David,4,Entire home/apt,140,365,0.24,505
3281,Monica,1,Entire home/apt,146,0,0.5,146
3282,Sylvana,2,Entire home/apt,250,223,1.31,473
3283,Courtney,1,Entire home/apt,499,0,0.1,499
3285,Jorge,2,Entire home/apt,80,250,3.49,330
3286,Dave,1,Entire home/apt,220,305,1.27,525
3287,Kara,1,Private room,102,0,0.13,102
3288,Anna,1,Entire home/apt,120,0,0.12,120
3289,Pierre,1,Entire home/apt,170,312,0.11,482
3291,Lindsay,1,Entire home/apt,149,0,0.03,149
3292,Julianna & Lawrence,2,Entire home/apt,180,0,0.13,180
3293,Melissa,2,Private room,89,78,0.43,167
3294,Susi,2,Entire home/apt,199,220,0.52,419
3295,Amaya,2,Private room,72,140,1.05,212
3296,Maria,2,Entire home/apt,80,3,0.12,83
3297,Tino,1,Private room,99,133,2.36,232
3298,Andres & Mapa,2,Entire home/apt,125,264,0.38,389
3299,Joseph,1,Private room,150,365,2.49,515
3301,Eva,1,Private room,106,291,2.81,397
3302,Tammy,1,Entire home/apt,250,318,0.3,568
3303,Brad,1,Private room,150,0,0.12,150
3304,Katie,2,Private room,100,358,0.24,458
3305,Marie,1,Entire home/apt,189,0,0.87,189
3306,Josh,1,Entire home/apt,1999,0,0.39,1999
3307,Sam,1,Entire home/apt,120,49,1.07,169
3308,Hannah,2,Private room,100,0,0.05,100
3309,Vida,2,Entire home/apt,149,277,0.11,426
3310,Rachel,1,Entire home/apt,480,24,0.87,504
3311,Nora,1,Private room,100,0,0.01,100
3313,Nancy,2,Private room,33,295,1.25,328
3315,Katya,1,Entire home/apt,142,242,3.17,384
3316,Terry & Kristen,3,Entire home/apt,135,243,0.62,378
3317,Giovani,2,Entire home/apt,135,325,2.45,460
3319,Ester,2,Entire home/apt,80,0,0.28,80
3320,Jose,1,Private room,80,344,0.59,424
3321,Kalae,1,Private room,87,133,4.02,220
3322,S & G,1,Entire home/apt,450,0,0.19,450
3323,Zeynep,1,Entire home/apt,275,0,0.03,275
3324,Joyce,2,Entire home/apt,150,285,0.64,435
3325,Jessica,2,Private room,50,0,0.16,50
3326,Christina,2,Private room,79,37,2.63,116
3327,Randy,2,Private room,60,305,1.38,365
3328,Jacqueline & Tyas,3,Private room,45,307,0.77,352
3329,Jordan,1,Entire home/apt,120,0,0.07,120
3330,Lauren,1,Entire home/apt,145,0,0.01,145
3331,Rachel,1,Entire home/apt,175,171,2.0,346
3332,Heidi,1,Entire home/apt,137,0,0.11,137
3334,Cesar,1,Private room,86,22,0.97,108
3336,Nadia,1,Entire home/apt,345,192,0.33,537
3338,Pedro,1,Entire home/apt,250,314,0.32,564
3339,Shari,2,Entire home/apt,105,0,0.03,105
3340,Amanda,2,Entire home/apt,130,0,0.41,130
3341,Regina,1,Private room,90,332,2.39,422
3342,Marietta,2,Entire home/apt,150,218,2.27,368
3343,Michael,2,Entire home/apt,150,0,0.62,150
3344,Chris,1,Entire home/apt,225,157,1.89,382
3346,Barbara,2,Private room,80,254,0.08,334
3347,Whitney,2,Entire home/apt,150,0,0.04,150
3348,Thomas,1,Private room,120,206,0.19,326
3349,Dianne,4,Private room,53,263,2.13,316
3350,Yolanda,2,Entire home/apt,115,47,0.07,162
3351,Beto,2,Shared room,175,0,0.1,175
3352,Daniel,1,Entire home/apt,150,0,0.08,150
3353,Brenton,1,Entire home/apt,162,247,0.26,409
3354,Anne,1,Private room,95,0,0.13,95
3355,Nicole,1,Private room,55,0,0.79,55
3356,Jake,1,Entire home/apt,117,163,3.27,280
3357,Xander,1,Entire home/apt,175,0,0.12,175
3358,Rosa,3,Entire home/apt,75,178,0.95,253
3359,Jake,1,Entire home/apt,189,271,3.25,460
3360,Molly,1,Entire home/apt,150,0,0.18,150
3361,Dany,1,Private room,45,188,0.57,233
3362,Jennifer,2,Entire home/apt,190,266,3.7,456
3363,Lydia,2,Entire home/apt,130,0,0.13,130
3364,Kenny And Christine,2,Private room,79,315,0.49,394
3366,Monica,2,Entire home/apt,150,202,1.07,352
3367,Bradley,2,Entire home/apt,100,280,1.49,380
3368,Todd,1,Entire home/apt,115,93,1.81,208
3369,Michael,1,Entire home/apt,300,169,0.55,469
3372,Jack Andrew,1,Private room,39,155,0.42,194
3374,Paul,2,Entire home/apt,200,279,0.3,479
3375,Raees,1,Entire home/apt,250,0,0.24,250
3376,Andrew And Katie,1,Entire home/apt,120,0,0.06,120
3377,Deda,1,Private room,105,365,0.46,470
3378,Mary,3,Entire home/apt,100,0,0.05,100
3382,Helene & Michael,2,Private room,85,207,0.11,292
3383,Yonathan,1,Entire home/apt,320,66,0.36,386
3384,Mirlet,3,Entire home/apt,149,291,0.56,440
3385,Nisian,1,Entire home/apt,400,0,0.02,400
3386,Mirlet,3,Private room,72,307,0.41,379
3388,Brooklyn,1,Entire home/apt,115,125,0.89,240
3389,Jay,3,Entire home/apt,325,359,1.37,684
3390,Susan,2,Private room,32,208,1.7,240
3391,Susana,1,Private room,100,0,0.16,100
3392,Igor,1,Entire home/apt,150,0,0.2,150
3393,Marvin,1,Entire home/apt,95,11,1.1,106
3394,Rafael,1,Entire home/apt,290,157,1.71,447
3395,Susan,2,Private room,30,150,0.99,180
3396,Ben,2,Entire home/apt,75,0,0.01,75
3397,Angelita,1,Entire home/apt,140,13,0.37,153
3399,Taylor,3,Entire home/apt,100,0,0.03,100
3400,Todd,1,Private room,80,146,1.4,226
3401,Sara,2,Entire home/apt,125,0,0.03,125
3402,Sim,2,Entire home/apt,250,0,0.17,250
3403,Stella,2,Private room,50,35,0.5,85
3404,Andrey,1,Entire home/apt,395,350,0.55,745
3405,Erin,1,Entire home/apt,100,0,0.16,100
3407,Tom & Lily,2,Private room,79,310,1.39,389
3409,Olabimpe,2,Private room,52,323,3.13,375
3410,Helena,1,Private room,98,102,1.09,200
3411,Lauren,2,Entire home/apt,120,0,0.04,120
3413,Meredith,1,Entire home/apt,345,0,0.83,345
3414,Joel,3,Private room,50,0,0.04,50
3417,Kris,1,Entire home/apt,350,0,0.02,350
3418,Noel And Patricia,2,Private room,57,265,2.98,322
3419,Nichola,2,Entire home/apt,120,42,0.06,162
3421,Candace,1,Entire home/apt,125,274,0.9,399
3422,Ashley & Nate,1,Entire home/apt,145,0,0.97,145
3424,Gigi,2,Private room,89,101,0.19,190
3425,Mike,2,Entire home/apt,164,208,3.37,372
3426,Mike,2,Entire home/apt,210,224,3.2,434
3427,Adrienne,1,Private room,115,0,0.02,115
3428,Amanda,1,Entire home/apt,110,0,0.31,110
3429,Connie,1,Entire home/apt,199,9,0.12,208
3430,Omar,1,Entire home/apt,272,0,0.08,272
3431,Mike,1,Private room,75,328,0.12,403
3432,Steve,1,Private room,69,84,0.62,153
3433,Evan,1,Private room,179,0,0.01,179
3434,Chun,1,Entire home/apt,106,4,0.09,110
3437,Mia,2,Private room,60,164,3.42,224
3438,Julia,1,Entire home/apt,120,0,0.04,120
3439,Lexy,4,Entire home/apt,80,0,0.02,80
3440,Anthony,1,Private room,75,345,0.67,420
3442,Jason,2,Entire home/apt,88,16,0.21,104
3444,Lilia,1,Private room,45,42,0.31,87
3445,Diana,1,Entire home/apt,75,0,0.08,75
3446,David,1,Private room,79,0,0.06,79
3447,Kat,3,Private room,55,255,0.1,310
3448,Frank,2,Private room,45,354,0.55,399
3450,Jullien,2,Private room,80,220,2.0,300
3452,Rory,2,Entire home/apt,110,0,0.05,110
3453,Wade,1,Entire home/apt,199,112,2.85,311
3454,Katja,2,Private room,94,188,2.22,282
3455,Wendy,2,Entire home/apt,400,333,0.5,733
3456,Silvia,2,Private room,60,3,0.14,63
3457,Lala,1,Entire home/apt,175,33,0.46,208
3459,Kris,1,Private room,100,0,0.06,100
3460,Jeremy,2,Entire home/apt,50,0,0.13,50
3462,Vida,2,Entire home/apt,199,308,0.14,507
3463,Brandon,2,Private room,54,0,0.06,54
3464,Katie And Matt,2,Entire home/apt,130,0,0.12,130
3465,Subhana,2,Entire home/apt,151,220,0.65,371
3466,Robyn,1,Entire home/apt,80,0,0.02,80
3467,Kate,1,Entire home/apt,110,333,0.07,443
3468,Rebecca,2,Entire home/apt,60,0,0.21,60
3469,Nadine,2,Entire home/apt,110,282,0.92,392
3470,Rob,2,Private room,73,0,0.28,73
3471,Nancy,2,Entire home/apt,177,237,3.11,414
3472,Robyn,3,Entire home/apt,90,0,0.09,90
3473,Adrien,1,Entire home/apt,190,0,0.04,190
3474,Rose,2,Entire home/apt,105,0,0.02,105
3475,Aktina,1,Entire home/apt,150,35,0.01,185
3476,Jenny,4,Private room,65,7,0.85,72
3477,Reid,2,Private room,35,0,0.03,35
3478,Corey,2,Entire home/apt,700,0,0.01,700
3479,Eric,2,Entire home/apt,185,0,0.2,185
3480,Rt,1,Entire home/apt,150,153,0.86,303
3483,Luna,1,Private room,128,0,0.75,128
3484,Jeni,1,Entire home/apt,299,14,1.37,313
3485,Christina,1,Entire home/apt,169,0,0.03,169
3486,Patrick,1,Private room,109,78,3.38,187
3487,Lorna,2,Entire home/apt,99,261,1.93,360
3489,Owen,1,Entire home/apt,239,84,0.82,323
3490,Mariya,2,Entire home/apt,100,0,0.25,100
3491,Edgar,2,Entire home/apt,124,147,0.8,271
3492,C S,2,Private room,69,362,0.96,431
3494,Kimberly,2,Entire home/apt,225,0,0.55,225
3495,Kevin,1,Entire home/apt,119,0,0.04,119
3496,Joseph,1,Entire home/apt,220,13,1.12,233
3497,Emily,2,Entire home/apt,150,0,0.1,150
3499,Angelina,2,Private room,51,0,0.32,51
3500,Daria,1,Entire home/apt,150,0,0.13,150
3501,Enrique,2,Private room,91,0,0.14,91
3502,Michael,1,Entire home/apt,139,219,0.31,358
3503,Brian,2,Entire home/apt,100,190,1.01,290
3504,Robert,3,Private room,60,329,4.64,389
3505,Laura,1,Entire home/apt,255,0,0.12,255
3506,Jp,3,Entire home/apt,94,0,0.4,94
3507,Gill,1,Entire home/apt,179,0,0.31,179
3508,Ro,1,Entire home/apt,135,267,1.56,402
3509,Sasha,2,Private room,50,33,1.14,83
3510,Jenny And Mark,2,Entire home/apt,350,99,0.95,449
3511,Jessica,1,Entire home/apt,150,269,0.41,419
3512,Adar,1,Entire home/apt,375,0,0.1,375
3513,Victoria,1,Private room,150,42,0.16,192
3515,Richard And Mollie,2,Entire home/apt,170,0,0.38,170
3516,Phoebe,2,Entire home/apt,275,0,0.05,275
3517,Angela,2,Private room,30,0,0.03,30
3518,Andrea,2,Entire home/apt,150,0,0.28,150
3519,Dai,1,Entire home/apt,140,0,0.07,140
3520,Dana,1,Entire home/apt,200,365,0.02,565
3523,Alex,3,Entire home/apt,99,42,0.89,141
3524,Joe,1,Entire home/apt,195,0,0.21,195
3525,David,1,Private room,89,0,0.32,89
3526,Adriano,2,Private room,65,305,1.37,370
3530,Gianni,2,Entire home/apt,210,343,0.1,553
3531,Vida,2,Entire home/apt,159,338,0.14,497
3532,Adriano,2,Private room,55,285,1.11,340
3533,Vida,2,Entire home/apt,129,322,0.06,451
3534,Itay,1,Entire home/apt,300,0,0.06,300
3535,Kenny And Christine,2,Private room,79,285,0.32,364
3537,Jay And Liz,1,Entire home/apt,6000,359,0.27,6359
3538,Debbie,3,Entire home/apt,64,333,0.69,397
3539,De,2,Private room,110,42,1.07,152
3540,Kevin,1,Private room,55,17,1.12,72
3541,Miguel,2,Private room,55,270,0.21,325
3544,Lorna,1,Shared room,85,0,0.25,85
3545,Mal,2,Entire home/apt,130,217,0.26,347
3547,Sarah,2,Entire home/apt,50,0,0.06,50
3548,Jochy,1,Entire home/apt,100,1,3.05,101
3549,Stephen,1,Entire home/apt,145,0,0.06,145
3550,Andrew,2,Private room,100,41,1.68,141
3551,Maria,1,Entire home/apt,200,0,0.06,200
3552,Christina,1,Entire home/apt,80,258,5.26,338
3553,Cody,1,Entire home/apt,200,364,0.06,564
3555,Julian,3,Entire home/apt,120,69,1.74,189
3556,Stephen,1,Private room,180,161,3.29,341
3557,Alfredo,1,Entire home/apt,379,0,1.52,379
3558,Susan,2,Private room,33,0,1.55,33
3560,Vida,2,Entire home/apt,199,365,0.07,564
3561,Vida,2,Entire home/apt,149,343,0.06,492
3563,Hb,1,Entire home/apt,98,170,0.59,268
3564,Matthew,1,Entire home/apt,250,239,0.52,489
3565,Garth,2,Private room,60,0,0.06,60
3566,Mary,2,Entire home/apt,149,171,0.73,320
3568,Tico,2,Entire home/apt,85,41,1.93,126
3569,Seth,1,Entire home/apt,90,0,0.36,90
3570,Don Luis,3,Private room,47,162,0.16,209
3571,Host,1,Entire home/apt,180,337,0.25,517
3572,Chris,1,Private room,110,0,0.04,110
3573,Leon,2,Entire home/apt,170,26,2.02,196
3574,Dain,1,Entire home/apt,210,0,0.42,210
3576,Mike,3,Entire home/apt,65,302,2.45,367
3578,Chris,1,Entire home/apt,225,0,0.29,225
3580,Richelle And Pela,2,Entire home/apt,170,314,1.86,484
3581,Tye And Etienne,1,Private room,62,336,0.19,398
3582,Ashley,1,Entire home/apt,125,0,0.13,125
3583,Chad,1,Private room,106,0,0.02,106
3584,Carlyn,1,Private room,93,7,2.23,100
3585,Jenn,1,Private room,85,299,0.77,384
3587,Kenneth,1,Entire home/apt,224,0,0.21,224
3588,Shelly,2,Private room,145,291,0.82,436
3589,Rebecca,2,Private room,40,0,0.01,40
3590,Pat,1,Private room,135,98,2.42,233
3591,Lydia,1,Private room,97,58,2.69,155
3592,Alberto,1,Private room,69,90,0.65,159
3593,Roberta (And Chris),2,Entire home/apt,225,89,3.55,314
3595,Margy,1,Entire home/apt,215,0,0.04,215
3596,Rob,2,Private room,99,88,0.25,187
3599,David,3,Private room,60,184,0.16,244
3600,Inbar,1,Entire home/apt,303,3,0.46,306
3602,Rhonda,2,Entire home/apt,111,261,1.65,372
3603,Ryan,2,Private room,60,92,0.15,152
3604,Edward,2,Entire home/apt,320,330,2.99,650
3605,Joni,2,Entire home/apt,112,42,4.82,154
3606,Sharon And Ronn,2,Entire home/apt,185,348,3.2,533
3607,Laura,3,Private room,100,305,0.57,405
3608,Cat,2,Entire home/apt,150,0,0.02,150
3609,Ritza,1,Private room,130,48,1.73,178
3610,Adrien,2,Entire home/apt,130,0,0.18,130
3612,Edward,2,Entire home/apt,125,196,0.32,321
3613,Sheila,1,Entire home/apt,190,55,3.34,245
3614,Benjamin,2,Private room,70,365,0.63,435
3615,Poppi,1,Entire home/apt,599,0,0.14,599
3616,Kerstin,2,Private room,80,199,1.39,279
3618,Sean,1,Entire home/apt,100,128,0.47,228
3619,Gregory,1,Entire home/apt,200,339,0.05,539
3620,Logan,1,Private room,60,33,0.45,93
3621,Brett,2,Private room,100,365,0.36,465
3623,Tracy,1,Private room,90,0,1.29,90
3624,Maya,2,Private room,61,0,0.06,61
3626,Florian / Anna,3,Private room,100,365,0.24,465
3627,Alex,1,Entire home/apt,340,365,0.41,705
3628,Jaclyn,2,Private room,75,154,3.03,229
3629,Michelle,2,Entire home/apt,130,39,0.17,169
3630,Aditya,2,Entire home/apt,140,0,0.1,140
3631,Phyllis,1,Entire home/apt,112,313,0.34,425
3632,Zed,1,Entire home/apt,160,0,0.4,160
3633,Adrianne,1,Entire home/apt,165,301,2.27,466
3634,Nina,1,Private room,80,301,0.12,381
3638,Jeffrey,1,Entire home/apt,160,0,0.12,160
3640,Anthony,2,Entire home/apt,150,144,2.55,294
3643,Dana  (& Justin),1,Private room,49,52,1.22,101
3644,Jan,1,Entire home/apt,675,0,0.05,675
3645,Craig,1,Entire home/apt,150,6,0.15,156
3647,Yanina,1,Private room,79,2,3.93,81
3648,Marie,1,Entire home/apt,225,320,0.8,545
3649,Mete,2,Private room,90,250,2.26,340
3650,Sj,2,Entire home/apt,285,364,0.36,649
3651,Ish & Asa,1,Entire home/apt,300,0,0.06,300
3652,Thomas,2,Private room,55,157,0.16,212
3653,J,1,Entire home/apt,80,315,1.26,395
3654,Maureen And Josiah,1,Private room,90,281,4.32,371
3655,Yumi,1,Entire home/apt,325,0,0.05,325
3656,Maryam,1,Private room,55,0,0.14,55
3657,Eden,1,Private room,208,313,0.6,521
3658,Nina,1,Entire home/apt,156,300,0.15,456
3659,Reid,2,Entire home/apt,85,1,0.22,86
3660,James,2,Entire home/apt,200,0,0.06,200
3661,Aviad,1,Entire home/apt,180,0,0.03,180
3663,H,2,Entire home/apt,325,277,3.33,602
3665,Laura,1,Entire home/apt,160,7,1.19,167
3666,Jay,1,Private room,130,0,1.0,130
3667,Beth,1,Private room,110,63,3.1,173
3668,Claudia,1,Entire home/apt,150,29,3.25,179
3669,Mena,1,Private room,149,270,2.06,419
3671,Everett,1,Entire home/apt,215,0,0.27,215
3672,Richard,1,Entire home/apt,155,0,0.38,155
3673,Tim,2,Private room,50,0,0.07,50
3675,Alicia,1,Private room,65,114,0.05,179
3676,Rebecca And Vilem,2,Entire home/apt,112,248,2.21,360
3677,Alex&Ivy,1,Entire home/apt,250,273,1.64,523
3678,Ashley,2,Private room,65,19,0.19,84
3680,Lex,1,Entire home/apt,99,327,2.39,426
3681,T,1,Entire home/apt,395,340,0.02,735
3683,Laura And Jake,1,Entire home/apt,185,0,0.31,185
3685,Adam,2,Private room,45,241,0.68,286
3688,Lyndell,1,Private room,55,34,0.27,89
3690,Rachel,1,Entire home/apt,165,8,1.0,173
3691,Allison,1,Entire home/apt,285,194,0.74,479
3692,Victoria,1,Entire home/apt,220,31,0.32,251
3693,Emery,4,Private room,75,365,0.2,440
3694,Assaf,2,Entire home/apt,120,2,0.27,122
3698,Carly & Sebastian,2,Entire home/apt,100,10,0.15,110
3699,Karen,1,Private room,95,270,0.11,365
3701,Ever,1,Private room,119,265,2.21,384
3704,Katarina,2,Shared room,48,0,2.21,48
3705,John,1,Shared room,30,304,1.88,334
3706,Vanessa,3,Entire home/apt,65,0,0.03,65
3707,Alosha,3,Private room,79,238,0.29,317
3708,Jian,1,Entire home/apt,105,121,0.46,226
3709,Victoria,1,Entire home/apt,420,0,0.04,420
3711,Penny,2,Entire home/apt,95,0,0.05,95
3712,Monika,2,Entire home/apt,290,195,0.39,485
3715,Stephanie,1,Entire home/apt,180,0,0.03,180
3716,Philippe,1,Entire home/apt,380,43,0.18,423
3718,Indie,2,Entire home/apt,45,0,0.43,45
3719,Michelle,1,Entire home/apt,300,0,0.05,300
3724,James,1,Entire home/apt,110,0,0.06,110
3725,Clifton,2,Entire home/apt,105,248,4.29,353
3726,Lisa,2,Private room,45,221,0.64,266
3728,Sole,2,Entire home/apt,80,15,1.66,95
3733,Maayan,1,Private room,89,10,0.15,99
3734,Jordan,1,Private room,129,0,0.02,129
3737,Sal,1,Entire home/apt,250,310,0.06,560
3738,Jenna,1,Entire home/apt,250,0,0.03,250
3739,Danielle,1,Entire home/apt,175,0,0.08,175
3740,Danni,2,Private room,40,0,0.16,40
3742,Kevin,2,Private room,85,0,0.02,85
3743,Alison,2,Entire home/apt,219,31,0.33,250
3744,Kourosh,1,Entire home/apt,130,156,0.39,286
3745,Vida,2,Entire home/apt,149,330,0.09,479
3746,Jeff,1,Entire home/apt,100,0,0.12,100
3747,Ever,1,Entire home/apt,289,247,0.96,536
3748,Lex,1,Private room,67,331,0.36,398
3749,Charles,1,Entire home/apt,221,256,4.91,477
3751,Victor,2,Private room,75,0,0.05,75
3759,Adam,1,Entire home/apt,112,244,0.34,356
3760,Bobbi,1,Entire home/apt,175,0,0.29,175
3761,Tzvi,2,Entire home/apt,1485,260,0.24,1745
3762,Sandra,3,Entire home/apt,120,81,0.19,201
3763,Marie-Hélène & Rick,1,Entire home/apt,150,0,0.02,150
3764,William,1,Entire home/apt,369,0,0.02,369
3765,Gaudhi,1,Private room,81,13,2.23,94
3766,Paul & Marçal,2,Private room,89,147,2.67,236
3767,Vida,2,Entire home/apt,199,127,0.06,326
3769,Skip,2,Private room,45,270,3.25,315
3770,Vida,2,Entire home/apt,149,337,0.03,486
3773,Sufia,3,Private room,65,362,0.22,427
3775,Lara,1,Entire home/apt,150,0,0.73,150
3777,Dylan,1,Entire home/apt,199,0,0.16,199
3778,Anthony,1,Entire home/apt,395,0,0.19,395
3780,Clarina,2,Entire home/apt,130,297,0.43,427
3781,Corey,1,Private room,175,0,0.07,175
3783,Sally,1,Private room,90,255,2.92,345
3786,Ariel,1,Entire home/apt,350,365,0.14,715
3787,Sarah,2,Entire home/apt,250,0,0.06,250
3789,(Email hidden by Airbnb),1,Private room,250,170,0.58,420
3791,Vanessa,2,Entire home/apt,180,24,1.83,204
3795,Connor,2,Private room,49,0,0.04,49
3797,Peter,2,Private room,91,113,2.82,204
3798,Rob,1,Private room,100,0,0.26,100
3799,Lauren,1,Entire home/apt,152,0,0.14,152
3801,Shell,1,Private room,110,239,3.5,349
3805,Lindsey,1,Entire home/apt,135,0,0.06,135
3806,Mary,1,Entire home/apt,75,0,0.33,75
3809,Donna,4,Entire home/apt,250,338,0.04,588
3810,Jj,1,Entire home/apt,200,0,0.16,200
3811,Annie,2,Private room,75,334,0.08,409
3815,Lana,3,Entire home/apt,88,262,0.77,350
3817,Troy,1,Entire home/apt,975,0,0.02,975
3818,Alexandra,2,Entire home/apt,305,30,0.12,335
3819,Nathan,1,Entire home/apt,220,112,3.45,332
3820,Cory,1,Entire home/apt,150,0,0.26,150
3821,Carrie-Anne,2,Private room,49,8,0.07,57
3823,Jake,2,Entire home/apt,140,307,2.41,447
3824,Laura,3,Entire home/apt,86,53,0.79,139
3825,Jamie,1,Entire home/apt,650,0,0.47,650
3827,Shaina,1,Entire home/apt,225,88,0.09,313
3828,Chris,1,Private room,75,0,0.06,75
3829,Amy,1,Entire home/apt,150,0,0.75,150
3830,Tim,1,Private room,199,0,0.56,199
3831,Guillermo,2,Entire home/apt,95,22,3.1,117
3832,Lee,2,Entire home/apt,200,51,1.73,251
3833,Alina,1,Entire home/apt,200,346,0.73,546
3834,Claudia,2,Entire home/apt,175,24,0.5,199
3835,Vida,2,Entire home/apt,129,365,0.08,494
3836,Alix,2,Entire home/apt,200,0,0.22,200
3837,Gita,1,Private room,60,365,0.18,425
3839,Steve,1,Private room,115,55,3.69,170
3840,Eyal,1,Private room,135,296,1.22,431
3842,Vanessa,3,Private room,59,87,1.61,146
3843,Lila & Paul,2,Entire home/apt,196,261,4.31,457
3844,Christopher,2,Private room,128,219,0.8,347
3846,Georgia,1,Entire home/apt,200,363,0.18,563
3847,Doria,1,Entire home/apt,180,0,0.22,180
3848,Barbara,2,Private room,60,190,0.28,250
3849,Michele,2,Private room,70,264,0.03,334
3850,Fany,1,Private room,40,291,1.29,331
3851,Helena,2,Entire home/apt,250,195,0.11,445
3852,Rebeca,2,Entire home/apt,80,0,0.39,80
3853,Brenda,1,Entire home/apt,85,35,1.38,120
3854,Véronique,1,Private room,70,0,3.03,70
3855,Ezra,2,Private room,55,0,0.08,55
3857,El,2,Private room,100,0,0.14,100
3858,Nora,2,Private room,73,13,0.3,86
3860,Lauren,3,Private room,65,146,2.82,211
3861,Ruby,2,Entire home/apt,162,103,1.2,265
3862,Karen,3,Entire home/apt,275,342,0.14,617
3864,Laurence,1,Entire home/apt,200,0,0.55,200
3865,Andreas,1,Entire home/apt,250,0,2.72,250
3866,Krystal,2,Entire home/apt,500,365,0.19,865
3867,Audrey,2,Entire home/apt,120,108,0.22,228
3868,Emma,2,Private room,55,0,0.36,55
3869,Devi,2,Private room,59,22,2.15,81
3870,Michele,2,Entire home/apt,99,0,0.02,99
3871,Alice,1,Entire home/apt,155,0,1.3,155
3872,Ashley,1,Entire home/apt,200,0,0.08,200
3873,John,1,Private room,60,0,0.35,60
3874,Lee,3,Entire home/apt,85,238,1.66,323
3875,Rip,1,Private room,150,4,0.48,154
3876,Rob,3,Private room,45,190,0.42,235
3877,Michal,1,Entire home/apt,200,223,2.51,423
3878,Andre,2,Entire home/apt,120,292,2.97,412
3880,Enid,1,Entire home/apt,195,233,2.13,428
3883,Elska,2,Entire home/apt,76,282,0.44,358
3885,Rich,2,Entire home/apt,500,364,1.17,864
3886,Edmund,2,Entire home/apt,179,242,2.33,421
3887,C S,2,Private room,200,362,0.5,562
3889,Août,4,Shared room,32,83,0.16,115
3890,Beth,2,Private room,50,0,0.25,50
3892,Rong,1,Private room,40,0,0.08,40
3893,Clay,2,Private room,62,110,0.65,172
3894,Jessica,2,Private room,239,363,0.28,602
3895,Julian,2,Entire home/apt,179,336,0.37,515
3896,Lara,2,Entire home/apt,250,284,0.35,534
3897,Lillian,1,Entire home/apt,400,35,0.13,435
3898,Annette,1,Private room,98,312,2.85,410
3899,Georgia,2,Private room,89,0,1.55,89
3900,Luanna,1,Entire home/apt,185,0,0.27,185
3901,Anoop,1,Private room,125,0,0.34,125
3902,James,2,Entire home/apt,180,0,0.02,180
3903,Sandra&Orlando,2,Shared room,30,288,0.52,318
3904,Ron,2,Private room,60,333,0.54,393
3905,Ross,1,Private room,115,276,2.3,391
3906,Hetty,2,Entire home/apt,200,0,0.21,200
3908,Sally,1,Entire home/apt,179,365,0.27,544
3909,Michael,2,Entire home/apt,109,0,0.19,109
3910,Pj,1,Private room,124,236,4.1,360
3911,Daniel,1,Entire home/apt,159,25,1.1,184
3912,H. Erin,2,Entire home/apt,85,12,0.14,97
3913,Matthew,2,Private room,109,269,1.64,378
3914,Alice,1,Entire home/apt,110,0,0.02,110
3916,Sarah,1,Private room,65,0,0.04,65
3917,Anthony,1,Private room,112,179,1.44,291
3918,Gloria,2,Shared room,25,258,1.22,283
3920,Darwin And Nicole,2,Entire home/apt,79,0,0.71,79
3921,Marianne,2,Entire home/apt,200,205,0.03,405
3922,Sue,2,Private room,55,129,0.34,184
3923,Migdalia,4,Private room,50,156,0.51,206
3924,Vida,2,Entire home/apt,129,325,0.16,454
3925,Sally,1,Entire home/apt,195,327,0.73,522
3926,Janet,2,Entire home/apt,79,6,0.13,85
3927,Arthur,1,Private room,65,123,1.71,188
3928,Redi,1,Entire home/apt,123,0,0.13,123
3929,Sofia,2,Private room,70,0,0.15,70
3930,Walther,3,Private room,100,97,0.58,197
3931,Devi,2,Private room,69,22,2.41,91
3932,Simonie,1,Entire home/apt,450,0,0.16,450
3934,Carlos,1,Entire home/apt,125,249,0.13,374
3935,Kaet,2,Private room,75,306,0.55,381
3936,Kaet,2,Entire home/apt,154,213,0.11,367
3937,Francesca,1,Entire home/apt,60,0,0.19,60
3938,Rose,1,Entire home/apt,279,363,1.22,642
3939,Kaori,1,Private room,80,178,0.05,258
3940,Reka,1,Private room,84,59,2.86,143
3941,Georgia,2,Entire home/apt,180,26,1.0,206
3942,Andrea,2,Entire home/apt,100,0,0.11,100
3943,Christine,2,Private room,86,35,0.31,121
3944,Sharon,2,Entire home/apt,189,33,0.39,222
3945,Andrew,1,Entire home/apt,130,262,0.1,392
3946,Tiffany,1,Entire home/apt,150,215,1.48,365
3947,Vida,2,Entire home/apt,149,0,0.07,149
3951,Andrea,2,Entire home/apt,100,0,0.02,100
3952,Rachel,2,Private room,145,64,0.45,209
3953,Sausan,1,Entire home/apt,133,221,2.82,354
3954,Joao,3,Private room,75,193,2.93,268
3955,Mike And Lucy,2,Private room,100,341,0.25,441
3956,Chris,1,Shared room,99,0,1.46,99
3957,Garth,2,Entire home/apt,132,0,0.14,132
3958,Jimmie,1,Private room,72,183,0.44,255
3959,Amy,3,Entire home/apt,125,0,0.22,125
3960,Lee,2,Entire home/apt,102,2,0.41,104
3961,Vida,2,Entire home/apt,129,303,0.05,432
3962,Seth,2,Entire home/apt,107,18,0.55,125
3963,Nico,1,Entire home/apt,250,0,0.05,250
3964,Inez,3,Private room,90,324,0.25,414
3966,Cristina,2,Private room,90,0,0.03,90
3967,Ziporah,1,Private room,200,0,0.33,200
3968,Laura,2,Entire home/apt,160,0,0.15,160
3969,Pj,1,Private room,124,149,3.02,273
3970,Omar,2,Private room,95,137,2.72,232
3971,Vida,2,Entire home/apt,129,341,0.04,470
3972,En,2,Private room,110,323,1.04,433
3973,Leah,1,Private room,92,276,2.71,368
3974,Grover,1,Entire home/apt,175,38,2.46,213
3976,Peter,2,Entire home/apt,134,264,2.45,398
3977,Andrew,1,Entire home/apt,400,30,0.28,430
3978,Vanita,1,Entire home/apt,152,0,0.1,152
3980,Chiara,1,Private room,169,60,0.24,229
3981,Priya,2,Private room,95,274,2.43,369
3982,Priya,2,Private room,90,306,2.22,396
3983,Jerome,1,Private room,60,356,1.34,416
3984,Asaf,1,Entire home/apt,180,97,0.85,277
3985,Daniel,1,Private room,84,294,2.38,378
3986,Josh,2,Entire home/apt,98,8,0.5,106
3987,Angel,2,Entire home/apt,90,0,0.33,90
3988,Dusan,2,Entire home/apt,134,0,0.09,134
3989,Michael,1,Private room,119,0,1.09,119
3990,Megan,1,Entire home/apt,141,0,0.33,141
3991,Idan,1,Entire home/apt,199,0,0.05,199
3992,Suzette,2,Entire home/apt,108,89,3.62,197
3993,Robyn,1,Entire home/apt,150,0,0.05,150
3994,Ginger,2,Entire home/apt,175,14,0.72,189
3995,Elizabeth,2,Private room,90,0,0.08,90
3996,Daniel,2,Private room,45,151,0.06,196
3998,Claudius,3,Entire home/apt,63,23,2.28,86
3999,Rose,1,Private room,100,308,0.22,408
4000,Heather,2,Private room,110,157,0.63,267
4002,Dominique,3,Entire home/apt,395,319,0.8,714
4003,Tegan,3,Private room,70,0,0.02,70
4004,Jada,1,Entire home/apt,399,267,1.37,666
4005,Scott,1,Entire home/apt,145,282,0.35,427
4006,Nicholas P,3,Private room,59,346,0.31,405
4007,Jimmy,3,Private room,50,0,0.03,50
4008,John,1,Entire home/apt,145,0,0.86,145
4009,Anthony,1,Entire home/apt,245,0,0.07,245
4010,Fabiola,1,Private room,149,78,3.11,227
4011,Brenna,2,Private room,50,0,0.02,50
4012,Solange,3,Entire home/apt,150,0,0.02,150
4014,Mari,2,Entire home/apt,60,0,0.03,60
4015,Elizabeth,2,Entire home/apt,165,0,0.11,165
4016,Jason,2,Private room,53,60,2.51,113
4018,Jason,2,Private room,38,280,0.62,318
4019,Jason,2,Private room,49,120,1.51,169
4020,Jason,2,Private room,47,74,1.43,121
4021,Julie,2,Entire home/apt,120,61,0.24,181
4022,Jenna,1,Entire home/apt,175,0,0.76,175
4023,Alex,1,Entire home/apt,129,171,0.25,300
4024,SirRoan,2,Private room,105,0,0.02,105
4025,Jodie,2,Entire home/apt,275,0,0.05,275
4027,Ryan,1,Entire home/apt,210,0,0.5,210
4028,Laura,1,Private room,65,0,0.02,65
4029,Christina,2,Private room,52,281,0.11,333
4030,Ismail,3,Private room,100,0,0.51,100
4031,KayCee,1,Private room,91,0,0.44,91
4032,Patricia,1,Entire home/apt,124,279,1.93,403
4034,Gary,2,Entire home/apt,550,0,0.38,550
4035,Nicolas,4,Private room,70,313,0.73,383
4036,Wilson,1,Entire home/apt,150,111,2.46,261
4037,Vinneth,2,Entire home/apt,176,302,2.64,478
4038,Martin,1,Entire home/apt,99,0,0.14,99
4039,Milenna,1,Entire home/apt,130,0,0.06,130
4040,Lang,1,Entire home/apt,109,261,3.22,370
4041,Doug,1,Private room,75,109,1.92,184
4042,Jonathan,1,Private room,95,0,0.11,95
4043,Daisy,2,Private room,50,0,0.02,50
4044,Ellie,2,Private room,100,0,0.61,100
4045,Alessandro,1,Private room,68,64,1.36,132
4046,Craig,1,Private room,104,42,4.67,146
4047,Yago,2,Private room,30,0,0.08,30
4048,Dominick,2,Entire home/apt,595,0,0.39,595
4049,Carlos,2,Private room,65,0,0.19,65
4050,Serenity,1,Shared room,55,0,0.2,55
4051,Nan,2,Entire home/apt,250,56,0.09,306
4052,Zandy,2,Entire home/apt,85,324,0.64,409
4053,Matteo,1,Private room,90,21,1.73,111
4054,Angie,1,Private room,90,0,0.03,90
4055,Sean,2,Entire home/apt,90,310,0.14,400
4056,Jennifer,1,Entire home/apt,199,0,0.03,199
4057,G,1,Entire home/apt,275,365,0.03,640
4059,Shay,1,Private room,150,0,0.36,150
4060,Jessica,3,Entire home/apt,140,0,0.22,140
4062,Lila,2,Private room,60,0,1.24,60
4063,Guillaume,2,Private room,36,0,0.03,36
4064,Wendy,1,Private room,85,66,1.27,151
4065,Eva,2,Private room,85,0,0.11,85
4066,Melinda,2,Private room,45,287,0.48,332
4067,Frances,2,Entire home/apt,92,173,3.61,265
4068,Johnny,2,Private room,30,0,0.02,30
4069,Andrew,2,Private room,75,0,0.05,75
4070,Abraham,1,Entire home/apt,99,0,0.24,99
4071,Justin,2,Entire home/apt,100,327,0.21,427
4072,Alex,2,Entire home/apt,115,188,0.94,303
4073,Stephen And Hector,2,Entire home/apt,175,0,0.25,175
4074,Chaydha,2,Entire home/apt,112,0,0.52,112
4075,Nicole,1,Entire home/apt,450,0,0.16,450
4076,AFI Apartments,1,Entire home/apt,103,326,0.23,429
4078,Sonja,1,Entire home/apt,150,0,0.14,150
4079,Aaron,5,Private room,129,86,0.85,215
4080,Omar,1,Entire home/apt,145,0,0.13,145
4083,Joe,1,Entire home/apt,90,0,0.02,90
4084,Oz,2,Entire home/apt,100,151,1.57,251
4085,Tmc,4,Private room,41,0,0.35,41
4086,AFI Apartments,1,Entire home/apt,145,329,0.11,474
4087,AFI Apartments,1,Entire home/apt,139,308,0.07,447
4088,AFI Apartments,1,Entire home/apt,117,255,0.11,372
4089,Mark,2,Private room,50,0,0.12,50
4090,Ronnie,1,Private room,80,118,4.02,198
4091,Conall,2,Entire home/apt,100,0,0.16,100
4092,Jas,2,Entire home/apt,225,0,0.19,225
4093,Guyen,2,Private room,70,176,2.21,246
4094,Angel,4,Private room,80,365,0.03,445
4095,Yoni,1,Private room,70,247,4.27,317
4096,Susan,2,Private room,31,158,0.97,189
4097,Rachael And Christopher,2,Private room,40,0,0.39,40
4098,Radu,1,Entire home/apt,290,359,0.2,649
4099,Daria,2,Entire home/apt,235,31,0.36,266
4100,Nicole,2,Entire home/apt,200,0,0.06,200
4102,Heather,2,Entire home/apt,110,85,0.88,195
4103,Arash,1,Private room,120,0,0.09,120
4104,AFI Apartments,1,Entire home/apt,142,205,0.03,347
4105,Helena,1,Private room,105,20,0.33,125
4106,Tanya,1,Entire home/apt,100,0,0.06,100
4107,João,1,Private room,102,0,0.26,102
4108,David,2,Entire home/apt,152,269,5.2,421
4109,Clayon Elizabeth,2,Entire home/apt,150,207,0.38,357
4110,Abby & Kurt,3,Entire home/apt,95,6,3.04,101
4111,Anthony,2,Private room,67,300,0.8,367
4112,Clare,2,Private room,65,73,0.81,138
4113,Lulú,2,Private room,79,313,0.34,392
4114,Al,2,Private room,55,135,2.37,190
4115,Angélique,1,Entire home/apt,83,0,0.02,83
4116,Lenny,1,Entire home/apt,200,170,0.65,370
4118,Fabrizio,1,Entire home/apt,160,281,0.28,441
4119,Jimmy,3,Entire home/apt,80,32,3.13,112
4120,Jason,1,Entire home/apt,159,0,0.05,159
4121,Izumi,1,Entire home/apt,90,0,0.25,90
4122,Madeline,2,Shared room,45,0,0.19,45
4123,Peter,1,Private room,100,223,2.21,323
4124,Michael,2,Entire home/apt,125,60,0.25,185
4126,Fabian,1,Private room,80,187,2.24,267
4127,Isabel,1,Entire home/apt,2300,139,0.53,2439
4128,Lamee,2,Entire home/apt,90,280,1.2,370
4129,Kurtis,1,Entire home/apt,140,0,0.04,140
4130,Dawn,2,Private room,52,342,0.18,394
4131,Alexandra,1,Entire home/apt,200,0,0.18,200
4133,Howard T.,2,Shared room,40,0,0.13,40
4134,Renald,3,Private room,55,89,0.2,144
4135,Mira,2,Private room,69,0,0.1,69
4136,Natalie,1,Entire home/apt,200,0,0.09,200
4137,Brittany,2,Entire home/apt,100,334,1.65,434
4138,Sofia,2,Entire home/apt,53,220,0.27,273
4139,Rebecca,1,Private room,425,365,0.39,790
4140,Denise,4,Private room,40,292,0.72,332
4141,Michelle,2,Private room,40,0,0.5,40
4143,Micky,1,Private room,65,0,0.02,65
4144,Kevin,1,Private room,109,103,4.58,212
4145,Favio,3,Private room,60,348,1.05,408
4146,Luis,2,Entire home/apt,180,0,0.21,180
4147,Jovana,3,Private room,95,39,1.98,134
4148,Anthony,1,Private room,140,296,0.82,436
4149,Cecile,3,Entire home/apt,155,0,0.07,155
4150,John,1,Entire home/apt,105,12,2.09,117
4151,Vashti,2,Private room,45,365,0.83,410
4152,Thomas,2,Entire home/apt,330,0,0.02,330
4154,Juan,1,Private room,100,305,3.1,405
4155,Julie,2,Private room,49,284,1.16,333
4156,Sarah,2,Entire home/apt,65,98,0.09,163
4157,Tyrell,1,Private room,70,0,0.11,70
4158,Daniel,1,Entire home/apt,180,0,0.11,180
4159,Diane,3,Entire home/apt,130,0,0.02,130
4160,Amir,2,Entire home/apt,225,112,1.51,337
4162,Juliette,1,Private room,85,318,0.63,403
4164,Karen,1,Entire home/apt,99,107,0.14,206
4165,Arya,3,Private room,95,140,2.92,235
4166,Grace,3,Entire home/apt,400,281,0.15,681
4167,Gregory,1,Private room,99,307,1.28,406
4168,Gregory,1,Private room,85,341,1.6,426
4169,Jonathan,1,Entire home/apt,90,3,0.25,93
4170,Renee,2,Entire home/apt,85,38,0.66,123
4171,Tina,1,Entire home/apt,130,0,0.08,130
4172,Arash,1,Private room,95,0,0.75,95
4173,Vida,2,Entire home/apt,149,341,0.08,490
4174,Nicole,2,Entire home/apt,225,0,0.04,225
4175,Monica,2,Entire home/apt,135,0,0.03,135
4176,Ed,1,Entire home/apt,140,0,0.73,140
4177,Will,1,Entire home/apt,200,0,0.07,200
4178,Vida,2,Entire home/apt,159,327,0.12,486
4179,Naz,2,Entire home/apt,200,81,1.68,281
4180,Clayon Elizabeth,2,Entire home/apt,155,336,0.36,491
4181,Patrizza,2,Entire home/apt,125,0,0.29,125
4182,Martine,4,Private room,71,45,0.37,116
4183,Robert,2,Private room,75,266,1.22,341
4184,Bridget,1,Entire home/apt,275,157,0.11,432
4186,Scott,1,Entire home/apt,250,0,0.02,250
4187,Tony,2,Entire home/apt,200,64,2.03,264
4188,Herby,2,Entire home/apt,90,311,0.08,401
4189,Yagil,2,Private room,50,0,0.09,50
4190,Devin,2,Entire home/apt,124,165,1.06,289
4192,Fotis,3,Private room,50,313,0.59,363
4193,Zachary,1,Private room,75,0,0.02,75
4194,Vijay,1,Private room,90,0,0.03,90
4195,Jonathan,2,Entire home/apt,130,248,1.45,378
4196,Mike,1,Entire home/apt,140,0,0.3,140
4197,Sarah,2,Entire home/apt,200,0,0.03,200
4198,Ann,2,Entire home/apt,350,0,0.12,350
4199,Sarah,1,Entire home/apt,100,0,0.39,100
4200,Taylor,3,Entire home/apt,225,0,0.02,225
4201,Heather,2,Private room,65,0,0.07,65
4202,Seth,2,Entire home/apt,145,275,2.75,420
4203,Cong,1,Entire home/apt,189,0,0.25,189
4204,Eva,1,Entire home/apt,265,29,0.1,294
4205,Marie-Christine,1,Entire home/apt,409,0,0.05,409
4206,Olivia,2,Private room,95,0,0.19,95
4207,Sandy,1,Private room,175,324,1.41,499
4208,Funda,3,Private room,55,30,1.82,85
4209,Al,1,Entire home/apt,200,248,0.57,448
4210,Craig,1,Entire home/apt,200,88,0.81,288
4211,Jasmine,2,Private room,69,280,2.89,349
4212,Rachel,2,Entire home/apt,135,76,0.53,211
4213,Linda,2,Entire home/apt,325,0,0.2,325
4214,Michelle,1,Private room,95,18,4.2,113
4215,AFI Apartments,1,Entire home/apt,117,298,0.09,415
4216,Nick,1,Private room,59,99,1.33,158
4217,Luis,1,Shared room,85,171,1.03,256
4218,Ruth,3,Private room,55,333,0.82,388
4219,Lisa,2,Private room,80,13,5.54,93
4220,Evan,2,Entire home/apt,115,0,0.04,115
4221,Lisa,1,Private room,78,49,0.74,127
4222,Chris,1,Private room,150,357,0.6,507
4223,Yulia,2,Entire home/apt,195,0,0.05,195
4224,Max,2,Entire home/apt,142,157,0.13,299
4226,Ada Azra,4,Shared room,55,365,0.16,420
4227,Jenn,2,Entire home/apt,97,282,0.12,379
4228,Ariana,2,Entire home/apt,70,211,0.21,281
4229,Jeani,1,Shared room,70,262,3.53,332
4230,Frances,1,Private room,155,88,0.4,243
4231,Bruce,2,Entire home/apt,68,0,0.09,68
4232,Amina,1,Private room,68,129,0.61,197
4233,Eilon,2,Entire home/apt,150,53,1.33,203
4235,Ken,1,Entire home/apt,150,0,0.02,150
4236,Henriette,1,Private room,100,365,0.07,465
4237,Joy,1,Entire home/apt,110,331,1.61,441
4238,Eric,2,Entire home/apt,150,0,0.02,150
4240,Marc,1,Entire home/apt,218,304,0.9,522
4241,Kiki,1,Entire home/apt,430,14,0.38,444
4242,Chris,2,Private room,79,111,2.83,190
4243,Martina,1,Entire home/apt,120,99,0.91,219
4244,Norman,2,Entire home/apt,200,15,0.67,215
4245,Francesca,1,Private room,120,0,0.19,120
4247,Stanton,1,Entire home/apt,200,0,0.45,200
4248,Skylar,5,Entire home/apt,75,0,0.02,75
4249,Tyson,2,Entire home/apt,175,0,0.03,175
4250,Virginie,2,Entire home/apt,76,333,0.04,409
4251,Samantha,1,Entire home/apt,75,0,0.1,75
4252,Sil,2,Entire home/apt,400,171,0.35,571
4253,Ruth,3,Private room,75,355,0.77,430
4254,Cyn,1,Entire home/apt,189,0,0.02,189
4255,Emily,3,Private room,55,0,0.02,55
4256,Ger,2,Private room,80,0,0.18,80
4257,Cash,2,Private room,69,238,0.31,307
4258,Ines,1,Private room,100,0,0.02,100
4259,Neisha,3,Entire home/apt,100,0,0.02,100
4260,Brandon,1,Entire home/apt,300,219,0.3,519
4261,Juan,1,Private room,53,117,3.29,170
4262,Matthew,1,Entire home/apt,179,0,0.26,179
4264,Fernando,3,Entire home/apt,130,170,0.82,300
4265,Caroline,4,Entire home/apt,120,0,1.54,120
4266,Jerome,2,Private room,150,16,0.42,166
4267,AFI Apartments,1,Entire home/apt,105,265,0.09,370
4268,Raymond,2,Entire home/apt,150,209,3.19,359
4269,Roger,1,Entire home/apt,200,0,0.02,200
4270,Gen,1,Private room,39,168,0.3,207
4271,Denise,1,Entire home/apt,67,0,0.12,67
4272,Paula,1,Entire home/apt,200,32,0.93,232
4273,Vida,2,Entire home/apt,129,336,0.05,465
4274,Randy,2,Private room,55,307,1.11,362
4275,Delia,3,Private room,65,198,0.48,263
4276,Bee,1,Entire home/apt,100,0,0.29,100
4278,Alfonso,1,Entire home/apt,240,0,0.02,240
4279,Aspen,1,Entire home/apt,150,107,0.52,257
4280,Anna,1,Entire home/apt,299,267,2.46,566
4281,Anastasia,3,Entire home/apt,160,269,2.78,429
4284,Vida,2,Entire home/apt,199,311,0.08,510
4285,Erin,1,Private room,100,0,0.55,100
4286,Gilberto,1,Private room,45,53,1.92,98
4287,"Rossy,  Carmen And Juan",4,Private room,44,70,2.13,114
4290,Andrea,1,Entire home/apt,185,0,0.08,185
4292,Janelle,1,Entire home/apt,650,283,1.76,933
4293,Patrick,2,Private room,100,0,0.18,100
4294,Chad,1,Private room,111,317,1.65,428
4295,Ofer,1,Entire home/apt,99,139,0.19,238
4296,Louie,2,Private room,75,87,0.31,162
4297,AFI Apartments,1,Entire home/apt,103,336,0.06,439
4298,Ilda,3,Entire home/apt,130,0,1.55,130
4299,Ofer,1,Entire home/apt,109,90,0.34,199
4301,Ting,2,Entire home/apt,100,0,0.05,100
4302,Glenn,2,Entire home/apt,155,59,0.08,214
4303,Caitlin,3,Private room,60,118,2.64,178
4304,Mark,2,Entire home/apt,195,13,0.18,208
4305,Alwin,3,Entire home/apt,69,30,1.25,99
4306,Julio,1,Private room,72,311,1.05,383
4307,Cristina,2,Entire home/apt,300,224,0.24,524
4308,AFI Apartments,1,Entire home/apt,119,339,0.13,458
4309,Sine,2,Private room,100,296,0.09,396
4310,Jessica,2,Private room,199,363,1.14,562
4311,Teresa,1,Private room,75,126,0.33,201
4312,Kells,2,Private room,100,96,1.22,196
4313,Allison,1,Entire home/apt,125,0,1.0,125
4314,Christian,3,Entire home/apt,95,0,0.4,95
4315,Triny,2,Entire home/apt,295,151,1.74,446
4316,Hugh,3,Private room,149,365,0.17,514
4317,Patricia,1,Entire home/apt,150,0,0.1,150
4318,Shanti,2,Entire home/apt,100,214,2.87,314
4320,Sara,1,Entire home/apt,385,180,0.75,565
4321,Jerry,2,Entire home/apt,87,233,3.31,320
4322,Paulo,1,Entire home/apt,180,184,0.1,364
4323,Ruth,3,Private room,59,185,0.78,244
4324,Rob&Elle,5,Private room,95,264,3.74,359
4325,Inga,1,Entire home/apt,130,161,0.05,291
4326,Alexandra,2,Entire home/apt,120,254,2.2,374
4327,Tracy & Matt,1,Private room,113,41,4.05,154
4328,Angelo,3,Private room,60,309,2.14,369
4329,Anna,2,Private room,40,221,0.5,261
4330,Nesrine,1,Entire home/apt,250,0,0.03,250
4333,Derek,2,Entire home/apt,149,0,0.04,149
4334,Bradley,2,Entire home/apt,169,0,0.54,169
4335,Kieran,2,Private room,105,93,1.4,198
4336,Jeffrey,2,Private room,42,0,0.1,42
4338,Raymond,1,Entire home/apt,200,0,0.14,200
4339,Claire,2,Entire home/apt,160,279,0.74,439
4340,Dave,2,Private room,155,0,0.67,155
4341,Velma,2,Entire home/apt,151,308,0.54,459
4342,Merrill,1,Entire home/apt,200,0,0.02,200
4343,Sophia,2,Private room,80,0,0.14,80
4344,Michael,3,Entire home/apt,119,0,0.05,119
4345,Bianca,2,Private room,5000,363,0.16,5363
4346,Al,2,Private room,45,99,1.58,144
4347,Robert And Zafir,2,Entire home/apt,115,0,0.08,115
4348,Rosa,2,Private room,65,269,1.06,334
4349,Winona,1,Private room,87,89,0.63,176
4350,Maria,1,Private room,110,21,0.14,131
4351,Jon,2,Private room,80,0,1.13,80
4353,Jess,2,Private room,63,290,1.34,353
4354,Seryn,2,Entire home/apt,200,78,0.78,278
4355,Meg,2,Entire home/apt,185,0,0.16,185
4356,James,1,Entire home/apt,250,9,1.83,259
4357,Satya,1,Entire home/apt,130,187,0.94,317
4358,Gillian,2,Entire home/apt,185,254,1.18,439
4359,Lily,2,Private room,75,0,0.08,75
4360,Jane,1,Entire home/apt,240,52,3.67,292
4361,Nicole,2,Private room,65,0,0.08,65
4362,Joseph,1,Entire home/apt,195,0,0.51,195
4363,Ray,1,Entire home/apt,200,0,0.74,200
4364,Kaytlin,1,Private room,120,283,4.07,403
4365,Molly,2,Entire home/apt,180,197,2.9,377
4366,Yolanda,3,Private room,53,189,1.44,242
4367,Carlo,1,Entire home/apt,200,0,0.16,200
4368,Michael,1,Private room,100,0,2.26,100
4369,Tamoi,2,Entire home/apt,86,0,1.07,86
4370,Zuben,1,Entire home/apt,225,0,0.1,225
4371,Yolanda,3,Private room,40,291,2.21,331
4372,Sanjna,1,Entire home/apt,60,291,0.15,351
4373,Astoria,3,Private room,70,220,0.21,290
4374,Petya,3,Private room,35,364,1.0,399
4375,Marjorie,1,Entire home/apt,250,284,2.17,534
4376,Jessica,2,Entire home/apt,4500,365,0.09,4865
4377,Jessica,2,Entire home/apt,8000,365,0.03,8365
4379,Anna,3,Entire home/apt,255,297,0.97,552
4380,Bah.,1,Entire home/apt,290,252,1.25,542
4382,Ellie,1,Entire home/apt,115,4,0.3,119
4383,Jeffrey,2,Entire home/apt,299,346,0.56,645
4384,Quyen,1,Entire home/apt,160,0,0.55,160
4385,Kevin,1,Shared room,175,0,0.02,175
4386,Claude,1,Private room,120,174,5.81,294
4387,Jessica,2,Private room,179,365,0.13,544
4388,Mariano,2,Private room,74,25,1.71,99
4389,Brent,1,Private room,68,237,2.42,305
4390,Allie,1,Private room,235,135,0.68,370
4391,Mads,2,Private room,100,0,0.07,100
4392,Karen,2,Entire home/apt,270,0,0.22,270
4393,Lily,2,Entire home/apt,200,0,0.04,200
4395,Hannah,2,Private room,60,83,0.04,143
4396,Frederico,1,Entire home/apt,155,341,0.7,496
4397,Alesandra,1,Private room,95,288,4.5,383
4398,Nico,1,Entire home/apt,125,0,0.27,125
4399,AFI Apartments,1,Entire home/apt,118,308,0.03,426
4400,Grace Brigitte,1,Private room,80,278,1.56,358
4401,Patricia,2,Entire home/apt,210,0,0.11,210
4402,Chris,2,Entire home/apt,150,0,0.16,150
4403,Karen And Ben,2,Entire home/apt,135,296,2.19,431
4404,AFI Apartments,1,Entire home/apt,118,326,0.06,444
4405,Lane,1,Private room,110,113,1.48,223
4406,Danie,2,Private room,70,0,0.17,70
4407,Sergey & Kate,2,Private room,43,220,2.77,263
4408,David,2,Entire home/apt,140,294,3.26,434
4409,AFI Apartments,1,Entire home/apt,116,335,0.02,451
4410,Vida,2,Entire home/apt,159,317,0.12,476
4411,Josandra,2,Entire home/apt,135,187,4.84,322
4412,Gen,1,Private room,39,310,0.36,349
4413,Jade,2,Private room,59,54,0.28,113
4414,Aivars,1,Entire home/apt,600,0,0.03,600
4415,Ruby,2,Private room,66,41,0.11,107
4416,Mike,1,Entire home/apt,130,365,0.03,495
4417,Christy,2,Entire home/apt,100,237,4.57,337
4418,Emma,2,Private room,50,125,0.94,175
4419,Alison,1,Private room,185,365,0.56,550
4420,Jessie,2,Private room,54,0,0.07,54
4421,Camille,2,Entire home/apt,100,202,0.11,302
4422,Selma,1,Entire home/apt,180,0,0.1,180
4423,Kendall,2,Entire home/apt,115,78,0.7,193
4424,Amir,2,Entire home/apt,350,21,0.19,371
4425,Sheki,2,Private room,32,319,0.07,351
4426,Neomi,2,Entire home/apt,165,297,0.38,462
4427,Nattie,1,Entire home/apt,350,0,0.19,350
4429,Enma,2,Entire home/apt,200,95,0.32,295
4430,Arnan & Zahira,2,Entire home/apt,175,107,0.1,282
4431,Dany,1,Private room,50,188,0.96,238
4432,Nicholas,1,Entire home/apt,190,0,0.18,190
4433,Genny,1,Private room,110,182,0.6,292
4434,Kellie,2,Entire home/apt,414,0,0.06,414
4436,Mike,1,Entire home/apt,150,365,0.03,515
4437,Michael,1,Entire home/apt,93,97,0.17,190
4439,Oswaldo,5,Entire home/apt,175,39,0.4,214
4440,Laura,2,Entire home/apt,155,364,0.05,519
4441,Vida,2,Entire home/apt,129,337,0.08,466
4442,Genae,4,Private room,50,188,0.36,238
4443,Jacques,2,Entire home/apt,499,31,0.03,530
4444,William,2,Shared room,80,90,0.15,170
4446,Miranda,3,Private room,47,0,0.28,47
4447,Juan Felipe,2,Private room,95,0,0.02,95
4448,Michelle,1,Entire home/apt,249,278,2.52,527
4449,Mike,1,Entire home/apt,150,362,0.04,512
4450,Harper,1,Private room,77,18,2.29,95
4452,Deedles,2,Private room,70,67,0.61,137
4453,Mike,1,Entire home/apt,100,311,0.11,411
4454,Mike,1,Entire home/apt,87,365,0.1,452
4455,Helen,2,Entire home/apt,245,0,0.05,245
4456,Brian,1,Entire home/apt,300,254,1.53,554
4457,Carlos,1,Private room,55,0,0.03,55
4458,Kerry,1,Entire home/apt,120,0,0.08,120
4459,Gen,1,Private room,40,130,0.15,170
4460,SoSo,1,Private room,115,332,0.29,447
4461,Michael,1,Entire home/apt,93,234,0.3,327
4462,David,1,Private room,37,0,0.02,37
4463,Marc,2,Entire home/apt,240,0,0.29,240
4465,Kara Ayn,3,Private room,70,32,2.33,102
4466,Vida,2,Entire home/apt,149,295,0.1,444
4467,Kells,2,Private room,100,14,0.17,114
4468,Jennifer,1,Entire home/apt,200,0,1.52,200
4469,Emilia,2,Entire home/apt,99,0,0.7,99
4470,Eran,1,Entire home/apt,220,2,0.08,222
4471,Courtney,1,Entire home/apt,250,0,0.06,250
4472,AFI Apartments,1,Entire home/apt,103,209,0.2,312
4473,AFI Apartments,1,Entire home/apt,108,188,0.14,296
4474,El Haj,1,Private room,75,325,0.1,400
4475,Darwin And Nicole,2,Entire home/apt,78,0,0.16,78
4476,Agustina,2,Private room,75,0,0.13,75
4477,Edmi,2,Entire home/apt,152,12,0.1,164
4478,Lisa,1,Entire home/apt,150,3,0.51,153
4479,Einar,1,Entire home/apt,320,269,2.7,589
4480,Benjamin,2,Entire home/apt,220,0,0.07,220
4481,Joycelyn,2,Entire home/apt,99,287,3.67,386
4482,Alex,1,Entire home/apt,950,34,0.69,984
4483,Lindsey,1,Entire home/apt,120,0,0.02,120
4484,Patrick,1,Entire home/apt,100,0,0.08,100
4485,Anneta,2,Entire home/apt,199,37,0.11,236
4486,Samira,1,Private room,100,20,4.2,120
4487,Mac,2,Private room,75,25,1.29,100
4488,Mike,1,Entire home/apt,84,365,0.12,449
4489,Rebecca,2,Entire home/apt,100,0,0.04,100
4490,Michelle,2,Private room,75,292,1.41,367
4491,Crystal & Clee,2,Private room,93,336,1.73,429
4492,Marcus,2,Entire home/apt,140,315,1.38,455
4493,Heather,2,Entire home/apt,200,5,0.63,205
4494,Kristen,2,Entire home/apt,200,157,0.03,357
4495,Cristina,2,Entire home/apt,200,0,0.6,200
4496,Tyler,3,Entire home/apt,100,0,0.02,100
4497,Sarah,1,Private room,100,138,1.47,238
4498,Susana,1,Entire home/apt,120,203,1.61,323
4499,Mark,2,Entire home/apt,109,0,0.08,109
4500,Etan,2,Private room,126,105,0.8,231
4501,Ayo,1,Private room,50,321,0.04,371
4502,Matt,1,Entire home/apt,325,0,0.12,325
4504,Mariam,2,Entire home/apt,135,0,0.07,135
4505,Marty,3,Entire home/apt,52,0,0.02,52
4506,Grant,1,Entire home/apt,124,38,0.21,162
4507,Mack,3,Private room,59,158,0.61,217
4508,Meredith,1,Entire home/apt,215,0,0.13,215
4509,Alex,1,Private room,240,93,0.13,333
4510,Nicholas,1,Private room,150,87,0.19,237
4511,Bernice,2,Private room,83,0,0.03,83
4513,Julia,1,Entire home/apt,160,0,0.1,160
4514,Michael,1,Shared room,200,180,0.13,380
4515,Jehan,2,Entire home/apt,50,0,0.07,50
4516,Mike,1,Entire home/apt,87,311,0.2,398
4518,Alon & Adi,1,Entire home/apt,250,7,0.36,257
4519,Zoe,2,Entire home/apt,162,282,3.47,444
4521,Hans,1,Private room,147,10,0.51,157
4522,Dean,2,Entire home/apt,149,254,3.7,403
4523,Monica,2,Entire home/apt,65,0,0.14,65
4524,Craig,2,Entire home/apt,250,0,0.21,250
4525,Gil,2,Private room,160,307,2.54,467
4526,Madeleine,1,Entire home/apt,150,0,0.16,150
4528,Natalie,2,Private room,64,282,0.77,346
4529,Victor,2,Private room,33,16,3.62,49
4530,Jack Andrew,1,Private room,500,363,0.05,863
4531,Sara,2,Entire home/apt,150,7,0.94,157
4532,Isabelle,1,Private room,110,0,0.03,110
4533,Tenisha & Marty,2,Entire home/apt,145,218,1.96,363
4535,Marc,2,Private room,95,0,0.17,95
4536,Rick,2,Entire home/apt,185,0,1.3,185
4537,Tenisha & Marty,2,Entire home/apt,500,365,0.71,865
4538,Samantha,1,Entire home/apt,115,0,0.03,115
4539,Lynn,5,Entire home/apt,195,204,1.73,399
4540,Victoria And Juliana,2,Entire home/apt,105,221,0.08,326
4541,Quinn,2,Entire home/apt,67,26,0.16,93
4542,Marc,2,Entire home/apt,75,0,0.02,75
4543,Zachary,1,Private room,100,0,0.08,100
4544,Anna,2,Entire home/apt,125,188,0.93,313
4545,Ellie,2,Entire home/apt,350,0,0.04,350
4546,Masha,2,Entire home/apt,150,0,0.33,150
4547,David,3,Entire home/apt,200,188,0.37,388
4548,Mark,2,Entire home/apt,270,12,0.16,282
4549,Teresa,2,Entire home/apt,184,0,0.37,184
4550,Natasha,2,Entire home/apt,275,34,0.32,309
4551,Nicholas,1,Entire home/apt,171,0,0.02,171
4553,Justin,1,Entire home/apt,200,0,0.07,200
4554,Benjamin,2,Entire home/apt,165,0,0.19,165
4555,Tanda,2,Private room,85,363,0.45,448
4556,Daphna,2,Entire home/apt,170,44,0.33,214
4557,Justin,2,Private room,70,142,1.13,212
4558,Erin & Becky,2,Private room,125,7,0.6,132
4559,S Anthony,1,Entire home/apt,275,323,1.02,598
4560,Sil,2,Private room,120,162,2.2,282
4562,David,2,Entire home/apt,225,0,0.11,225
4563,Vlado & Sandra,3,Entire home/apt,119,214,3.67,333
4564,Jeff,1,Entire home/apt,175,0,0.1,175
4565,Velma,2,Entire home/apt,155,363,0.71,518
4566,Matthew,1,Entire home/apt,100,0,0.02,100
4567,Jeffrey,1,Private room,70,209,0.26,279
4568,Carol,4,Entire home/apt,95,358,0.96,453
4569,Ryan,2,Entire home/apt,450,13,0.2,463
4570,Stanley,2,Entire home/apt,215,106,0.53,321
4571,Thomas,2,Private room,60,0,0.07,60
4572,Yan,4,Private room,75,300,0.67,375
4573,Glasshouse,2,Private room,99,11,0.36,110
4574,Birgitta,2,Entire home/apt,300,268,1.81,568
4575,Gina,1,Entire home/apt,175,339,2.39,514
4576,Albane,1,Entire home/apt,195,0,0.13,195
4577,Nathan,3,Private room,50,140,0.15,190
4578,Karlan,1,Entire home/apt,175,0,0.03,175
4579,Thomas & Gaby,2,Entire home/apt,120,56,2.86,176
4580,Anthony,2,Private room,54,0,0.19,54
4581,Larry,1,Entire home/apt,345,273,2.34,618
4582,Althea,2,Entire home/apt,225,275,1.24,500
4583,Chris,2,Entire home/apt,151,54,0.3,205
4584,Shae,2,Entire home/apt,110,179,3.06,289
4585,Karima,1,Entire home/apt,280,0,0.28,280
4586,Lisa,2,Private room,99,125,1.28,224
4587,Jennifer,2,Entire home/apt,350,0,0.14,350
4589,Michelle,1,Entire home/apt,120,197,3.47,317
4590,Jackie,1,Private room,89,177,3.72,266
4591,Folake,2,Private room,120,365,0.02,485
4592,Tal,1,Private room,85,80,2.3,165
4593,Caroline,1,Entire home/apt,220,0,1.93,220
4594,Anthony,1,Private room,125,309,0.29,434
4595,Petek,1,Entire home/apt,189,0,0.05,189
4597,Ingrid,1,Private room,81,0,0.19,81
4598,Heather,1,Shared room,45,15,2.22,60
4600,Cheryl,1,Private room,62,35,0.61,97
4601,Julie,2,Entire home/apt,330,351,1.98,681
4602,Maria,1,Private room,80,0,0.25,80
4603,Ford,1,Shared room,65,0,0.21,65
4604,Carl,1,Private room,125,43,0.05,168
4605,Samantha And Scott,2,Entire home/apt,165,264,3.1,429
4606,Pierre-Hubert,1,Private room,90,0,0.05,90
4607,Laurie,2,Entire home/apt,120,9,0.13,129
4609,Melissa,2,Entire home/apt,115,0,0.1,115
4610,Dov,2,Private room,55,249,0.79,304
4613,Shae,2,Entire home/apt,55,64,1.91,119
4614,Caroline,2,Entire home/apt,400,1,0.56,401
4615,Claudia,2,Entire home/apt,200,0,0.05,200
4616,May,2,Entire home/apt,111,0,3.08,111
4617,Jonathan,2,Entire home/apt,175,0,0.2,175
4618,Norva,1,Entire home/apt,150,0,0.54,150
4619,Lilia,1,Private room,52,17,0.28,69
4620,Brooke,2,Entire home/apt,88,101,0.09,189
4621,Melissa,2,Entire home/apt,425,321,0.08,746
4622,Yuval,1,Entire home/apt,175,0,0.05,175
4626,Ava,2,Private room,105,285,0.42,390
4627,Patti,2,Entire home/apt,265,0,0.18,265
4628,Andrea,1,Private room,60,188,0.25,248
4629,Kristiana,1,Private room,45,0,0.21,45
4630,Malik,1,Private room,89,0,0.92,89
4631,Chen,1,Entire home/apt,200,6,1.7,206
4632,Katy,2,Entire home/apt,149,0,0.28,149
4633,Soon,1,Private room,80,227,4.36,307
4634,Rebekah,2,Entire home/apt,125,122,3.05,247
4635,Aseel,1,Entire home/apt,78,0,0.22,78
4636,Anna,2,Private room,65,80,2.5,145
4637,Laurence,2,Entire home/apt,350,0,0.14,350
4639,Jon,1,Entire home/apt,289,0,0.02,289
4640,Benjamin,2,Entire home/apt,158,365,0.14,523
4641,Ali,1,Private room,50,0,0.11,50
4642,Lorna,1,Entire home/apt,234,0,0.08,234
4644,Eve,1,Private room,69,0,0.03,69
4645,Tara,1,Entire home/apt,135,0,0.35,135
4646,Goran,2,Private room,89,359,1.19,448
4647,Jeff,1,Entire home/apt,16,9,1.69,25
4648,Dee,2,Entire home/apt,300,254,0.52,554
4649,Ramon,1,Entire home/apt,250,234,0.83,484
4650,John,2,Entire home/apt,70,0,0.08,70
4651,Irena,1,Private room,140,316,1.91,456
4652,Kevin,1,Entire home/apt,175,0,0.3,175
4653,Kevin,2,Entire home/apt,160,0,0.03,160
4655,Linnea,2,Private room,57,0,0.18,57
4656,Rivani,1,Private room,90,53,1.58,143
4657,Karen,3,Private room,89,1,0.65,90
4658,Tania,2,Entire home/apt,90,13,0.37,103
4659,Matt,1,Entire home/apt,200,312,0.82,512
4660,Jon,2,Entire home/apt,100,30,1.08,130
4661,Suzy,2,Entire home/apt,68,334,0.41,402
4662,Daniel,1,Entire home/apt,170,0,0.23,170
4663,Sheki,2,Private room,40,318,0.22,358
4664,Francesca,1,Entire home/apt,500,341,0.18,841
4665,Cecile,2,Entire home/apt,145,0,0.22,145
4666,Stefano,2,Entire home/apt,250,6,0.27,256
4667,Katie,1,Entire home/apt,288,222,0.23,510
4668,Roy,2,Entire home/apt,245,0,0.3,245
4669,Laura,1,Entire home/apt,80,0,0.25,80
4670,Arun,2,Entire home/apt,125,0,0.08,125
4671,Celeste,1,Entire home/apt,166,48,0.3,214
4672,Christine,1,Entire home/apt,330,260,0.18,590
4673,Travis,2,Private room,60,0,0.16,60
4674,Hope,1,Private room,130,0,0.05,130
4675,Julie,2,Private room,45,0,0.07,45
4676,Michelle,1,Entire home/apt,165,75,2.71,240
4677,Taller,1,Private room,155,172,0.23,327
4678,Andrey,1,Entire home/apt,119,0,0.04,119
4679,Aaron,2,Entire home/apt,158,0,0.19,158
4680,Danny,2,Entire home/apt,169,91,0.83,260
4681,Mary & Josh,2,Entire home/apt,139,231,2.09,370
4682,Gautam,1,Entire home/apt,125,0,0.11,125
4683,Michelle,3,Private room,70,353,0.41,423
4684,Smidty,2,Private room,135,162,4.69,297
4685,Ofer,1,Entire home/apt,99,170,0.13,269
4688,Amanda,1,Entire home/apt,250,173,0.51,423
4690,Heather,2,Private room,100,10,0.08,110
4691,Faith,2,Entire home/apt,128,32,1.53,160
4692,Theresa,2,Entire home/apt,121,7,0.13,128
4693,Linda,2,Entire home/apt,160,228,0.63,388
4695,Robert,1,Entire home/apt,275,20,0.5,295
4696,Adam,1,Entire home/apt,180,0,0.07,180
4697,Carrie,1,Entire home/apt,189,203,2.86,392
4699,Louisa,2,Entire home/apt,99,235,2.46,334
4700,Anne,2,Entire home/apt,200,193,2.0,393
4701,Delphine And Michael,1,Entire home/apt,145,262,1.9,407
4702,Natasha,1,Private room,100,219,1.05,319
4703,Tara,1,Entire home/apt,240,0,0.37,240
4704,Amber,2,Private room,90,0,0.85,90
4705,Simone,2,Entire home/apt,220,306,0.91,526
4706,Pam,2,Private room,100,240,1.01,340
4707,Christopher,3,Private room,59,359,2.34,418
4708,Lamee,2,Entire home/apt,78,188,1.33,266
4709,Desmar,4,Entire home/apt,75,253,1.41,328
4710,Jessica,2,Private room,78,362,1.43,440
4711,Morgan,1,Entire home/apt,250,0,0.07,250
4713,Asher,1,Private room,44,0,0.05,44
4714,Aaron,2,Private room,69,125,0.47,194
4716,Lihi,2,Entire home/apt,90,0,0.07,90
4717,Carolina,2,Entire home/apt,125,0,0.17,125
4718,Kitt,2,Entire home/apt,78,0,0.2,78
4719,Dave,1,Entire home/apt,785,331,1.52,1116
4720,Dorina,3,Entire home/apt,99,299,2.65,398
4721,Cris,3,Private room,74,76,0.16,150
4722,Fate,1,Entire home/apt,130,0,0.06,130
4723,Shawn & Christine,3,Entire home/apt,105,70,3.54,175
4724,Natalie,1,Entire home/apt,145,0,0.1,145
4725,Fernando,1,Private room,90,40,2.67,130
4726,Alicia And Jamie,2,Entire home/apt,215,0,0.23,215
4727,Jeremy,1,Entire home/apt,100,0,0.03,100
4728,Louis,2,Entire home/apt,92,281,3.14,373
4729,Mark,1,Entire home/apt,185,2,0.08,187
4731,Whitney,1,Entire home/apt,160,1,0.18,161
4732,Michael,1,Entire home/apt,93,329,0.26,422
4733,Host,1,Entire home/apt,300,291,0.24,591
4734,Nikki,2,Private room,75,0,0.05,75
4735,Spencer,1,Entire home/apt,370,365,0.13,735
4736,Nicole,1,Entire home/apt,425,0,0.07,425
4737,Richard,2,Entire home/apt,200,282,0.18,482
4738,Alejandro,1,Private room,125,348,0.89,473
4739,Robert,1,Entire home/apt,179,0,0.03,179
4740,Karen,2,Private room,46,346,1.24,392
4741,Susanna,2,Entire home/apt,150,86,0.76,236
4742,Rez,2,Private room,52,0,0.6,52
4743,Lauren,1,Private room,80,351,0.67,431
4744,Tara,2,Entire home/apt,120,0,0.08,120
4745,Olga,2,Entire home/apt,300,363,0.13,663
4746,Katherine,2,Private room,110,189,0.02,299
4747,Johanna,2,Entire home/apt,200,0,0.07,200
4748,Maria,2,Entire home/apt,75,0,0.16,75
4749,Caleb,1,Entire home/apt,200,25,0.84,225
4750,Cayla,1,Entire home/apt,300,0,0.19,300
4751,Berhani,1,Private room,22,0,0.05,22
4752,Vida,2,Entire home/apt,129,157,0.27,286
4753,Debris,1,Entire home/apt,125,0,0.07,125
4755,Tanya,1,Entire home/apt,185,31,0.3,216
4756,Aleksandra,2,Entire home/apt,158,0,0.28,158
4758,Kathrine,2,Entire home/apt,316,6,0.49,322
4759,Michael,2,Entire home/apt,175,0,2.88,175
4760,Michael,3,Entire home/apt,97,0,0.65,97
4761,Paul,1,Entire home/apt,175,347,0.02,522
4763,Catherine,2,Private room,72,83,0.1,155
4764,Peter,2,Entire home/apt,175,0,1.41,175
4766,Paul,2,Entire home/apt,85,0,0.04,85
4767,Ben,1,Entire home/apt,150,188,1.0,338
4768,Hannah,2,Entire home/apt,225,179,4.21,404
4769,Julia,1,Private room,400,0,0.09,400
4770,Anna,2,Private room,125,0,0.3,125
4771,Julia,2,Entire home/apt,200,260,2.64,460
4775,Suzy,3,Entire home/apt,89,222,0.18,311
4776,David,1,Entire home/apt,165,0,0.41,165
4778,Paulina,2,Entire home/apt,285,110,1.47,395
4779,Hannah,2,Entire home/apt,150,0,0.44,150
4780,Arika,2,Private room,70,68,0.16,138
4781,Mor,1,Entire home/apt,300,365,0.05,665
4782,Reno,2,Entire home/apt,220,186,0.13,406
4784,Nadine,1,Entire home/apt,249,0,0.1,249
4786,Ivan,1,Private room,69,270,0.29,339
4787,Nicky,2,Entire home/apt,120,3,1.3,123
4788,Mario,1,Private room,69,271,1.05,340
4789,Ivan,1,Private room,54,187,0.34,241
4790,Ivan,1,Private room,50,177,0.39,227
4791,Ivan,1,Private room,51,258,0.33,309
4792,Thomas,1,Private room,99,0,0.58,99
4793,Nick,1,Entire home/apt,290,0,0.03,290
4795,Pat,4,Private room,49,240,1.87,289
4796,Michael,2,Entire home/apt,115,0,0.1,115
4797,Ayodele,2,Private room,78,0,0.99,78
4798,Janice,2,Entire home/apt,125,270,0.41,395
4799,Amy,1,Entire home/apt,135,13,3.69,148
4801,Brendon,1,Entire home/apt,205,0,0.16,205
4802,Judette,1,Entire home/apt,95,245,0.61,340
4803,Kip,2,Private room,55,15,3.7,70
4804,Carl,2,Private room,47,310,1.99,357
4805,Mordechai,1,Private room,39,12,0.82,51
4806,Craig,1,Entire home/apt,349,358,0.45,707
4807,Sabine,2,Entire home/apt,250,170,0.12,420
4808,Dee,1,Entire home/apt,290,41,1.53,331
4809,Allie,2,Private room,85,21,1.51,106
4810,Liz,2,Entire home/apt,170,0,0.02,170
4811,Stina,1,Entire home/apt,146,0,0.82,146
4812,Griffin,3,Entire home/apt,99,0,0.12,99
4813,Marta,2,Entire home/apt,150,18,0.42,168
4814,Blake,2,Entire home/apt,240,77,1.46,317
4815,Randall,2,Entire home/apt,500,365,0.8,865
4816,Steve,3,Private room,48,113,0.92,161
4817,Abigail,2,Entire home/apt,129,0,0.36,129
4818,Han,1,Entire home/apt,750,365,0.27,1115
4819,Lana,1,Entire home/apt,180,87,0.15,267
4820,FLora,3,Private room,70,342,0.09,412
4822,Laura,2,Entire home/apt,240,0,0.05,240
4823,Laura,2,Entire home/apt,100,0,0.17,100
4824,Gabi,1,Entire home/apt,122,339,0.12,461
4825,Geoffrey,1,Entire home/apt,400,0,0.36,400
4826,Pat,4,Private room,47,172,1.27,219
4827,Laura,2,Entire home/apt,140,4,0.2,144
4828,Anne,4,Private room,55,16,3.95,71
4829,Konstantino,2,Entire home/apt,110,0,0.05,110
4830,Lionel,2,Entire home/apt,175,365,0.02,540
4831,Arjun,1,Entire home/apt,80,0,0.18,80
4832,Sharon,1,Entire home/apt,150,0,0.07,150
4833,Kira,1,Entire home/apt,200,0,0.07,200
4834,Ana,2,Private room,50,0,0.03,50
4835,Jay,1,Private room,99,82,0.47,181
4836,Sarah,1,Private room,60,0,0.18,60
4837,Casey,1,Entire home/apt,225,49,2.73,274
4838,Elizabeth,1,Entire home/apt,175,0,0.08,175
4839,Daniel,2,Private room,60,313,0.26,373
4840,Julie,1,Entire home/apt,255,341,0.02,596
4841,Gaspard,2,Private room,75,0,0.07,75
4842,Jean-Cosme,2,Entire home/apt,190,0,0.03,190
4843,G,2,Entire home/apt,495,198,0.27,693
4844,Sasha,2,Entire home/apt,98,188,0.18,286
4847,Emilie,1,Entire home/apt,215,47,1.8,262
4848,David Jerome,2,Entire home/apt,200,0,0.12,200
4849,Amy,2,Entire home/apt,100,0,0.98,100
4852,Alexia,1,Entire home/apt,110,0,0.02,110
4853,Natasha,1,Entire home/apt,115,211,1.05,326
4854,Jonathon,1,Private room,75,0,0.05,75
4855,Richard,1,Entire home/apt,289,0,0.12,289
4856,Evgenia,1,Private room,95,263,3.31,358
4857,Jenny,1,Entire home/apt,197,8,4.83,205
4860,Mary,2,Entire home/apt,375,252,0.1,627
4861,"Lisa, Nancy & John",5,Private room,56,258,2.38,314
4862,Pablo,1,Entire home/apt,225,266,0.45,491
4863,C,1,Entire home/apt,70,0,0.02,70
4864,Mat,1,Entire home/apt,264,281,0.1,545
4865,Mat,1,Entire home/apt,199,365,0.19,564
4866,G,2,Entire home/apt,149,28,0.33,177
4867,Tom,2,Entire home/apt,142,306,2.8,448
4868,Tae,1,Entire home/apt,299,324,0.97,623
4869,Nicholas,2,Entire home/apt,50,0,0.25,50
4870,Asa,2,Entire home/apt,160,269,8.14,429
4871,Ala,2,Entire home/apt,127,2,2.34,129
4872,Michelle,2,Entire home/apt,110,0,0.85,110
4873,John,1,Private room,69,5,0.6,74
4874,Lionel,2,Entire home/apt,175,365,0.07,540
4875,Brian,1,Entire home/apt,179,0,1.18,179
4876,Taylor,2,Entire home/apt,144,85,0.84,229
4878,Parnell,1,Entire home/apt,150,0,0.02,150
4879,Tony,2,Entire home/apt,109,127,4.58,236
4881,Aleksandar,2,Entire home/apt,75,0,0.08,75
4882,William,1,Entire home/apt,135,0,0.05,135
4884,Petya,3,Private room,38,358,0.14,396
4885,Assiati,2,Entire home/apt,195,251,3.82,446
4886,Tom,1,Entire home/apt,146,223,1.52,369
4887,Paul,2,Entire home/apt,318,268,0.32,586
4889,Enrico,2,Entire home/apt,140,283,2.52,423
4890,Alex And Zeena,1,Private room,85,342,3.48,427
4891,Meghan,1,Entire home/apt,170,0,0.02,170
4892,Edvaldo,3,Private room,100,365,0.03,465
4893,Eddie,1,Entire home/apt,350,196,0.13,546
4894,Izzy,1,Entire home/apt,199,0,0.42,199
4895,Ligeia,2,Private room,77,188,0.29,265
4896,Nathan,1,Private room,80,0,0.03,80
4897,Richard,4,Private room,79,0,0.19,79
4898,Nicole,2,Private room,550,358,0.1,908
4899,Maria,2,Entire home/apt,155,17,0.12,172
4900,Brooks,1,Entire home/apt,275,358,0.2,633
4901,Benjamin,2,Entire home/apt,119,0,0.18,119
4902,Adi,2,Entire home/apt,85,0,0.09,85
4904,Gabrielle,1,Private room,90,58,2.15,148
4905,Amy,2,Entire home/apt,135,191,0.9,326
4906,Megan,2,Private room,90,125,3.79,215
4907,Michael,2,Entire home/apt,150,0,0.08,150
4908,Shelley,2,Private room,38,253,1.3,291
4909,Mike,1,Entire home/apt,87,343,0.07,430
4910,Carrie,2,Entire home/apt,210,0,0.05,210
4911,Marissa,1,Private room,80,6,0.83,86
4912,Rhonda,2,Entire home/apt,250,323,0.39,573
4913,Ashley,1,Entire home/apt,175,0,0.31,175
4914,Brad,2,Private room,65,82,0.87,147
4915,Allie,1,Entire home/apt,140,0,0.81,140
4916,Christopher,1,Entire home/apt,129,64,0.28,193
4917,Jonathan,1,Entire home/apt,159,87,0.75,246
4919,Sean,1,Entire home/apt,249,332,0.74,581
4920,Velma,2,Entire home/apt,151,333,0.91,484
4921,Zaineb,2,Private room,79,308,1.19,387
4922,Fabi,2,Entire home/apt,125,0,0.22,125
4923,Kev,1,Entire home/apt,135,257,1.28,392
4924,Edward,1,Entire home/apt,151,46,0.1,197
4925,Josie,1,Entire home/apt,600,282,1.23,882
4926,Maximus,2,Entire home/apt,59,318,2.63,377
4927,Michael,1,Entire home/apt,273,91,1.41,364
4928,Andrew,1,Private room,70,80,0.82,150
4929,Gideon & Chantal,1,Private room,95,0,0.03,95
4930,Brendan,2,Entire home/apt,399,269,0.96,668
4931,Rylan,2,Private room,96,355,5.57,451
4932,Ricardo,1,Shared room,110,362,0.81,472
4934,Anthony,1,Private room,69,132,4.12,201
4935,Sigi,2,Private room,85,264,1.56,349
4936,Aurea,1,Entire home/apt,150,0,2.02,150
4937,Nevena,1,Entire home/apt,170,0,0.15,170
4938,Tommy,1,Entire home/apt,125,0,0.2,125
4939,Kent,1,Private room,130,0,3.17,130
4940,Allison,1,Entire home/apt,145,3,5.96,148
4941,Jack,2,Entire home/apt,500,282,2.34,782
4942,Brendan,1,Private room,95,0,2.78,95
4943,Cathleen,2,Entire home/apt,150,0,0.15,150
4945,Jillian,2,Private room,56,0,3.04,56
4946,Abby,2,Private room,60,0,0.02,60
4947,Esther,2,Entire home/apt,85,310,0.62,395
4948,Irene,1,Private room,80,0,0.05,80
4949,Kim,1,Private room,100,0,0.26,100
4950,Rony,2,Private room,54,0,0.05,54
4951,Fanny,2,Entire home/apt,113,191,0.63,304
4952,John,2,Entire home/apt,200,303,2.93,503
4953,Robert,1,Private room,75,0,0.1,75
4954,Kayvon,1,Shared room,200,365,0.53,565
4955,Ilona,2,Entire home/apt,110,220,0.07,330
4956,Shell,2,Entire home/apt,500,365,0.36,865
4958,Thomas,2,Entire home/apt,200,336,0.24,536
4959,Alberto,1,Private room,69,90,0.16,159
4960,Arianna,1,Entire home/apt,200,329,1.09,529
4961,Sigi,2,Entire home/apt,140,14,0.15,154
4962,Sue,2,Private room,45,281,0.64,326
4966,Michael,1,Entire home/apt,70,308,0.12,378
4967,Earle,1,Private room,200,304,1.06,504
4968,Deidre,1,Entire home/apt,308,0,0.15,308
4969,Gerald,1,Entire home/apt,270,0,0.21,270
4971,Theresa,1,Entire home/apt,365,28,1.02,393
4972,Brian & Arlette,2,Private room,99,248,1.39,347
4973,Oisin,1,Entire home/apt,175,255,0.27,430
4974,Fara,1,Entire home/apt,220,4,1.01,224
4975,Candy,1,Private room,80,314,0.05,394
4976,Valerie,2,Entire home/apt,230,0,0.15,230
4977,Telora,1,Private room,60,183,0.19,243
4978,Naz,1,Private room,120,0,0.03,120
4979,Tyler,2,Private room,45,31,0.81,76
4980,Francesco,1,Entire home/apt,100,12,0.83,112
4982,Domenick,2,Entire home/apt,100,0,1.11,100
4983,Crystal & John,1,Entire home/apt,230,0,0.49,230
4984,Sebastien,1,Entire home/apt,225,0,0.09,225
4985,Smith O'Brien,2,Entire home/apt,120,156,1.0,276
4986,Ken,2,Private room,99,365,0.17,464
4988,Erin,2,Entire home/apt,122,235,2.64,357
4989,Leslie,2,Entire home/apt,150,0,0.03,150
4990,Michael,1,Entire home/apt,140,186,4.95,326
4991,Elisa,1,Entire home/apt,150,0,0.3,150
4992,Chadanut,2,Private room,38,309,1.28,347
4993,Patrick,1,Entire home/apt,200,50,1.09,250
4994,Lanny,2,Private room,50,0,0.31,50
4995,Lilia,1,Private room,45,346,0.23,391
4996,Eric,2,Private room,90,0,0.02,90
4997,Sonya,3,Private room,85,0,0.04,85
4999,Adriana,3,Entire home/apt,108,328,1.35,436
5000,Olivia,2,Entire home/apt,129,204,0.25,333
5001,Annie And Joan,2,Entire home/apt,275,290,2.99,565
5002,Raanan,1,Entire home/apt,148,329,0.15,477
5004,Morgan,1,Entire home/apt,160,0,0.08,160
5005,Louis,2,Entire home/apt,130,309,2.48,439
5006,Richard,2,Private room,180,60,3.2,240
5007,Carli,1,Private room,50,0,0.23,50
5008,Sara,1,Private room,145,257,1.17,402
5009,Dave,1,Private room,94,0,0.28,94
5010,Danielle,1,Entire home/apt,180,0,0.41,180
5011,Masaki,1,Private room,80,0,0.07,80
5012,Rachel,2,Entire home/apt,97,0,0.25,97
5013,Maria,2,Entire home/apt,90,179,0.86,269
5014,Justa,2,Entire home/apt,70,1,0.94,71
5015,Jason,3,Entire home/apt,120,0,0.55,120
5016,Tomer,1,Entire home/apt,120,261,1.95,381
5018,Pedro Pablo,1,Private room,59,109,0.44,168
5019,Timothy,2,Private room,91,90,0.65,181
5020,Irma,3,Entire home/apt,184,143,2.46,327
5021,Joseph,2,Private room,45,0,0.26,45
5022,Marshall,1,Private room,150,344,2.44,494
5023,David,1,Entire home/apt,139,0,0.49,139
5024,Esther,1,Private room,65,290,0.92,355
5025,Darren,1,Private room,65,157,0.28,222
5026,Anna,2,Private room,150,0,0.26,150
5027,Eddie,3,Entire home/apt,115,0,0.08,115
5028,Justin,1,Entire home/apt,299,0,0.19,299
5029,Deanna,2,Entire home/apt,80,0,1.7,80
5030,Elma,2,Private room,80,364,1.5,444
5032,Alain,1,Private room,135,0,0.27,135
5033,Andy,2,Private room,80,227,2.07,307
5034,Sean,2,Private room,69,0,0.09,69
5035,Veronique Camille,1,Private room,75,352,0.04,427
5036,Allegra,2,Entire home/apt,94,0,0.52,94
5037,Valeria,2,Entire home/apt,192,8,0.14,200
5038,Veronique Camille,1,Private room,50,350,0.3,400
5039,Veronique Camille,1,Private room,58,331,0.04,389
5040,Jeanny,3,Entire home/apt,120,346,0.42,466
5041,Matthew,2,Private room,69,0,0.18,69
5042,Samita,3,Private room,50,0,0.03,50
5043,Neal,1,Entire home/apt,125,0,0.13,125
5044,Ota,2,Private room,50,88,0.23,138
5045,Joaquin,2,Private room,85,299,0.81,384
5046,Christopher,3,Private room,59,352,2.87,411
5047,AFI Apartments,1,Entire home/apt,130,308,0.08,438
5048,Karen,1,Entire home/apt,104,80,0.19,184
5049,Pao,3,Entire home/apt,95,332,0.16,427
5050,Veronique Camille,1,Entire home/apt,199,43,0.68,242
5051,Julio,4,Private room,105,365,0.14,470
5052,Lord Daniel,2,Private room,34,92,1.35,126
5053,Tina,2,Entire home/apt,120,0,0.22,120
5054,Aldo,4,Entire home/apt,87,0,0.28,87
5055,Louann,3,Entire home/apt,125,158,0.5,283
5056,Andrew,2,Entire home/apt,170,0,0.69,170
5057,Grace,1,Entire home/apt,250,0,0.06,250
5058,Dan,1,Private room,55,0,0.05,55
5059,Beatriz,3,Private room,80,253,0.97,333
5060,Pao,3,Entire home/apt,95,332,0.28,427
5061,Patricia,1,Private room,150,273,1.27,423
5062,Dexter,2,Entire home/apt,140,192,0.6,332
5063,Kini,2,Entire home/apt,150,242,1.96,392
5064,Yana,1,Entire home/apt,159,0,0.02,159
5065,Michael,1,Entire home/apt,95,245,0.23,340
5066,Vida,2,Entire home/apt,159,365,0.08,524
5067,Melissa,2,Private room,65,0,0.3,65
5068,Karina,2,Entire home/apt,100,0,2.52,100
5069,Andra,1,Private room,85,0,0.2,85
5070,Shawna,2,Entire home/apt,175,2,0.43,177
5071,Brett,2,Entire home/apt,175,0,0.07,175
5072,Olga,2,Entire home/apt,260,363,0.05,623
5073,Katya,2,Entire home/apt,80,19,0.4,99
5074,Seun And Marie,2,Private room,69,66,0.95,135
5075,Isaiah,2,Entire home/apt,100,89,0.6,189
5076,Danica,3,Private room,85,84,0.51,169
5077,Anna,2,Entire home/apt,95,0,0.03,95
5078,Host,1,Entire home/apt,160,333,0.25,493
5079,Josh,2,Private room,49,0,0.1,49
5080,Jillian,2,Private room,65,0,0.88,65
5081,Host,1,Entire home/apt,150,331,0.03,481
5082,Mike,1,Entire home/apt,115,342,0.06,457
5083,Haya,3,Private room,113,365,0.74,478
5084,Mike,1,Entire home/apt,110,323,0.18,433
5085,Susan,1,Private room,75,0,0.23,75
5086,Francesco,1,Entire home/apt,250,0,0.04,250
5087,Sharon,4,Private room,50,0,0.55,50
5088,Frank,2,Entire home/apt,81,318,1.67,399
5089,Marco,1,Private room,69,129,2.88,198
5090,Maggie,2,Private room,125,0,0.03,125
5091,Caitlin,2,Private room,65,0,0.03,65
5093,Jeremy & Laura,1,Entire home/apt,175,281,0.06,456
5094,Maia,2,Private room,49,362,0.54,411
5095,Brooke,1,Entire home/apt,191,55,0.88,246
5097,Ryan,1,Entire home/apt,250,0,0.11,250
5098,Adam,2,Entire home/apt,216,295,3.89,511
5100,Qian,2,Private room,119,0,0.72,119
5101,AFI Apartments,1,Entire home/apt,118,341,0.08,459
5102,Alicia,1,Private room,95,355,1.65,450
5103,Tim,2,Entire home/apt,110,12,0.57,122
5104,Robert,2,Entire home/apt,170,302,2.55,472
5105,Amanda,1,Entire home/apt,99,0,0.15,99
5106,Benjamin,2,Entire home/apt,172,342,0.16,514
5107,Victoria,3,Private room,75,0,0.06,75
5108,Normandy,2,Private room,50,0,0.79,50
5109,Drew & Kristen,2,Private room,77,365,2.42,442
5110,Douglas,2,Entire home/apt,125,32,0.41,157
5111,Pamela,3,Private room,75,348,1.89,423
5112,Joshua,1,Entire home/apt,350,0,0.35,350
5113,Sue,2,Private room,55,261,0.46,316
5114,Linda Green And Norga,2,Entire home/apt,99,321,3.61,420
5115,G,2,Entire home/apt,545,227,0.12,772
5116,Carrie,1,Private room,70,244,4.67,314
5118,Suzanne,2,Entire home/apt,150,0,0.03,150
5119,Natsuko,2,Private room,55,19,0.41,74
5120,Amanda,2,Entire home/apt,100,0,0.87,100
5121,Nicole,2,Entire home/apt,100,0,0.12,100
5122,Nick,2,Entire home/apt,95,226,2.18,321
5124,Luci,1,Entire home/apt,200,2,0.45,202
5125,Alex,1,Entire home/apt,190,0,0.33,190
5126,Emily,2,Private room,65,0,0.06,65
5127,Andriana,2,Entire home/apt,400,300,2.05,700
5128,Julienne,2,Entire home/apt,95,0,0.21,95
5129,Gary,1,Entire home/apt,197,166,3.46,363
5130,Alexandra,2,Entire home/apt,395,9,0.34,404
5131,Arleta,2,Private room,100,365,0.04,465
5132,Ian & Sady,2,Entire home/apt,200,0,0.1,200
5133,Catherine,2,Entire home/apt,165,0,0.1,165
5134,Corey,2,Entire home/apt,145,0,0.07,145
5135,Kevin,2,Entire home/apt,75,174,2.27,249
5136,Jed,1,Entire home/apt,180,25,1.22,205
5137,Jime,1,Private room,73,153,0.8,226
5138,Jime,1,Private room,87,132,1.01,219
5139,Jime,1,Private room,74,169,1.0,243
5140,Rose,2,Private room,65,0,0.12,65
5141,Dawnie,1,Entire home/apt,199,37,1.06,236
5142,Barbara,2,Private room,65,0,0.03,65
5143,Alexandra,1,Entire home/apt,160,0,0.09,160
5144,Rob,2,Private room,175,0,0.1,175
5146,Host,1,Entire home/apt,195,331,0.14,526
5147,Terry,2,Private room,99,365,0.7,464
5148,Ellen,2,Entire home/apt,175,171,2.03,346
5150,Alix,2,Entire home/apt,99,66,0.28,165
5151,Nathalie,1,Private room,100,0,0.16,100
5152,Abigail,2,Entire home/apt,199,0,0.3,199
5153,Mitch,2,Entire home/apt,199,23,2.12,222
5154,Steven,3,Entire home/apt,100,319,1.21,419
5155,Alia,3,Shared room,45,38,1.6,83
5156,Saint,1,Private room,72,219,3.41,291
5157,Walt,1,Entire home/apt,129,179,2.99,308
5158,"Erin, Avi, Kaleb & Shiloh",2,Entire home/apt,100,317,2.81,417
5159,Natalie,2,Entire home/apt,85,0,0.03,85
5160,Jason,2,Private room,70,0,0.03,70
5161,Amanda Reil,2,Entire home/apt,100,0,0.09,100
5162,Emily,2,Entire home/apt,160,0,0.02,160
5163,John,1,Entire home/apt,185,365,0.02,550
5164,Jennifer,2,Entire home/apt,162,0,0.23,162
5165,Claudiu,3,Private room,80,0,0.03,80
5167,Amanda,2,Private room,45,247,0.31,292
5168,Vida,2,Entire home/apt,129,188,0.12,317
5169,Mohini,2,Private room,55,0,0.02,55
5170,Carly,2,Private room,68,14,0.26,82
5171,Elliot,2,Entire home/apt,120,0,0.02,120
5172,Juliana,2,Private room,55,0,1.09,55
5174,Jaime,2,Private room,50,0,0.03,50
5175,Chaim,2,Entire home/apt,150,0,0.12,150
5176,John,2,Entire home/apt,140,252,0.38,392
5177,Nina,1,Entire home/apt,136,220,0.17,356
5179,Samuel,1,Private room,125,9,2.25,134
5181,Jime,1,Private room,82,138,0.94,220
5182,Nataly,1,Entire home/apt,150,0,0.05,150
5183,Gemma,2,Entire home/apt,90,0,0.42,90
5184,Melissa,2,Entire home/apt,117,6,1.77,123
5185,Jime,1,Private room,71,156,1.03,227
5186,Andrew,1,Entire home/apt,390,9,0.17,399
5187,Meghan,5,Private room,58,279,2.1,337
5188,Nayoung,3,Private room,50,0,0.05,50
5189,Debbie,2,Entire home/apt,150,0,0.17,150
5190,Tessa,2,Private room,150,0,0.19,150
5191,Liz And Melissa,1,Private room,80,121,0.8,201
5192,Sofia,2,Private room,115,8,1.31,123
5194,Mike,1,Entire home/apt,95,336,0.22,431
5195,Ed,2,Private room,85,0,0.05,85
5196,Elito,2,Entire home/apt,180,291,1.31,471
5197,Elliot,1,Entire home/apt,149,0,0.17,149
5198,Jupira,1,Entire home/apt,200,0,0.34,200
5199,Lola,1,Private room,69,285,2.98,354
5200,Ms. Yvonne,1,Private room,85,198,0.44,283
5201,O.D.,2,Entire home/apt,117,280,1.39,397
5202,Nancy,1,Entire home/apt,219,122,1.15,341
5203,Sylvia,3,Entire home/apt,100,216,2.43,316
5204,Donna,2,Entire home/apt,320,242,0.71,562
5205,Anthony,1,Private room,95,335,0.91,430
5206,Julie,2,Private room,110,345,0.32,455
5207,Pierre,1,Entire home/apt,105,60,0.04,165
5208,Michael,2,Entire home/apt,134,32,0.89,166
5209,Neysa,2,Private room,45,90,0.26,135
5210,Tony,1,Entire home/apt,200,166,0.05,366
5211,Josh,1,Private room,110,80,1.33,190
5212,Tae,1,Entire home/apt,150,283,1.23,433
5213,Carmia And Joe,2,Entire home/apt,149,255,3.9,404
5214,Trish,1,Private room,85,329,0.91,414
5215,Carolina,2,Entire home/apt,200,0,0.09,200
5216,Ehsan,3,Entire home/apt,170,355,1.96,525
5217,Melody,4,Private room,40,343,1.0,383
5219,Yevgeny,1,Private room,95,254,6.51,349
5220,Edward,1,Private room,95,266,1.12,361
5221,Schatzie,1,Private room,350,0,0.2,350
5222,Ella,2,Entire home/apt,165,297,2.97,462
5223,Liz,2,Entire home/apt,120,13,0.51,133
5224,Julian,1,Private room,130,0,0.38,130
5225,Paris,2,Private room,40,335,0.16,375
5226,Anthony/Joanne,2,Entire home/apt,130,206,2.27,336
5227,Laurent,1,Entire home/apt,120,245,1.37,365
5228,Madeline,2,Entire home/apt,90,0,0.68,90
5229,Carlton,2,Private room,120,328,1.6,448
5230,Gina,1,Shared room,115,365,0.27,480
5231,Eilon,1,Entire home/apt,150,0,0.02,150
5232,Ali,1,Private room,170,364,0.4,534
5233,Andrew,2,Entire home/apt,124,238,1.45,362
5234,Ofer,1,Entire home/apt,104,101,0.28,205
5235,Ofer,1,Entire home/apt,99,135,0.24,234
5237,Benjamin,2,Entire home/apt,158,278,0.1,436
5240,Tim,2,Entire home/apt,115,0,0.03,115
5241,Anne,4,Private room,55,19,4.63,74
5242,Tamara,1,Private room,72,153,2.72,225
5243,Host,1,Entire home/apt,170,252,0.22,422
5244,Vernon,2,Entire home/apt,150,280,0.27,430
5245,Emilie,1,Private room,39,233,1.18,272
5246,Pamela,3,Private room,49,1,1.53,50
5247,Petya,3,Private room,39,318,0.16,357
5248,Marina,1,Entire home/apt,200,336,1.33,536
5249,Gage,2,Entire home/apt,185,0,0.2,185
5250,Leena,1,Entire home/apt,200,35,0.29,235
5251,Emma,2,Private room,110,0,0.02,110
5252,Tracey,2,Entire home/apt,275,0,0.07,275
5253,Martin,2,Private room,105,59,6.23,164
5254,Zev,1,Entire home/apt,260,232,5.04,492
5255,Scottie,2,Entire home/apt,175,0,0.07,175
5256,Marie Yves,2,Entire home/apt,90,295,1.66,385
5257,Jonathan,2,Entire home/apt,125,0,0.02,125
5258,Jay,3,Entire home/apt,239,355,0.45,594
5259,Annie,1,Entire home/apt,195,10,0.52,205
5260,Chandra,4,Private room,53,44,5.46,97
5261,Jeevan,1,Private room,99,4,2.84,103
5263,Silvia,1,Entire home/apt,130,13,0.07,143
5264,Brian,1,Entire home/apt,325,0,0.16,325
5265,Cathy,2,Entire home/apt,135,35,4.37,170
5266,Morgan,2,Private room,85,3,3.5,88
5267,Atlantis & Carmen,1,Private room,68,87,2.85,155
5268,Kay,3,Private room,45,0,0.02,45
5269,Mike,1,Entire home/apt,87,365,0.11,452
5270,Isa,2,Private room,89,188,1.44,277
5271,Samantha,2,Entire home/apt,150,308,3.42,458
5272,Andre,1,Entire home/apt,124,0,0.17,124
5274,Ruth,3,Private room,125,332,2.17,457
5275,Ruth,3,Private room,145,358,1.27,503
5277,Eugene,2,Private room,75,0,0.04,75
5278,Mike,1,Entire home/apt,87,340,0.12,427
5279,Chad,3,Private room,50,54,1.41,104
5280,Host,1,Entire home/apt,150,313,0.2,463
5281,Corey,1,Private room,95,365,0.04,460
5282,Host,1,Entire home/apt,200,188,0.14,388
5283,Amanda,1,Entire home/apt,120,0,0.45,120
5284,Tina,1,Entire home/apt,325,71,1.19,396
5285,Russell,1,Entire home/apt,165,0,0.04,165
5286,Jeremy & Laura,1,Entire home/apt,140,342,0.09,482
5287,Fabeye & Nabou,2,Private room,33,255,0.87,288
5288,Elyse,1,Entire home/apt,169,0,0.14,169
5290,Maha,1,Entire home/apt,190,0,0.08,190
5291,Petya,3,Private room,39,237,0.19,276
5292,Marcus,2,Entire home/apt,165,322,2.66,487
5293,Haim,3,Private room,79,297,0.83,376
5294,Maia,1,Entire home/apt,125,297,0.17,422
5295,Matthew,1,Entire home/apt,349,0,0.17,349
5297,Larry,2,Private room,40,278,0.7,318
5298,Fernando,2,Entire home/apt,76,0,0.28,76
5300,Kurt,2,Private room,45,197,0.53,242
5301,Todd,2,Entire home/apt,80,0,0.06,80
5302,Wendy,1,Entire home/apt,265,334,0.36,599
5303,Kaykay,2,Shared room,65,0,0.12,65
5304,Polly,2,Entire home/apt,90,0,0.05,90
5305,Jana,1,Private room,115,31,1.27,146
5307,Larry,2,Private room,45,327,0.39,372
5308,Angelo,3,Private room,50,308,2.78,358
5309,Seun And Marie,2,Private room,72,71,0.61,143
5310,Angelo,3,Private room,50,311,3.48,361
5311,Seun And Marie,2,Private room,57,58,0.72,115
5312,Adriana,1,Entire home/apt,225,0,0.08,225
5314,Telmo,3,Entire home/apt,120,300,1.73,420
5316,Lisa,1,Entire home/apt,249,58,1.35,307
5318,Eric,2,Entire home/apt,225,0,0.05,225
5319,Karen,4,Entire home/apt,95,0,0.13,95
5320,Ryan,2,Entire home/apt,90,4,0.29,94
5321,Geeta,2,Entire home/apt,101,0,0.29,101
5322,Allison,2,Entire home/apt,246,0,0.54,246
5323,Matt,2,Entire home/apt,120,188,0.32,308
5324,Gary,2,Entire home/apt,150,88,1.35,238
5325,Anaïs,2,Entire home/apt,119,0,0.02,119
5326,Ryan,1,Entire home/apt,150,0,0.13,150
5327,Valerie,1,Private room,80,118,0.3,198
5328,Sanda,2,Entire home/apt,189,0,0.27,189
5329,Kate,2,Private room,90,0,0.67,90
5330,(Email hidden by Airbnb),1,Entire home/apt,200,0,0.02,200
5331,Dolores,1,Entire home/apt,120,225,0.11,345
5332,Leighann,1,Private room,149,354,0.94,503
5333,Mike,1,Entire home/apt,130,365,0.04,495
5334,Holly,2,Private room,35,0,0.34,35
5335,Joseph,2,Entire home/apt,139,353,1.83,492
5336,Kristina,2,Entire home/apt,100,0,0.24,100
5337,Nancy,1,Private room,65,336,0.21,401
5338,Pam,1,Entire home/apt,200,0,0.18,200
5339,Theodora,1,Entire home/apt,99,0,0.49,99
5340,Velma,2,Entire home/apt,115,337,1.02,452
5341,Natasha,3,Private room,149,358,1.53,507
5342,Kate,2,Entire home/apt,135,10,0.32,145
5343,Stefanie,2,Private room,150,0,0.23,150
5344,John & Catherine,1,Private room,105,288,1.79,393
5345,Rebecca,2,Entire home/apt,75,0,0.02,75
5346,Alexander,1,Entire home/apt,175,0,1.05,175
5347,Samita,2,Entire home/apt,135,0,0.14,135
5350,Maria And Mariano,2,Private room,97,0,0.06,97
5351,Susan,1,Entire home/apt,860,365,0.67,1225
5353,Chris,1,Entire home/apt,98,33,3.97,131
5354,Mike,1,Entire home/apt,87,365,0.1,452
5355,Nina,1,Entire home/apt,150,331,0.23,481
5356,Ota,2,Private room,50,79,0.06,129
5357,Jeremy & Laura,1,Entire home/apt,185,310,0.13,495
5358,James,1,Entire home/apt,225,0,0.28,225
5359,Velma,2,Entire home/apt,151,318,0.87,469
5360,Kory,2,Entire home/apt,75,10,0.72,85
5362,Alex,2,Entire home/apt,150,294,4.33,444
5363,Eliane,1,Entire home/apt,145,0,0.29,145
5364,Irena,1,Entire home/apt,250,4,0.49,254
5365,Tony,3,Private room,170,90,0.07,260
5366,Marek,2,Entire home/apt,145,14,0.9,159
5367,Roxanne,1,Entire home/apt,200,0,0.32,200
5368,Jessica,2,Private room,50,0,0.09,50
5369,Michael,1,Private room,250,365,0.1,615
5370,Taz And Nayyirah,1,Entire home/apt,229,0,0.36,229
5371,Caleb,1,Entire home/apt,129,0,0.2,129
5373,Jeremy & Laura,1,Entire home/apt,168,283,0.16,451
5374,Nora,1,Private room,80,196,0.46,276
5375,Rez,2,Entire home/apt,104,159,0.77,263
5376,Jennifer,2,Entire home/apt,100,0,0.12,100
5377,Ian,1,Private room,95,127,5.03,222
5378,Del,3,Private room,95,267,0.06,362
5379,Ari,2,Entire home/apt,200,0,0.03,200
5381,Deborah,4,Private room,100,207,0.22,307
5382,Michael,1,Entire home/apt,195,178,6.76,373
5383,Dan,1,Entire home/apt,299,0,0.06,299
5384,Ota,2,Private room,45,92,0.74,137
5385,Shi Qing,1,Private room,139,365,0.23,504
5386,Aalap,1,Entire home/apt,200,0,0.05,200
5387,Aurelie,5,Entire home/apt,70,256,4.09,326
5388,Glenn,2,Private room,50,0,0.02,50
5389,Madeline,2,Private room,42,0,0.11,42
5390,Amitai,2,Entire home/apt,116,35,0.76,151
5391,Mary,1,Entire home/apt,200,0,0.02,200
5392,Jesse,1,Private room,129,365,0.56,494
5393,Virginia,2,Private room,125,270,1.99,395
5394,Eylem,2,Private room,55,0,0.07,55
5395,Ted,1,Entire home/apt,200,0,0.1,200
5396,Sandra,2,Entire home/apt,165,159,0.27,324
5397,Sarah,1,Entire home/apt,199,0,0.08,199
5398,Ellie,1,Entire home/apt,150,0,0.26,150
5400,Nicole,2,Private room,90,365,0.17,455
5401,Max,1,Entire home/apt,120,64,0.86,184
5402,Fabeye & Nabou,2,Private room,40,190,1.23,230
5403,Evy,2,Private room,75,311,2.96,386
5404,Marine,2,Private room,68,0,0.11,68
5405,Tony,2,Private room,75,365,1.67,440
5406,Nicole,1,Entire home/apt,45,0,0.12,45
5407,Tim,1,Shared room,45,0,0.21,45
5408,Hetty,2,Private room,65,21,1.26,86
5409,David,2,Private room,75,347,0.24,422
5410,Jessica,1,Private room,84,0,0.09,84
5411,Jake,1,Entire home/apt,130,0,1.71,130
5412,Schuyler,2,Private room,50,0,0.2,50
5413,Jonathan,1,Private room,150,365,0.85,515
5414,Stephanie,2,Private room,95,365,0.13,460
5415,Samantha,1,Entire home/apt,300,0,0.03,300
5416,Mike,1,Entire home/apt,113,258,0.13,371
5417,Kenneth,1,Entire home/apt,145,219,0.39,364
5419,Ian,1,Private room,90,155,4.99,245
5420,Michael,1,Entire home/apt,95,204,0.27,299
5421,AFI Apartments,1,Entire home/apt,118,282,0.1,400
5422,Catherine,2,Entire home/apt,75,0,0.03,75
5423,Jan,1,Entire home/apt,225,85,0.68,310
5424,Stephanie,2,Private room,81,364,0.08,445
5425,Aleksandra,2,Entire home/apt,190,0,0.08,190
5426,Lian,2,Private room,75,0,0.05,75
5427,Camila,2,Private room,59,189,0.2,248
5428,Matias & Marlana,1,Private room,99,361,1.31,460
5431,Andrew M.,1,Entire home/apt,275,0,0.19,275
5433,Shawn,2,Entire home/apt,120,0,0.22,120
5434,Payal,2,Entire home/apt,125,0,0.19,125
5435,Joshua,2,Private room,75,271,0.42,346
5436,Michael,1,Entire home/apt,117,7,0.12,124
5437,MaryEllen,1,Entire home/apt,80,0,0.07,80
5438,Zack,3,Private room,60,0,0.08,60
5439,Patric,2,Private room,103,192,2.88,295
5440,Avijit,3,Entire home/apt,65,0,0.06,65
5441,Mysia,4,Private room,45,0,0.28,45
5442,Chuck,3,Private room,70,282,1.16,352
5443,Anna,1,Entire home/apt,90,124,0.02,214
5444,Laura,1,Entire home/apt,225,0,0.12,225
5445,Merritt,1,Entire home/apt,125,3,0.04,128
5446,Mette,2,Entire home/apt,175,19,1.29,194
5447,Geoff & Aurelia,1,Entire home/apt,195,0,0.43,195
5448,Kevin,1,Private room,130,235,3.01,365
5449,Lauren,2,Private room,96,0,0.02,96
5450,Mario,2,Private room,129,298,3.42,427
5451,Matt,1,Entire home/apt,200,100,0.17,300
5452,Burton,1,Private room,95,0,0.19,95
5453,Mark,1,Entire home/apt,189,9,1.18,198
5454,Christine,1,Entire home/apt,450,121,0.03,571
5455,Geoff & Aurelia,1,Entire home/apt,264,0,0.65,264
5456,Jessica,3,Private room,45,188,0.34,233
5457,Luis,2,Entire home/apt,150,0,0.42,150
5458,Geoff & Aurelia,1,Entire home/apt,540,350,0.38,890
5460,Olga,1,Entire home/apt,230,0,0.02,230
5461,Erika,3,Private room,65,302,0.27,367
5463,Mike,1,Entire home/apt,160,8,1.31,168
5465,Frank,2,Entire home/apt,138,0,0.1,138
5466,Carol Gloria,4,Entire home/apt,155,332,0.35,487
5468,Jack Andrew,1,Private room,39,292,0.57,331
5469,Justine,2,Entire home/apt,115,283,1.3,398
5470,Raanan,1,Entire home/apt,110,333,0.05,443
5471,Mariela,1,Private room,100,214,2.93,314
5472,Kimberly,1,Entire home/apt,225,0,0.04,225
5473,Charlayne,2,Entire home/apt,125,180,0.21,305
5474,Daphne,1,Private room,150,0,0.02,150
5475,Tommy,2,Entire home/apt,199,0,0.23,199
5476,Shivani,1,Entire home/apt,250,0,0.25,250
5477,Pervaiz,2,Entire home/apt,210,180,0.21,390
5478,Susannah,5,Entire home/apt,180,263,2.42,443
5479,Pat,1,Entire home/apt,129,0,0.58,129
5480,Jeff And Jessica,1,Private room,90,36,4.5,126
5481,Mike&Mavi,1,Private room,50,330,0.79,380
5482,Marina,1,Entire home/apt,140,19,0.66,159
5483,Joe & Michael,2,Entire home/apt,150,0,0.09,150
5484,Barry,1,Entire home/apt,233,364,0.33,597
5485,Natalie,1,Entire home/apt,170,0,0.16,170
5486,Stephanie,2,Private room,60,326,0.26,386
5487,Jennifer,2,Entire home/apt,200,0,0.05,200
5489,Mike,1,Entire home/apt,150,342,0.02,492
5490,Adam,2,Entire home/apt,140,0,0.12,140
5492,Victoria,2,Private room,60,0,0.07,60
5493,Mary,2,Entire home/apt,130,83,0.07,213
5495,Danielle,2,Private room,89,219,0.52,308
5497,Eliana E,3,Entire home/apt,150,294,1.86,444
5498,Matti,1,Entire home/apt,240,0,0.13,240
5499,Peng,1,Entire home/apt,1400,88,0.53,1488
5501,Mara,1,Private room,88,234,2.93,322
5502,James,1,Shared room,75,315,0.1,390
5503,Jd,1,Entire home/apt,500,90,0.46,590
5504,Angela,1,Entire home/apt,125,0,0.08,125
5505,Mike,1,Private room,75,301,1.12,376
5506,Mike,1,Entire home/apt,130,335,0.04,465
5507,Host,1,Entire home/apt,170,319,0.19,489
5508,Michael,1,Entire home/apt,300,137,0.19,437
5509,Monifa & Saint,2,Entire home/apt,115,285,4.43,400
5510,Jaxon,2,Entire home/apt,93,226,0.4,319
5511,Arielle,2,Entire home/apt,119,241,3.62,360
5512,Pablo,1,Entire home/apt,180,51,0.41,231
5513,Mina,1,Entire home/apt,226,303,0.14,529
5514,Carla,2,Entire home/apt,155,0,0.04,155
5515,Tom,1,Entire home/apt,115,0,0.27,115
5516,James,2,Private room,50,0,0.07,50
5518,Patricia,1,Private room,200,0,0.52,200
5519,Sara,2,Entire home/apt,157,0,0.05,157
5520,Nicci & David,2,Entire home/apt,145,269,2.14,414
5521,Martyn,3,Private room,95,0,1.15,95
5522,David,1,Entire home/apt,115,0,0.02,115
5523,Benham,3,Private room,65,2,5.0,67
5525,Sarah,3,Private room,250,123,0.43,373
5526,Matt,1,Private room,95,9,2.31,104
5527,David,2,Entire home/apt,185,9,1.9,194
5528,Bobi,1,Private room,55,359,2.76,414
5529,Hamish,1,Entire home/apt,350,0,0.02,350
5530,Robin,1,Private room,170,259,0.38,429
5531,Joanne,2,Entire home/apt,100,58,0.31,158
5532,Jillian,1,Private room,36,0,0.2,36
5533,Lorcán,2,Private room,60,0,0.02,60
5534,Marla,2,Private room,125,0,0.02,125
5535,Chloe,2,Entire home/apt,120,66,2.32,186
5536,Sushant,1,Shared room,90,0,0.14,90
5537,Patricia,1,Entire home/apt,129,260,1.63,389
5538,Karen,3,Entire home/apt,78,107,2.26,185
5540,Mike,1,Private room,99,268,0.36,367
5541,Mike,4,Private room,50,261,1.84,311
5543,"Rossy,  Carmen And Juan",4,Private room,47,71,2.15,118
5544,Stephanie,2,Entire home/apt,150,254,2.57,404
5545,Judith,5,Entire home/apt,200,360,0.92,560
5546,Saya & Diego,2,Entire home/apt,125,293,2.23,418
5547,Thomas & Gaby,2,Entire home/apt,60,59,2.5,119
5549,Ilona,2,Entire home/apt,100,0,0.16,100
5550,Kiara,3,Private room,99,322,0.26,421
5551,Elke,1,Private room,75,198,0.53,273
5552,Pam,2,Private room,140,185,0.02,325
5553,Michael,4,Entire home/apt,90,358,0.04,448
5554,Lisa,1,Shared room,59,345,0.99,404
5555,Lauren,1,Entire home/apt,111,198,0.88,309
5556,Agnieszka,1,Entire home/apt,80,0,0.05,80
5558,Rk,1,Private room,50,0,0.14,50
5559,Tuvia,1,Entire home/apt,300,0,0.12,300
5560,Andrew,2,Entire home/apt,90,0,0.12,90
5561,David,1,Private room,119,84,1.4,203
5562,Valeria,3,Private room,69,311,0.38,380
5564,Alicja,2,Entire home/apt,185,16,1.94,201
5565,Elizabeth,3,Entire home/apt,100,0,0.42,100
5566,Arnab,1,Shared room,85,0,0.56,85
5567,Jason,1,Private room,135,340,2.14,475
5568,Emily And Joel,2,Private room,169,0,2.58,169
5569,Garnet,2,Private room,38,126,1.35,164
5570,Tony,2,Private room,90,288,2.21,378
5571,Magen,1,Private room,45,0,0.03,45
5572,Steve & Anna,2,Entire home/apt,149,254,2.62,403
5573,Jason,2,Entire home/apt,200,0,0.24,200
5574,Michael And Donna,1,Entire home/apt,125,278,0.11,403
5575,Molly,2,Private room,65,6,0.45,71
5576,Molly,2,Entire home/apt,174,12,0.54,186
5577,Claudina,2,Private room,89,339,0.41,428
5578,Mary Kathryn,2,Entire home/apt,150,0,0.15,150
5580,Luana,3,Private room,58,364,0.04,422
5581,Gilda,2,Private room,103,0,0.82,103
5582,Charles,1,Entire home/apt,383,251,0.41,634
5583,Rachelle,2,Private room,40,0,0.02,40
5584,Melissa,3,Private room,76,225,0.41,301
5585,Mike,1,Private room,170,0,0.05,170
5586,Bobi,1,Private room,45,357,2.59,402
5588,Stara,1,Entire home/apt,199,17,3.17,216
5589,Rob,1,Entire home/apt,99,1,1.06,100
5590,Susan,2,Private room,39,273,0.88,312
5591,Dan,3,Entire home/apt,60,0,0.1,60
5592,Anthony/Joanne,2,Entire home/apt,130,257,2.53,387
5593,Kelly,2,Entire home/apt,200,303,2.96,503
5595,Yevgeny,1,Private room,105,287,4.13,392
5596,Eleanor,2,Entire home/apt,115,0,1.13,115
5597,Sugeiry,1,Entire home/apt,145,0,0.58,145
5598,Devin,2,Entire home/apt,75,30,4.27,105
5599,Shahram,2,Entire home/apt,250,309,2.57,559
5600,Suzanne,1,Private room,80,0,0.06,80
5601,Jason,1,Private room,120,304,1.21,424
5602,Todd,2,Private room,100,0,0.56,100
5603,Aj,1,Private room,125,0,0.2,125
5604,Russell,2,Entire home/apt,132,0,0.05,132
5605,Ellie,2,Entire home/apt,225,158,1.13,383
5606,Daniel,2,Entire home/apt,175,0,0.03,175
5607,David,1,Entire home/apt,225,221,0.03,446
5608,Jenny,2,Entire home/apt,215,250,2.86,465
5609,Cee,2,Entire home/apt,300,32,0.18,332
5610,Julia,1,Entire home/apt,130,300,3.76,430
5611,Jennifer And Basil,3,Entire home/apt,110,355,5.02,465
5612,Vie,4,Private room,75,364,0.73,439
5613,Liz,2,Private room,36,0,0.34,36
5614,Ozlem,2,Entire home/apt,299,279,0.15,578
5615,Aviad,1,Entire home/apt,200,0,0.02,200
5616,Kathisha,2,Entire home/apt,110,36,0.16,146
5617,Krzysztof,2,Entire home/apt,160,226,0.76,386
5618,Jae (Owen's Wife),2,Entire home/apt,152,287,2.51,439
5619,Caroline,2,Entire home/apt,145,96,0.31,241
5620,Fagan,2,Private room,120,365,0.2,485
5621,Emily,2,Entire home/apt,84,224,2.29,308
5622,Yong,1,Entire home/apt,160,0,0.22,160
5623,Erica,2,Entire home/apt,150,363,0.28,513
5624,Jessica,3,Entire home/apt,180,190,1.8,370
5625,Vie,4,Private room,68,365,0.74,433
5627,Michael,2,Private room,25,0,0.14,25
5628,Debbie,2,Entire home/apt,155,342,1.0,497
5630,Leslie,2,Entire home/apt,75,289,1.56,364
5631,Ryan,1,Private room,80,0,0.05,80
5632,Sade,1,Private room,72,304,0.96,376
5633,Edward,2,Private room,52,335,0.5,387
5634,Zheni,2,Entire home/apt,125,30,1.82,155
5635,Milena,1,Private room,85,241,0.36,326
5636,Channa,2,Private room,58,58,0.42,116
5637,Mandy,2,Private room,100,335,2.69,435
5638,Helen,1,Private room,65,103,3.64,168
5639,Kat,2,Entire home/apt,300,362,0.32,662
5640,Carrie-Anne,2,Private room,40,95,3.36,135
5641,Samantha,3,Entire home/apt,110,0,0.81,110
5642,David,2,Private room,85,90,0.77,175
5643,Deborah Lily,2,Entire home/apt,158,204,1.53,362
5645,Jessica,1,Private room,100,0,0.97,100
5646,Zak,2,Private room,64,0,0.07,64
5647,Rafael,2,Entire home/apt,395,158,0.65,553
5648,Rayna,3,Entire home/apt,120,142,0.52,262
5649,HayNoor,4,Private room,51,212,1.88,263
5650,Anthony,1,Entire home/apt,149,0,0.05,149
5651,Lara,2,Private room,65,308,3.99,373
5652,Jessica,3,Private room,70,183,0.19,253
5653,Andrew,1,Entire home/apt,170,0,0.02,170
5654,Sushant,1,Entire home/apt,150,0,0.04,150
5655,Rachel,1,Entire home/apt,75,203,0.12,278
5656,Katherine,1,Private room,100,0,0.21,100
5657,LeKethia,2,Private room,38,351,0.21,389
5658,Altin,1,Entire home/apt,200,157,0.22,357
5659,Roger,1,Entire home/apt,145,97,0.65,242
5660,Madison,2,Entire home/apt,150,0,0.29,150
5661,Leora,3,Entire home/apt,200,0,0.04,200
5662,Pervaiz,2,Entire home/apt,125,311,3.27,436
5663,Elizabeth,1,Private room,175,177,0.43,352
5664,P,2,Entire home/apt,180,0,0.03,180
5665,Prune,1,Entire home/apt,175,18,0.13,193
5666,Lars,1,Entire home/apt,175,0,1.36,175
5667,Patrick,2,Private room,50,14,0.14,64
5668,Timothy,2,Entire home/apt,109,356,0.64,465
5669,Seun And Marie,2,Private room,67,58,0.36,125
5670,Seun And Marie,2,Private room,57,71,0.38,128
5671,Seun And Marie,2,Private room,77,66,0.66,143
5672,Angelo,2,Private room,80,0,1.05,80
5673,Victoria,2,Entire home/apt,85,97,0.21,182
5674,Claudina,2,Private room,86,311,0.19,397
5675,Gil,2,Private room,120,312,1.96,432
5676,Florrie,2,Entire home/apt,140,28,3.24,168
5677,Rebecca,2,Entire home/apt,300,0,0.09,300
5678,Venessa,1,Private room,90,0,0.11,90
5679,Jason & Agnes,1,Private room,70,157,1.48,227
5680,Ammy,1,Private room,90,0,1.53,90
5681,Joanna,1,Entire home/apt,200,286,0.61,486
5682,Scott,1,Entire home/apt,135,0,0.1,135
5683,Jess And Josh,2,Private room,37,73,3.74,110
5684,Noelle,2,Private room,60,0,0.02,60
5685,Michael,1,Entire home/apt,419,10,0.47,429
5686,Emma,3,Entire home/apt,130,0,0.03,130
5687,Elizabeth,2,Entire home/apt,180,121,0.99,301
5688,Tal,1,Entire home/apt,160,0,0.12,160
5689,Eric,2,Entire home/apt,125,71,3.51,196
5691,Jessica,3,Private room,65,133,0.35,198
5693,Samer,3,Private room,79,88,0.4,167
5695,Yulia,1,Entire home/apt,115,11,0.57,126
5696,Lucio,1,Private room,100,23,0.22,123
5697,Geri,2,Private room,90,64,0.41,154
5698,Loni & Russ,1,Entire home/apt,135,192,4.01,327
5699,Keturah,2,Private room,50,76,0.84,126
5700,Morgan,2,Private room,71,3,3.0,74
5701,Cecilia,3,Entire home/apt,80,220,0.08,300
5702,Niko,1,Private room,103,237,6.79,340
5703,Mat,1,Entire home/apt,250,303,0.1,553
5704,Sarah,1,Entire home/apt,219,0,0.15,219
5705,Leslie,2,Entire home/apt,225,305,0.22,530
5706,ZVIPCO  LLC (Robert),1,Entire home/apt,99,333,0.87,432
5707,Arnie,2,Private room,35,0,0.02,35
5708,Daniel,1,Private room,90,10,2.01,100
5709,Tanya,3,Private room,47,157,0.07,204
5710,Steven,2,Private room,75,108,2.15,183
5711,Sandy,2,Entire home/apt,170,275,0.77,445
5712,Joan,2,Entire home/apt,150,320,0.86,470
5713,Mari J,2,Shared room,30,319,1.39,349
5714,Corey,1,Private room,119,0,0.12,119
5715,Beatrice,2,Private room,40,0,0.02,40
5716,Ritchie,2,Entire home/apt,85,0,0.03,85
5717,Danielle,2,Private room,99,354,0.33,453
5719,Adam,1,Private room,79,0,0.09,79
5720,Amy,2,Private room,60,0,0.1,60
5721,R,2,Entire home/apt,115,241,2.27,356
5722,Monika,3,Private room,90,340,0.31,430
5723,David,2,Private room,65,188,0.55,253
5724,Veronica,2,Private room,65,321,6.19,386
5725,Monica,1,Entire home/apt,131,12,0.27,143
5726,Grace,2,Entire home/apt,150,0,0.05,150
5727,Anna,2,Private room,55,38,1.49,93
5728,Steven,2,Private room,70,148,1.58,218
5729,June,3,Entire home/apt,160,0,0.04,160
5730,Zoya,2,Entire home/apt,95,0,1.79,95
5731,Ana,1,Entire home/apt,99,0,0.09,99
5732,Rosemary,1,Entire home/apt,500,0,0.05,500
5733,Chris,2,Private room,35,0,0.03,35
5734,Dana,3,Private room,50,245,0.76,295
5735,Steven,2,Private room,77,129,2.14,206
5736,Jenny,2,Entire home/apt,380,264,1.82,644
5738,Avril,1,Entire home/apt,150,210,0.16,360
5740,Lou,2,Entire home/apt,199,269,1.78,468
5741,June,2,Private room,150,180,0.21,330
5742,Susie,1,Entire home/apt,145,0,0.34,145
5743,Maha,2,Private room,70,364,0.35,434
5744,Katerina,2,Entire home/apt,120,336,2.29,456
5746,Cristina,1,Entire home/apt,139,248,2.76,387
5747,Firas,2,Private room,85,0,0.02,85
5748,Elizabeth And Roberto,1,Entire home/apt,94,309,0.26,403
5749,Brian,2,Entire home/apt,116,0,2.56,116
5750,Oates + Bill,2,Private room,72,20,3.94,92
5753,Alejandro,1,Entire home/apt,200,0,0.02,200
5754,Grace,2,Private room,72,66,6.22,138
5755,Alaina,1,Entire home/apt,100,0,0.27,100
5756,J,1,Entire home/apt,900,0,0.17,900
5757,Keith,3,Private room,80,102,1.31,182
5759,Kelly,1,Entire home/apt,92,245,3.14,337
5761,Marley,2,Private room,50,364,0.12,414
5763,Alexandre,2,Entire home/apt,135,245,2.23,380
5764,Meghna,1,Entire home/apt,160,0,0.05,160
5766,Hazel,2,Entire home/apt,129,230,3.91,359
5767,Genevieve,1,Entire home/apt,180,365,0.03,545
5769,Cherng-Mao,2,Private room,75,0,0.17,75
5770,Diana,2,Entire home/apt,119,0,0.11,119
5771,Takao & Aiko,5,Entire home/apt,99,326,0.61,425
5772,Brad,2,Entire home/apt,120,0,0.07,120
5773,Steven,2,Private room,73,147,1.88,220
5774,Jessica,2,Entire home/apt,500,173,0.2,673
5776,Alissa,2,Entire home/apt,275,0,0.05,275
5777,Funda,3,Private room,50,52,2.25,102
5778,Ben,1,Shared room,40,197,1.53,237
5779,Gabriela,2,Entire home/apt,115,0,0.05,115
5782,Amanda,2,Entire home/apt,150,0,0.07,150
5783,Matt,2,Entire home/apt,200,358,1.65,558
5784,Robert,1,Entire home/apt,75,0,0.09,75
5785,Lumin And Hendrik,3,Entire home/apt,98,15,2.73,113
5786,Eric,2,Entire home/apt,199,238,3.92,437
5787,Crystal,1,Entire home/apt,109,0,0.19,109
5788,Francesca,1,Entire home/apt,110,14,0.45,124
5789,Veronica,2,Private room,59,328,6.05,387
5790,Amy,2,Entire home/apt,95,172,0.44,267
5791,David,1,Entire home/apt,159,234,3.53,393
5792,Stephen,1,Entire home/apt,225,0,0.18,225
5793,Nick,2,Entire home/apt,195,260,2.02,455
5794,Orinda,3,Entire home/apt,96,316,3.44,412
5795,Whitney,2,Entire home/apt,73,0,0.13,73
5796,Mark,1,Private room,88,251,5.6,339
5797,Simone,2,Entire home/apt,90,0,0.05,90
5798,Juli,2,Entire home/apt,99,0,0.28,99
5800,Reenie,2,Private room,35,11,0.81,46
5801,Nirit (Nina),2,Entire home/apt,1050,327,2.19,1377
5802,Christophe,2,Entire home/apt,175,308,1.33,483
5803,Brandon,1,Entire home/apt,395,2,1.27,397
5804,David,3,Entire home/apt,195,305,2.2,500
5805,Beatriz,2,Private room,49,281,0.14,330
5807,Anita,1,Entire home/apt,250,0,0.02,250
5808,Cristina,2,Entire home/apt,150,170,0.3,320
5810,Louise & Thomas,3,Entire home/apt,100,268,0.16,368
5811,Yohan,1,Private room,55,339,0.07,394
5812,Lee,1,Entire home/apt,275,0,0.03,275
5815,Tameisha,2,Private room,80,346,2.24,426
5816,Kishorie,3,Entire home/apt,89,359,6.1,448
5817,Lorcan,1,Entire home/apt,280,173,1.59,453
5820,BrooklynSleeps,2,Private room,70,323,1.96,393
5821,Lori,2,Private room,75,0,0.02,75
5822,Angel,2,Private room,80,297,1.12,377
5823,Nathaniel,1,Shared room,41,0,0.02,41
5824,Anja,1,Entire home/apt,195,0,0.02,195
5825,Chloe,1,Entire home/apt,250,0,0.11,250
5826,Gina,1,Entire home/apt,96,169,3.47,265
5827,Andy,1,Private room,98,116,0.55,214
5828,Kevin,2,Entire home/apt,140,100,2.09,240
5830,Brandon,1,Entire home/apt,175,276,1.88,451
5831,Janet,1,Entire home/apt,120,0,0.09,120
5832,Stephenie,1,Private room,89,363,1.33,452
5834,Hellen,2,Entire home/apt,178,32,0.24,210
5835,Solange Et Michel,2,Entire home/apt,210,302,0.47,512
5836,Erin,1,Entire home/apt,150,46,1.53,196
5837,Gita,1,Entire home/apt,149,215,1.43,364
5838,Lev,1,Entire home/apt,225,0,0.03,225
5840,Aj,3,Entire home/apt,63,362,0.03,425
5842,Gregory,2,Entire home/apt,106,0,0.26,106
5843,Sj,2,Entire home/apt,165,328,0.63,493
5844,Ken,2,Private room,75,365,0.43,440
5845,Petya,3,Private room,39,310,0.1,349
5846,Petya,3,Private room,39,341,0.26,380
5847,Torell,2,Shared room,30,339,0.37,369
5848,Nick,1,Private room,70,0,0.03,70
5849,Marjorie,1,Private room,100,66,2.45,166
5850,George & Diana,3,Entire home/apt,125,0,1.94,125
5851,Daniela,3,Entire home/apt,110,342,0.05,452
5852,Maria,2,Entire home/apt,145,0,0.13,145
5853,Joseph  &  Hector,1,Private room,112,230,2.92,342
5854,Caroline,2,Private room,69,286,2.68,355
5855,Alessio,1,Entire home/apt,300,0,1.08,300
5856,Roberta,1,Private room,260,177,0.03,437
5857,Diego,3,Private room,49,298,0.73,347
5858,Lp,1,Entire home/apt,215,187,0.4,402
5859,Julia,1,Entire home/apt,200,208,2.84,408
5861,Joyce,1,Entire home/apt,1000,270,0.72,1270
5862,James,1,Entire home/apt,120,0,0.31,120
5863,Sean,1,Entire home/apt,310,7,1.32,317
5864,James,2,Private room,70,0,3.64,70
5865,Andrew,2,Entire home/apt,195,15,0.99,210
5866,SooKi,2,Entire home/apt,110,264,0.56,374
5867,Nina,1,Entire home/apt,75,167,0.23,242
5868,Carol Gloria,4,Shared room,45,365,0.14,410
5869,Mila,1,Entire home/apt,165,0,0.41,165
5870,Linda,3,Entire home/apt,150,24,1.5,174
5871,Ariel,2,Private room,80,0,0.03,80
5872,Lea,1,Entire home/apt,180,362,2.15,542
5873,Tony,2,Private room,80,365,1.73,445
5874,Jessica,2,Private room,60,0,0.04,60
5875,Daniel,1,Entire home/apt,149,0,0.45,149
5876,Veronica,2,Private room,53,0,6.09,53
5877,Chris,1,Entire home/apt,200,291,0.16,491
5878,Tess,1,Entire home/apt,160,108,1.38,268
5880,Xiao,1,Entire home/apt,140,0,0.28,140
5881,Jc,1,Entire home/apt,199,232,0.19,431
5882,Brian,1,Entire home/apt,190,3,0.75,193
5883,Katie,2,Entire home/apt,125,351,0.89,476
5884,Angela,1,Entire home/apt,145,50,1.1,195
5885,Anna,1,Entire home/apt,150,0,0.02,150
5886,Ruth,3,Private room,95,334,0.74,429
5888,Ana,2,Private room,99,290,1.34,389
5889,Manuela,2,Entire home/apt,130,0,0.84,130
5890,Joey,2,Private room,56,0,0.02,56
5891,Ross,1,Entire home/apt,450,0,0.02,450
5892,Rasheeda,1,Private room,75,0,0.2,75
5893,Judith,2,Private room,240,348,0.79,588
5894,Vida,2,Entire home/apt,129,300,0.02,429
5895,Talisa,2,Private room,45,0,0.27,45
5896,Lindsay Alexa,1,Entire home/apt,259,255,0.44,514
5897,Danielle,1,Entire home/apt,75,116,1.91,191
5898,Victor,4,Private room,37,305,1.15,342
5899,Sharon,2,Entire home/apt,210,83,2.75,293
5900,James,1,Entire home/apt,199,178,3.37,377
5901,Victoria,2,Entire home/apt,189,271,0.58,460
5902,J.,3,Private room,58,101,1.98,159
5903,Ollie,2,Private room,60,99,0.78,159
5904,Walther,3,Entire home/apt,190,182,0.6,372
5905,Mona,2,Entire home/apt,139,82,1.53,221
5906,Ehud,1,Entire home/apt,125,193,3.28,318
5907,Basil,2,Private room,94,267,0.9,361
5908,Karen,1,Entire home/apt,100,9,1.02,109
5909,Dean,1,Private room,149,90,0.17,239
5910,Tarek,1,Private room,128,249,0.26,377
5911,Vinneth,2,Entire home/apt,160,303,2.61,463
5912,Roni,2,Entire home/apt,160,296,0.17,456
5913,Orhun,1,Private room,110,14,1.26,124
5914,Liana,2,Entire home/apt,285,12,0.75,297
5915,Val And Taylor,2,Entire home/apt,75,349,0.1,424
5916,Ahmad,1,Entire home/apt,650,358,0.13,1008
5917,Mina,1,Entire home/apt,133,345,0.36,478
5918,Sindhu,1,Entire home/apt,149,0,0.79,149
5920,Madeline,1,Entire home/apt,200,226,0.98,426
5921,Rahul,1,Private room,110,0,0.36,110
5922,John,1,Entire home/apt,375,0,0.23,375
5923,Danielle,1,Entire home/apt,95,0,0.04,95
5924,Mina,1,Entire home/apt,94,316,0.57,410
5925,Janine,2,Entire home/apt,120,266,2.07,386
5926,Swati,2,Entire home/apt,150,0,0.02,150
5927,Host,1,Entire home/apt,160,267,0.12,427
5928,Georges,1,Entire home/apt,132,0,0.16,132
5929,Angie And Matthew,2,Entire home/apt,102,4,0.18,106
5930,Chema,2,Entire home/apt,85,286,1.46,371
5931,Katie,2,Entire home/apt,142,0,0.04,142
5932,Mio,3,Private room,70,23,0.05,93
5933,Murad,2,Entire home/apt,200,365,1.59,565
5934,Vida,2,Entire home/apt,199,339,0.09,538
5935,Leatha,2,Entire home/apt,100,343,1.19,443
5936,Mei-Ling,2,Entire home/apt,123,0,0.61,123
5937,LaToya,2,Entire home/apt,175,0,0.49,175
5938,Maria,1,Private room,100,0,0.25,100
5939,Cynthia,1,Private room,57,222,0.22,279
5940,Shahana,2,Private room,39,178,2.66,217
5941,Cynthia,1,Private room,107,251,0.47,358
5943,Derek,2,Private room,69,0,0.59,69
5944,Peter,2,Entire home/apt,137,344,1.16,481
5946,Mandy,1,Private room,65,0,0.02,65
5947,Michael,1,Private room,66,0,0.02,66
5948,Joshua,2,Private room,77,0,0.16,77
5949,Gung,2,Entire home/apt,110,0,0.14,110
5950,Abel,1,Private room,64,331,0.82,395
5951,Sandra,2,Entire home/apt,90,349,1.96,439
5953,Husain,1,Entire home/apt,146,0,1.01,146
5955,Roman,3,Entire home/apt,189,330,1.88,519
5956,Wayne,2,Entire home/apt,985,19,1.6,1004
5957,Farrell,2,Entire home/apt,285,0,0.65,285
5958,Treasure,2,Entire home/apt,140,251,2.21,391
5959,Aj,3,Private room,97,90,0.55,187
5960,Tony & Lea,3,Entire home/apt,180,90,0.31,270
5961,Anna,1,Entire home/apt,199,0,0.18,199
5962,Felicia,2,Entire home/apt,220,253,1.48,473
5963,Gillian,1,Entire home/apt,180,226,0.13,406
5964,Julie,2,Entire home/apt,88,0,0.09,88
5966,Amanda,2,Entire home/apt,170,28,3.05,198
5967,Jasmine,1,Private room,120,0,0.24,120
5968,Jasmine,1,Private room,105,0,0.16,105
5969,Steef,2,Entire home/apt,110,132,3.35,242
5970,Marie,2,Private room,55,100,0.2,155
5971,Mauricio,2,Entire home/apt,150,0,0.12,150
5972,Tony,2,Entire home/apt,180,365,0.97,545
5973,Belinda,2,Entire home/apt,110,0,0.12,110
5974,Gloria,1,Entire home/apt,160,0,0.09,160
5976,Fernando,3,Private room,75,0,0.02,75
5978,Leonella,1,Entire home/apt,120,279,0.96,399
5979,David,1,Entire home/apt,198,269,3.22,467
5980,Amy,2,Private room,60,352,1.68,412
5981,Benjamin,2,Entire home/apt,170,151,3.76,321
5982,Yervand,1,Entire home/apt,248,0,0.02,248
5983,Aaron,2,Private room,100,0,0.02,100
5984,Jonathan,1,Entire home/apt,180,0,0.03,180
5985,Lindsay,2,Private room,60,0,0.21,60
5986,Bellamy,2,Entire home/apt,83,165,4.66,248
5987,Adriana,2,Private room,45,0,0.03,45
5988,Linda,2,Private room,135,0,0.02,135
5990,Dan,1,Entire home/apt,230,4,0.21,234
5991,Jessica,1,Entire home/apt,180,227,3.11,407
5992,Kristen,1,Entire home/apt,175,0,0.02,175
5993,Mark,3,Private room,110,325,1.0,435
5994,Kanae,2,Entire home/apt,160,302,1.63,462
5995,Brittan,2,Entire home/apt,115,0,0.16,115
5996,Marc,1,Shared room,169,0,0.07,169
5998,Mike,1,Entire home/apt,87,325,0.09,412
5999,Waleed,3,Private room,75,0,1.85,75
6000,Joe,1,Entire home/apt,130,0,0.19,130
6001,Gena,1,Entire home/apt,115,251,0.13,366
6002,Jessica,3,Private room,50,183,0.02,233
6003,Vyacheslav,1,Entire home/apt,200,0,0.04,200
6004,Jessica,3,Private room,55,281,0.23,336
6005,Angela,1,Entire home/apt,125,0,0.13,125
6006,Pascal & Karin,3,Entire home/apt,160,133,1.38,293
6007,Shahana,2,Private room,39,32,2.77,71
6008,Matthew & Marilyn,1,Private room,89,301,0.98,390
6009,Gina,2,Entire home/apt,85,247,1.12,332
6010,Emily,2,Private room,50,0,0.11,50
6011,Erin,2,Entire home/apt,229,254,3.41,483
6012,Adrien,1,Entire home/apt,130,0,0.07,130
6013,Mark,3,Entire home/apt,149,327,1.55,476
6014,Jenny,2,Entire home/apt,120,16,0.05,136
6015,Priscillia,2,Private room,45,0,0.02,45
6016,Marina,3,Private room,56,304,0.88,360
6018,Rustam,2,Private room,75,340,1.23,415
6020,Christine,1,Entire home/apt,115,10,1.2,125
6021,Michelle,2,Private room,90,365,0.37,455
6022,Sara,1,Private room,109,355,1.57,464
6023,Pat,4,Private room,49,227,0.74,276
6024,Claire,2,Entire home/apt,100,243,1.85,343
6025,Kristen,1,Entire home/apt,295,0,0.09,295
6026,Nick,2,Entire home/apt,245,19,0.92,264
6027,Charlene,1,Private room,79,90,1.1,169
6028,Dominique,1,Private room,60,0,0.63,60
6029,Alex,2,Entire home/apt,125,0,0.12,125
6030,Caroline,2,Private room,55,0,0.17,55
6031,Howard,1,Private room,425,0,0.02,425
6032,Chad,2,Entire home/apt,150,0,0.03,150
6035,Cassandra,2,Private room,49,0,0.12,49
6037,Annette,1,Private room,97,363,2.0,460
6038,Travis,1,Entire home/apt,115,0,0.16,115
6039,Sarah,1,Entire home/apt,200,0,0.5,200
6040,Mor,1,Entire home/apt,250,311,0.07,561
6041,Mor,1,Entire home/apt,200,336,0.14,536
6042,Deirdre,2,Entire home/apt,160,211,5.81,371
6043,Maria,1,Entire home/apt,90,249,0.36,339
6044,Gena,2,Entire home/apt,239,257,0.33,496
6045,Toby,1,Entire home/apt,290,193,0.37,483
6046,Anissa,2,Entire home/apt,150,0,0.09,150
6047,Rosa,2,Private room,55,173,1.52,228
6048,Rachael,2,Entire home/apt,380,62,0.12,442
6049,Tanya,2,Entire home/apt,120,11,1.82,131
6052,Lia,2,Entire home/apt,103,211,0.09,314
6053,Sol & Izak,3,Entire home/apt,64,234,3.47,298
6054,Amanda,1,Entire home/apt,195,0,0.05,195
6055,Sue,1,Shared room,70,309,2.61,379
6056,Patwell,1,Entire home/apt,150,0,0.78,150
6059,Patwell,2,Private room,150,292,0.54,442
6060,Kristin,1,Private room,105,362,1.79,467
6061,Jackie,1,Entire home/apt,360,128,0.5,488
6062,Gerald,1,Private room,165,363,0.12,528
6063,Jessica,1,Entire home/apt,325,0,0.34,325
6064,Campbell,1,Private room,105,191,0.19,296
6066,Alex,1,Private room,100,200,0.61,300
6067,Ettrick,2,Entire home/apt,129,285,3.14,414
6068,James,1,Entire home/apt,229,332,0.75,561
6069,Melissa,2,Private room,64,0,0.28,64
6070,Irena,2,Entire home/apt,100,0,0.08,100
6071,Ofer,1,Entire home/apt,99,52,0.38,151
6072,Amy,1,Entire home/apt,300,310,0.07,610
6073,Tanda,2,Private room,84,87,0.2,171
6074,Ran,2,Entire home/apt,125,0,0.11,125
6076,Ceyda,1,Entire home/apt,200,0,0.16,200
6078,Michael,1,Entire home/apt,80,180,0.09,260
6079,Lisa,1,Private room,180,0,0.47,180
6080,Gary,4,Entire home/apt,105,52,0.48,157
6082,Victoria,2,Entire home/apt,100,363,0.11,463
6083,Verena,3,Entire home/apt,90,189,0.2,279
6084,Ariel,1,Entire home/apt,160,0,0.14,160
6085,Peter,2,Entire home/apt,250,315,1.87,565
6086,Loryn,1,Entire home/apt,115,50,1.51,165
6088,Lane,1,Entire home/apt,130,0,0.16,130
6089,Michael,1,Private room,159,54,3.19,213
6090,Jan,2,Entire home/apt,110,268,3.4,378
6091,Gabriel,2,Private room,60,0,0.09,60
6092,Veralisa,4,Private room,57,311,0.43,368
6093,Sarah Jazmine,2,Entire home/apt,180,0,0.12,180
6094,Veronica,2,Entire home/apt,250,165,0.07,415
6095,Charlene,1,Private room,92,115,0.94,207
6096,Stéphane,1,Entire home/apt,195,0,1.24,195
6097,Pat,4,Private room,47,262,1.81,309
6098,Cynthia,1,Entire home/apt,175,0,0.05,175
6100,Kim,1,Entire home/apt,165,0,0.16,165
6101,Terrance,2,Private room,79,336,0.62,415
6102,SabinaAndTahir,1,Entire home/apt,345,13,1.7,358
6103,Michael,2,Private room,80,4,1.93,84
6104,Elizabeth,1,Entire home/apt,300,204,2.56,504
6107,S,1,Entire home/apt,699,254,3.27,953
6108,Monica,4,Private room,25,219,0.17,244
6109,Catia,1,Entire home/apt,195,203,2.94,398
6110,Iryna,1,Entire home/apt,165,277,2.6,442
6111,Curtis,1,Private room,65,35,3.88,100
6113,Tiffany,1,Entire home/apt,149,329,0.5,478
6114,Rodney,3,Entire home/apt,225,0,0.02,225
6116,Richard,1,Entire home/apt,495,129,2.83,624
6117,Jane,1,Entire home/apt,200,0,0.41,200
6118,Sheila,2,Entire home/apt,125,69,0.44,194
6119,Raoul,3,Entire home/apt,95,271,0.81,366
6120,Sheila,2,Entire home/apt,135,89,0.27,224
6121,Melanie,2,Entire home/apt,120,157,0.08,277
6122,Katharine,2,Entire home/apt,160,36,0.02,196
6124,Elli,2,Private room,139,36,0.12,175
6125,Christie,1,Private room,69,240,0.19,309
6126,Natasha,2,Private room,100,7,0.04,107
6127,Fallon,1,Private room,71,6,3.72,77
6128,Niraj,1,Private room,250,365,0.08,615
6129,Sarah,2,Private room,70,0,0.29,70
6131,Sabir,1,Entire home/apt,170,0,0.04,170
6132,Petal,2,Entire home/apt,125,161,0.05,286
6133,Su-Ling,2,Entire home/apt,139,218,4.15,357
6135,Susan,1,Entire home/apt,199,0,0.35,199
6136,Chris,1,Entire home/apt,175,0,0.04,175
6137,Santiago,2,Entire home/apt,120,0,0.05,120
6138,Denis,1,Private room,100,0,0.04,100
6140,David,2,Entire home/apt,100,0,0.25,100
6141,Duane,1,Entire home/apt,130,0,0.15,130
6143,Danielle,2,Private room,50,0,0.04,50
6144,Ruth,2,Private room,80,0,0.19,80
6146,Tanya,2,Entire home/apt,227,362,0.31,589
6147,Patricia,1,Entire home/apt,300,288,1.65,588
6148,Josh,1,Entire home/apt,130,2,0.37,132
6149,Aneela,1,Entire home/apt,225,179,0.31,404
6150,Rahul,1,Entire home/apt,149,0,0.02,149
6152,Shelby,1,Private room,75,0,0.2,75
6153,Julia,2,Entire home/apt,115,183,0.11,298
6154,Mattan,1,Private room,97,0,1.15,97
6156,Stefani,1,Entire home/apt,275,0,0.45,275
6157,Barbara,2,Entire home/apt,163,132,1.38,295
6158,Carol,4,Private room,55,338,0.53,393
6159,Iyabo,2,Private room,75,0,0.04,75
6161,Philip,1,Entire home/apt,247,173,0.41,420
6163,Jeremy,1,Private room,69,365,0.47,434
6164,Host,1,Entire home/apt,150,339,0.15,489
6165,Host,1,Entire home/apt,140,344,0.17,484
6166,Joseph,1,Entire home/apt,205,0,0.13,205
6167,Manuel,1,Entire home/apt,148,207,0.63,355
6168,Raj,1,Private room,299,88,0.64,387
6169,Douglas,1,Private room,49,0,0.05,49
6170,Heather,1,Entire home/apt,150,244,0.03,394
6172,Deacon,2,Private room,80,342,0.34,422
6173,Amaya,2,Private room,68,83,1.47,151
6174,Amaya,2,Private room,72,322,1.65,394
6175,Eddie&Vlad,1,Private room,97,83,2.59,180
6176,Gazelle,3,Entire home/apt,170,178,1.51,348
6177,Michael,1,Entire home/apt,67,251,0.14,318
6178,Alex,3,Entire home/apt,80,0,0.05,80
6180,Sara,1,Private room,120,295,1.27,415
6182,Victoria,1,Private room,250,336,0.35,586
6183,Shirley,1,Private room,200,336,2.15,536
6187,Victoria,1,Entire home/apt,180,0,0.05,180
6188,Ashley,2,Private room,53,137,2.11,190
6189,Devon,2,Entire home/apt,200,0,0.12,200
6190,Michael,1,Entire home/apt,66,330,0.14,396
6193,Omer,2,Entire home/apt,165,158,0.27,323
6194,Oliver,2,Private room,45,245,5.9,290
6195,Luke,1,Entire home/apt,80,35,2.68,115
6196,Jacob,2,Private room,125,0,0.07,125
6197,Liana,2,Private room,90,0,0.07,90
6198,Eddie,3,Entire home/apt,40,10,0.94,50
6200,Petya,3,Private room,39,310,0.04,349
6201,Laura,2,Entire home/apt,125,0,0.04,125
6202,Gregory,1,Private room,85,343,0.38,428
6203,Shahana,2,Private room,39,26,2.32,65
6204,Shira,1,Entire home/apt,150,12,0.41,162
6205,Wendy,3,Entire home/apt,100,83,0.38,183
6207,Lauren,1,Entire home/apt,99,0,0.33,99
6208,DeeDee,2,Entire home/apt,167,0,0.12,167
6211,Shari,2,Entire home/apt,109,221,0.44,330
6212,Deniz,3,Entire home/apt,127,0,0.25,127
6213,Kaveh,1,Entire home/apt,220,293,0.5,513
6214,James,2,Private room,45,339,0.96,384
6215,Joshua,1,Private room,75,321,0.44,396
6216,Michelle,2,Entire home/apt,120,0,0.02,120
6218,Alison,1,Entire home/apt,120,0,0.62,120
6219,Ash,1,Entire home/apt,108,0,0.07,108
6220,Cesar,2,Entire home/apt,200,0,0.05,200
6221,Agata,1,Shared room,55,336,1.4,391
6222,Genine,1,Private room,205,364,0.05,569
6224,Kimia,1,Entire home/apt,150,263,1.33,413
6226,Angela,3,Private room,65,341,6.31,406
6227,Melinda,3,Entire home/apt,150,38,0.89,188
6228,Angela,3,Private room,65,312,7.53,377
6229,Fatou,2,Private room,75,340,1.4,415
6230,Fatou,2,Private room,85,325,0.67,410
6231,Charles,2,Private room,58,217,3.8,275
6232,Charles,2,Private room,90,229,3.81,319
6233,Yarimar,2,Entire home/apt,120,0,0.03,120
6234,Ilana,2,Entire home/apt,115,0,0.06,115
6236,Mike,3,Entire home/apt,105,277,0.27,382
6237,Janine Renee,1,Private room,69,213,0.27,282
6239,Sara,3,Entire home/apt,125,2,0.5,127
6240,Anna,1,Entire home/apt,90,249,0.15,339
6242,Johnny,1,Private room,125,271,3.33,396
6243,Peter,1,Entire home/apt,215,24,1.57,239
6244,Marcello,1,Entire home/apt,107,310,3.42,417
6245,David,1,Private room,89,16,1.86,105
6246,Sebastian,1,Entire home/apt,175,0,1.59,175
6249,Ole,1,Entire home/apt,450,0,0.23,450
6251,Marisa,3,Entire home/apt,98,306,0.67,404
6252,Shahana,2,Private room,39,0,1.57,39
6253,Yonatan,1,Entire home/apt,160,0,0.43,160
6255,T.,1,Entire home/apt,299,210,1.15,509
6256,Simon,2,Private room,75,0,0.14,75
6257,Matt,2,Private room,99,0,0.02,99
6258,Harmony And Eric,1,Entire home/apt,165,0,0.73,165
6259,Yiyi,1,Entire home/apt,145,0,0.21,145
6260,Ivan,1,Entire home/apt,239,1,2.63,240
6261,Crysdian,1,Private room,76,352,1.37,428
6263,Yohan,1,Private room,60,312,0.04,372
6264,Carmen,2,Entire home/apt,50,18,2.02,68
6265,Marycatherine,2,Entire home/apt,250,266,0.49,516
6266,María,2,Entire home/apt,140,0,0.2,140
6267,LeeAnne,1,Entire home/apt,125,0,0.09,125
6272,Josh,2,Entire home/apt,150,246,1.77,396
6273,Julia,2,Entire home/apt,220,143,1.62,363
6274,Tom,1,Entire home/apt,180,0,0.33,180
6275,Iryna,1,Entire home/apt,260,283,2.74,543
6277,Kathy,1,Entire home/apt,1500,358,0.43,1858
6278,Bev,2,Private room,50,260,3.21,310
6279,Katie,1,Entire home/apt,400,0,0.02,400
6281,Adrienne,1,Entire home/apt,225,173,0.13,398
6282,Liat,2,Entire home/apt,100,0,0.05,100
6284,Tysha,2,Private room,110,46,2.06,156
6285,Courtney,2,Private room,95,0,0.14,95
6286,Scott & Ellyn,1,Entire home/apt,150,258,0.76,408
6287,Chelsea,3,Entire home/apt,100,124,0.38,224
6288,Melissa,2,Entire home/apt,69,3,0.83,72
6289,Elem,1,Entire home/apt,110,332,0.27,442
6291,Joshua,3,Private room,44,88,0.83,132
6292,Kumar,1,Entire home/apt,155,238,4.4,393
6293,Mor,1,Entire home/apt,300,331,0.19,631
6294,Nicole,1,Private room,67,0,0.05,67
6295,Laura,2,Entire home/apt,175,0,0.04,175
6296,Sean,2,Entire home/apt,149,0,0.39,149
6298,Luis&Victor,2,Private room,75,74,4.44,149
6300,Suzanne,2,Private room,100,339,1.08,439
6301,Kurt,1,Entire home/apt,129,193,0.37,322
6302,Maggie,2,Entire home/apt,150,0,0.02,150
6303,Cecily,1,Entire home/apt,219,0,0.02,219
6304,Sam,1,Entire home/apt,185,0,0.38,185
6305,Angela,3,Private room,65,0,0.38,65
6306,Audrey,2,Private room,55,312,1.75,367
6308,Meghan,1,Entire home/apt,170,0,0.11,170
6312,Oscar,1,Entire home/apt,150,0,0.42,150
6313,Benjamin,2,Entire home/apt,172,328,0.09,500
6314,Teena,1,Private room,79,0,0.1,79
6315,Katarina,1,Entire home/apt,100,105,0.09,205
6316,Pat,1,Entire home/apt,272,277,0.13,549
6317,Veronica,1,Private room,85,6,1.03,91
6319,Helene,1,Entire home/apt,249,0,0.03,249
6320,Simone,2,Entire home/apt,180,208,0.39,388
6323,Lakshmi,1,Private room,60,0,0.09,60
6325,Marlon,2,Private room,85,0,0.02,85
6327,Maria,1,Entire home/apt,260,16,0.98,276
6328,Host,1,Entire home/apt,140,332,0.13,472
6329,Host,1,Entire home/apt,185,1,0.1,186
6330,Meredith,2,Entire home/apt,126,7,0.78,133
6331,Rose,1,Entire home/apt,399,109,2.24,508
6332,Natalia,1,Entire home/apt,100,0,0.11,100
6334,Amanda,2,Entire home/apt,225,44,0.05,269
6335,Romy,2,Entire home/apt,85,0,0.07,85
6336,Millie,1,Entire home/apt,147,154,0.92,301
6337,Kindra,1,Private room,90,146,0.23,236
6338,Jason,2,Entire home/apt,500,362,0.02,862
6339,Terrance,2,Private room,72,334,0.66,406
6340,Artem,2,Private room,41,0,0.37,41
6341,Masha,2,Entire home/apt,180,0,1.92,180
6342,Rene,3,Private room,67,0,0.07,67
6343,Mike,2,Entire home/apt,122,256,0.87,378
6344,Alex,1,Entire home/apt,105,0,0.52,105
6345,Shawn,2,Private room,95,364,0.04,459
6346,Monica,3,Entire home/apt,100,0,0.02,100
6347,Benjamin,2,Entire home/apt,130,312,0.07,442
6348,Alexander,1,Private room,107,157,1.64,264
6349,Petya,1,Private room,100,364,0.24,464
6350,Natasha,4,Private room,85,342,0.18,427
6351,Bogna,3,Private room,30,0,0.04,30
6352,Juan Carlos,1,Entire home/apt,175,0,1.04,175
6354,Kate,1,Entire home/apt,125,0,0.15,125
6355,Bogna,3,Private room,35,0,0.16,35
6356,Zena,3,Entire home/apt,119,319,0.46,438
6357,Vadim,3,Entire home/apt,150,133,2.71,283
6358,Pénélope,2,Private room,55,0,0.13,55
6359,Jay,2,Entire home/apt,115,108,4.07,223
6360,Chris,2,Private room,99,306,0.25,405
6362,Alex,1,Private room,84,147,0.68,231
6363,S Barn,1,Private room,129,176,0.27,305
6364,Andy & Friends,2,Private room,44,0,1.67,44
6366,Franklin,2,Entire home/apt,100,0,0.27,100
6367,Andrey,1,Private room,65,45,2.88,110
6368,Eddie,3,Private room,99,365,0.23,464
6369,Alexis,1,Entire home/apt,100,0,0.04,100
6370,Annika,1,Entire home/apt,225,0,0.24,225
6371,Jonathan,2,Entire home/apt,120,196,0.41,316
6372,Itai,1,Entire home/apt,139,0,0.11,139
6373,AFI Apartments,1,Entire home/apt,142,321,0.09,463
6374,Simsim,1,Entire home/apt,140,0,0.65,140
6375,Joni,2,Entire home/apt,130,64,4.84,194
6376,M David,1,Entire home/apt,325,330,1.15,655
6377,Lee,1,Entire home/apt,350,0,0.21,350
6378,Johnny,2,Entire home/apt,175,0,0.12,175
6379,Matthew & Marilyn,1,Private room,89,286,1.06,375
6380,Katja,2,Entire home/apt,69,48,3.25,117
6381,Andres Mekos,2,Private room,40,0,0.21,40
6382,Tara,1,Shared room,65,0,0.38,65
6383,Lia,1,Entire home/apt,160,43,0.37,203
6384,Emily And Joel,2,Private room,135,0,1.6,135
6385,John,1,Entire home/apt,109,7,1.13,116
6386,Saskia,2,Private room,85,0,0.05,85
6387,Max,1,Entire home/apt,189,191,0.48,380
6388,Anthony,2,Entire home/apt,125,19,2.42,144
6389,Eva,1,Private room,140,0,0.02,140
6390,David,2,Entire home/apt,160,0,0.07,160
6391,Rebecca,2,Entire home/apt,115,0,0.08,115
6392,Elizabeth,1,Entire home/apt,80,68,0.56,148
6393,Dan & Michelle,2,Entire home/apt,198,0,0.13,198
6395,Oksana,1,Entire home/apt,230,353,0.84,583
6396,Patricia,1,Entire home/apt,450,303,1.48,753
6397,Re,1,Entire home/apt,895,365,1.18,1260
6398,Kali,1,Entire home/apt,170,0,0.11,170
6399,Joshua,3,Private room,120,0,0.33,120
6400,Megan,2,Entire home/apt,140,0,0.33,140
6401,Taya,2,Private room,70,128,0.35,198
6402,Jason & Agnes,1,Private room,70,243,2.19,313
6403,Yohan,1,Private room,45,311,0.08,356
6404,William,2,Private room,140,0,2.88,140
6405,Darren,1,Entire home/apt,600,0,0.11,600
6407,Deborah,1,Private room,79,0,0.02,79
6408,Olga,1,Entire home/apt,55,0,0.05,55
6409,Bill,1,Entire home/apt,275,258,0.79,533
6410,Meagan,3,Private room,60,0,0.04,60
6411,Julien,3,Entire home/apt,195,248,1.69,443
6412,Yohan,1,Private room,50,330,0.11,380
6413,Marie-Claire,1,Entire home/apt,125,346,0.83,471
6414,Nychele,4,Entire home/apt,145,0,0.02,145
6415,Elem,1,Entire home/apt,99,341,0.31,440
6416,Hillary,2,Entire home/apt,130,0,0.16,130
6417,Andre,1,Entire home/apt,115,0,0.16,115
6418,Waundell,4,Private room,60,355,1.09,415
6419,Jon,1,Entire home/apt,199,162,1.93,361
6420,Michelle,2,Entire home/apt,170,0,0.4,170
6421,Avi,1,Entire home/apt,385,365,0.02,750
6423,Luis Enrique,2,Private room,37,333,0.11,370
6424,Mariela,1,Entire home/apt,80,0,0.1,80
6425,Maireni,2,Private room,65,292,3.99,357
6428,Elia,1,Private room,56,0,0.14,56
6429,Marie,1,Private room,70,0,0.13,70
6430,Ceci,3,Entire home/apt,105,141,0.17,246
6431,William Hakan,1,Private room,70,129,1.31,199
6434,Valmik,1,Entire home/apt,150,0,0.05,150
6435,Tracy,1,Private room,112,157,0.78,269
6437,Faye,2,Entire home/apt,80,187,0.11,267
6438,Elem,1,Entire home/apt,99,332,0.11,431
6439,Darren,1,Entire home/apt,110,0,0.2,110
6440,Lisah,2,Private room,70,68,2.47,138
6441,Meghan,2,Entire home/apt,140,0,0.03,140
6442,Chris,2,Private room,46,0,0.05,46
6443,Michelle,1,Entire home/apt,180,0,0.05,180
6444,Daniel,2,Entire home/apt,250,209,3.32,459
6445,Caitlin,2,Private room,75,294,0.81,369
6446,Guillermo,1,Entire home/apt,250,102,0.61,352
6447,Emily,1,Entire home/apt,250,0,0.04,250
6448,Julissa,1,Private room,60,0,0.05,60
6449,Cole,1,Private room,95,331,0.18,426
6450,Danny,1,Entire home/apt,138,0,0.09,138
6451,Brian,2,Entire home/apt,550,220,0.08,770
6455,Jen,2,Entire home/apt,145,0,0.02,145
6456,Aaron,2,Entire home/apt,100,0,0.27,100
6457,Trey,2,Entire home/apt,119,0,0.36,119
6459,Tuva,2,Private room,48,0,0.02,48
6461,Mike,1,Entire home/apt,200,363,0.55,563
6462,Elia,1,Private room,64,0,1.05,64
6463,Rocco,1,Private room,120,89,0.46,209
6464,Heather,2,Private room,50,0,0.42,50
6465,Stephanie,2,Entire home/apt,190,0,0.87,190
6466,Pete & Laurie,1,Entire home/apt,235,0,0.16,235
6467,Joshua,3,Private room,70,285,1.38,355
6468,Sara,1,Shared room,60,0,0.08,60
6469,Bb,1,Private room,90,0,0.02,90
6470,Aditi,1,Private room,125,0,0.02,125
6471,Felipe,2,Entire home/apt,120,8,0.16,128
6472,Melissa,2,Private room,55,157,0.44,212
6474,Mauricio,1,Private room,150,0,0.02,150
6475,Sachin,1,Entire home/apt,175,280,0.8,455
6477,Osvaldo,2,Entire home/apt,112,0,0.18,112
6478,Christopher,1,Entire home/apt,200,0,0.05,200
6479,Ioanna,3,Shared room,105,364,0.54,469
6480,Caylah,2,Private room,70,0,0.05,70
6481,Ashley,1,Private room,115,0,0.02,115
6482,Elem,1,Entire home/apt,99,225,0.15,324
6483,Joseph,1,Entire home/apt,120,4,2.39,124
6485,Ian,2,Private room,90,363,0.16,453
6486,Vanessa,2,Entire home/apt,70,0,0.33,70
6487,Yety,2,Private room,52,0,0.02,52
6488,Vadim,3,Entire home/apt,150,187,1.34,337
6489,Eddie,1,Entire home/apt,170,7,1.71,177
6490,Henrique,2,Entire home/apt,132,0,0.16,132
6491,Emelie,2,Entire home/apt,90,0,0.22,90
6492,Danny,2,Entire home/apt,525,365,0.5,890
6493,Max,1,Entire home/apt,249,0,1.25,249
6494,Adam,1,Entire home/apt,160,0,0.11,160
6495,Leesa,1,Entire home/apt,125,266,2.55,391
6499,Anna,1,Entire home/apt,150,213,0.59,363
6501,Ani,1,Entire home/apt,1000,353,1.7,1353
6503,Lauren,2,Private room,50,0,0.29,50
6504,Jennifer,1,Entire home/apt,250,0,0.05,250
6505,Nadine,2,Private room,40,0,0.02,40
6507,Naomi,2,Entire home/apt,82,0,0.02,82
6508,Jane,1,Entire home/apt,93,271,0.29,364
6509,Sacha,2,Entire home/apt,100,0,0.15,100
6511,Yaroslav,1,Entire home/apt,1000,19,0.25,1019
6512,Yana,2,Private room,65,128,0.24,193
6513,Adam,2,Entire home/apt,250,204,5.0,454
6514,Kirac,1,Entire home/apt,130,0,0.08,130
6516,Bohdana,2,Private room,37,6,0.2,43
6518,Sarah,2,Private room,33,0,0.19,33
6521,Emilia,2,Private room,69,98,0.09,167
6523,Charles,2,Entire home/apt,109,0,0.38,109
6524,Belle,2,Entire home/apt,200,21,0.1,221
6525,John,1,Private room,95,0,0.08,95
6527,Umberto,1,Private room,50,0,0.02,50
6528,Christopher,3,Private room,60,364,1.3,424
6529,Nima,2,Private room,44,0,0.05,44
6530,Olson,1,Entire home/apt,9999,0,0.02,9999
6533,Carol Gloria,4,Entire home/apt,110,325,0.49,435
6534,Tessa,1,Private room,65,0,0.02,65
6535,Juan-Pablo,2,Entire home/apt,85,0,0.26,85
6536,Amanda,2,Entire home/apt,175,88,0.34,263
6537,Don,2,Entire home/apt,93,325,0.99,418
6538,Mindy (...And I'M Jeff),3,Entire home/apt,375,351,0.66,726
6539,Morgan Marie,1,Entire home/apt,100,9,3.15,109
6540,Jeffrey,1,Entire home/apt,258,320,1.1,578
6541,Daniel,2,Private room,75,0,0.39,75
6542,David,2,Entire home/apt,118,295,0.52,413
6543,Mike,1,Entire home/apt,120,0,0.07,120
6544,Stephanie,1,Entire home/apt,154,0,0.31,154
6545,Sila,2,Entire home/apt,150,0,0.02,150
6546,Michael,3,Entire home/apt,150,0,0.02,150
6547,Martina,1,Private room,145,193,1.82,338
6548,Peter,1,Entire home/apt,250,0,0.2,250
6549,Jesse,2,Entire home/apt,100,0,0.44,100
6550,Tang,1,Private room,155,37,8.21,192
6552,Hernan & Chelsea,1,Private room,75,166,4.73,241
6554,Bowie,2,Private room,50,0,0.1,50
6557,Jin,1,Private room,125,154,1.51,279
6558,Ellie,1,Entire home/apt,200,0,0.21,200
6559,Byron,1,Private room,90,235,0.3,325
6560,Byron,1,Private room,125,365,0.08,490
6564,Ben,1,Entire home/apt,199,19,0.07,218
6565,Sheena,2,Private room,89,94,2.53,183
6566,Katrina,2,Entire home/apt,298,4,0.39,302
6568,Eveline,1,Entire home/apt,110,0,0.47,110
6569,Neil,1,Entire home/apt,239,0,0.04,239
6570,Melisa,1,Entire home/apt,300,0,0.04,300
6571,Laina,2,Private room,31,0,0.02,31
6573,Shanna,2,Private room,73,0,0.02,73
6574,Nathan,1,Private room,70,12,4.65,82
6575,Nicky,2,Private room,63,290,0.2,353
6576,Mor,1,Entire home/apt,200,332,0.21,532
6577,Victoria,1,Entire home/apt,220,287,2.68,507
6578,Ame,2,Private room,95,265,2.7,360
6579,Benjamin,2,Entire home/apt,127,342,0.15,469
6583,Travis,1,Private room,50,0,0.15,50
6585,James,2,Private room,58,0,0.04,58
6586,Debbie,3,Private room,80,0,0.04,80
6587,Angie,1,Private room,73,250,0.33,323
6588,James,2,Entire home/apt,91,0,0.03,91
6589,Ela,1,Private room,100,0,0.5,100
6590,Curtis,1,Private room,52,49,3.39,101
6592,Tanya,2,Private room,70,0,0.85,70
6593,Martin & Julia,2,Entire home/apt,150,0,0.03,150
6594,Freda,3,Entire home/apt,107,261,2.07,368
6597,Yalda,2,Private room,62,0,0.11,62
6598,Freda,3,Private room,49,309,0.1,358
6599,Freda,3,Private room,50,365,0.34,415
6601,Yinny,2,Entire home/apt,129,91,0.87,220
6602,Danielle,1,Entire home/apt,198,0,1.99,198
6603,Terry,1,Entire home/apt,185,337,2.19,522
6606,Jeremy,2,Entire home/apt,130,0,0.16,130
6607,Masha,2,Private room,100,74,0.55,174
6608,Matt,2,Private room,75,0,0.02,75
6609,Mia,2,Private room,90,133,2.03,223
6610,Takako,2,Entire home/apt,110,0,0.25,110
6611,Helena S,2,Private room,65,175,0.15,240
6612,Paul,1,Private room,49,1,1.84,50
6613,Idris,1,Entire home/apt,400,363,0.77,763
6615,Troy,3,Private room,31,0,0.23,31
6616,Marc & Farnoosh,3,Private room,70,325,0.61,395
6617,Amy,1,Entire home/apt,250,0,0.48,250
6619,Alexander,1,Entire home/apt,235,0,0.25,235
6620,Indi,1,Entire home/apt,2400,365,0.05,2765
6621,Toby,1,Private room,35,0,0.04,35
6623,Gabriel,1,Private room,65,86,0.45,151
6624,Miriam,1,Entire home/apt,180,0,0.09,180
6626,Rose,2,Entire home/apt,81,287,1.06,368
6627,Megan,1,Entire home/apt,225,0,0.25,225
6628,Hollis,2,Entire home/apt,100,184,2.48,284
6629,Matthew,2,Private room,75,134,3.26,209
6630,Lika,2,Private room,85,0,0.09,85
6631,Dee J,1,Entire home/apt,99,0,0.22,99
6632,Alexandra,2,Entire home/apt,175,11,0.49,186
6634,Ryan,1,Private room,125,0,0.8,125
6635,Pierre,2,Private room,30,0,0.15,30
6636,Kim,2,Entire home/apt,165,0,0.47,165
6639,Nikolaos,1,Entire home/apt,200,0,0.04,200
6640,Panayota,1,Private room,110,0,0.02,110
6641,Matt + Allie,1,Entire home/apt,315,0,0.04,315
6642,Aram,2,Entire home/apt,148,195,0.37,343
6643,Annika,2,Entire home/apt,150,9,0.24,159
6644,Nir,1,Private room,175,0,0.77,175
6645,Roger,1,Private room,59,308,2.75,367
6646,Val,1,Entire home/apt,139,0,0.02,139
6647,Katya,2,Private room,50,98,0.92,148
6648,Simon,1,Entire home/apt,250,0,0.04,250
6653,Steven,1,Entire home/apt,105,193,0.9,298
6654,Sarah,2,Private room,75,133,0.2,208
6655,Maribel & Carolina,3,Entire home/apt,130,292,3.35,422
6656,Kevin & Yuan,2,Entire home/apt,149,305,2.62,454
6657,Eli,1,Entire home/apt,200,0,0.07,200
6658,Vida,2,Entire home/apt,149,358,0.06,507
6659,Nick,1,Private room,60,0,0.02,60
6661,Carol,4,Private room,43,336,0.3,379
6662,L & R,2,Entire home/apt,145,40,0.24,185
6663,Matthias,1,Entire home/apt,85,147,0.28,232
6664,Julia,1,Entire home/apt,275,365,0.72,640
6665,Farai,2,Private room,100,89,0.08,189
6666,Jolie,1,Entire home/apt,105,315,0.04,420
6667,Victoria,1,Entire home/apt,250,0,0.06,250
6669,Gaetano,1,Private room,175,203,4.01,378
6670,Hill,2,Entire home/apt,600,283,3.3,883
6671,Anthony,1,Private room,95,365,0.68,460
6672,Zsuzsanna,3,Entire home/apt,150,0,0.04,150
6673,Anupam,1,Entire home/apt,119,0,0.22,119
6674,Kenneth,1,Entire home/apt,165,0,0.21,165
6677,Angelina,1,Entire home/apt,80,87,0.48,167
6678,Chaz,1,Entire home/apt,149,0,0.3,149
6679,Aron,2,Entire home/apt,195,230,3.55,425
6680,David,2,Entire home/apt,130,0,0.11,130
6681,Martin,1,Entire home/apt,95,0,0.16,95
6682,Jolie,1,Entire home/apt,125,331,0.1,456
6683,Jolie,1,Entire home/apt,95,318,0.06,413
6684,Cesar,3,Private room,50,332,1.21,382
6685,Jolie,1,Entire home/apt,85,83,0.05,168
6688,Anna,2,Private room,80,335,0.04,415
6689,Joe,2,Entire home/apt,320,269,3.42,589
6691,Joshua,2,Private room,90,0,0.02,90
6692,Jolie,1,Entire home/apt,95,337,0.11,432
6693,Stephanie,1,Private room,85,193,0.15,278
6694,David,2,Private room,79,24,0.19,103
6696,Wesly/Jessica,2,Private room,54,302,2.26,356
6697,Leslie,1,Entire home/apt,129,0,0.54,129
6698,Catherine,3,Private room,90,89,0.41,179
6699,Tanda,2,Entire home/apt,254,365,0.23,619
6700,Leandro,1,Entire home/apt,159,0,0.31,159
6701,Kaori,1,Entire home/apt,90,0,0.04,90
6702,Alexandra,2,Private room,85,9,0.85,94
6703,Wendy,2,Private room,45,0,0.09,45
6704,Danny,2,Entire home/apt,275,1,0.03,276
6705,Aaron,2,Private room,38,0,0.03,38
6706,Sophia,2,Entire home/apt,100,0,0.06,100
6707,Jennifer,2,Private room,103,0,0.13,103
6708,Elem,1,Entire home/apt,99,270,0.28,369
6709,Lindsay,1,Entire home/apt,185,0,0.13,185
6711,Brian,1,Private room,86,0,0.06,86
6712,Olga,1,Private room,40,70,0.43,110
6713,Karen,3,Entire home/apt,165,163,2.1,328
6714,Isabel,1,Shared room,35,66,2.48,101
6715,Kelly,2,Entire home/apt,2000,0,0.05,2000
6718,Ainsley,2,Entire home/apt,175,0,0.25,175
6719,Daniel,2,Entire home/apt,95,0,0.02,95
6720,Micheline,1,Private room,70,0,0.14,70
6721,Golsana,2,Entire home/apt,100,3,0.33,103
6722,Chi,2,Private room,150,362,0.21,512
6723,Mel,1,Entire home/apt,169,274,2.36,443
6725,Kai,1,Private room,99,0,0.11,99
6727,Phoebe,2,Private room,70,0,0.11,70
6728,Lindsey,2,Entire home/apt,130,105,0.72,235
6730,Brian,1,Entire home/apt,180,0,0.22,180
6731,Jillian,2,Private room,80,0,0.03,80
6734,Michael,1,Entire home/apt,99,157,0.3,256
6735,Alex,2,Private room,99,88,1.15,187
6737,Adreanna,3,Entire home/apt,150,0,0.06,150
6739,T-Po,2,Private room,73,260,0.71,333
6741,Sheila,1,Private room,80,364,0.19,444
6742,Giorgi,1,Private room,80,189,0.91,269
6743,Sonam And Roommates,1,Private room,85,8,0.71,93
6745,Jun,2,Private room,100,0,0.02,100
6746,Barry,2,Private room,85,364,0.07,449
6747,Mj,1,Private room,65,80,0.22,145
6748,Herbie,1,Private room,150,0,0.02,150
6751,Lisa,1,Private room,200,0,0.02,200
6752,Milena,3,Entire home/apt,124,0,0.15,124
6754,Robert,1,Entire home/apt,50,0,0.02,50
6755,Bobby,1,Entire home/apt,160,0,0.12,160
6758,Ra-Ey,1,Entire home/apt,200,0,0.13,200
6759,Oded,2,Entire home/apt,139,0,0.8,139
6760,Ronnie,2,Private room,49,0,0.35,49
6761,Javier,2,Private room,55,0,0.24,55
6762,Sophie,1,Entire home/apt,260,31,0.08,291
6764,Raanan,1,Entire home/apt,110,280,0.18,390
6765,Brady,2,Entire home/apt,110,0,0.04,110
6766,Ari,1,Private room,81,223,2.81,304
6767,Randy,2,Entire home/apt,60,83,1.99,143
6768,Leanne,2,Private room,65,0,0.02,65
6770,Natalie,2,Entire home/apt,130,0,0.02,130
6771,Agatha,2,Entire home/apt,240,0,0.2,240
6772,Francesco,2,Entire home/apt,130,0,0.29,130
6773,Mike,1,Entire home/apt,97,365,0.12,462
6775,Greg,2,Entire home/apt,88,0,0.04,88
6776,Andy,3,Entire home/apt,112,0,0.1,112
6778,Paul,2,Entire home/apt,105,77,1.12,182
6780,Ajay,2,Entire home/apt,70,18,0.27,88
6781,Cam,2,Private room,75,0,0.1,75
6782,Nick,3,Entire home/apt,99,344,2.33,443
6785,Corina E.,1,Private room,90,341,0.46,431
6786,Christian,2,Entire home/apt,60,0,0.02,60
6787,Michelle,2,Entire home/apt,125,0,0.2,125
6788,Corinne,2,Private room,65,349,0.27,414
6789,Arikia,2,Entire home/apt,159,0,0.54,159
6790,John,1,Entire home/apt,145,0,0.06,145
6792,Kathy,1,Entire home/apt,255,352,0.92,607
6793,Shailah,1,Private room,90,85,2.95,175
6794,Hanayo,2,Entire home/apt,150,120,1.34,270
6795,Shuang,2,Entire home/apt,295,339,1.5,634
6797,Irina,1,Entire home/apt,75,31,0.11,106
6798,Quincy,2,Entire home/apt,188,75,3.47,263
6799,Logan,1,Entire home/apt,130,0,0.09,130
6800,Lenore,2,Entire home/apt,72,0,0.07,72
6801,Jessica,3,Private room,45,201,0.37,246
6802,Donna And Joaquin,2,Private room,80,272,3.11,352
6803,Forest,1,Private room,94,88,0.93,182
6804,Audrey,2,Private room,70,173,0.29,243
6805,Sibin,2,Entire home/apt,150,0,0.16,150
6806,Azza,2,Private room,70,365,0.12,435
6807,Luis Enrique,2,Private room,42,348,0.05,390
6809,Ruth,2,Private room,70,0,0.18,70
6811,Tamara,1,Entire home/apt,180,10,0.15,190
6812,Vane,1,Entire home/apt,150,0,0.08,150
6813,Leandro,1,Private room,105,266,2.03,371
6814,Nina,2,Entire home/apt,100,262,0.17,362
6815,Andrew And Clara,2,Entire home/apt,225,0,0.16,225
6817,Jonathan,3,Private room,82,58,2.1,140
6822,Faye + Amiyr,2,Entire home/apt,145,219,3.79,364
6824,Hillela,2,Private room,100,0,0.04,100
6825,Sarah,1,Entire home/apt,100,108,2.4,208
6826,Lee,2,Entire home/apt,190,5,0.16,195
6827,Brock,1,Entire home/apt,200,0,0.94,200
6828,Max,1,Entire home/apt,125,41,0.02,166
6829,Victoria,1,Entire home/apt,300,316,0.06,616
6830,Mio,1,Entire home/apt,159,267,0.83,426
6833,Yaniv And Vanessa,1,Entire home/apt,180,0,0.58,180
6834,Irena,3,Entire home/apt,99,263,0.74,362
6835,Sarah,1,Private room,120,339,0.35,459
6836,Jason,1,Private room,90,35,0.5,125
6837,Ben,2,Private room,59,0,0.04,59
6838,Nika,3,Private room,95,331,2.77,426
6839,Fidelia,2,Private room,65,312,0.2,377
6840,Sp,3,Private room,40,5,2.0,45
6841,Meghan,1,Entire home/apt,250,0,0.14,250
6842,Mabel,2,Private room,85,280,0.42,365
6843,Susan,1,Private room,71,0,0.35,71
6845,Jeremy,2,Entire home/apt,262,0,3.06,262
6847,Daniel,1,Entire home/apt,70,0,0.02,70
6848,Svjetlana,1,Entire home/apt,109,0,0.05,109
6851,Monica,3,Private room,50,341,0.17,391
6852,Francesca,1,Private room,120,318,0.15,438
6854,Alexandra,2,Entire home/apt,200,0,0.11,200
6856,Daniel,1,Entire home/apt,175,0,0.08,175
6858,Bill & Regina,3,Entire home/apt,119,1,0.46,120
6859,Juliana,1,Entire home/apt,165,274,0.21,439
6860,Jacqueline,4,Private room,40,322,0.13,362
6861,Juliana,1,Entire home/apt,265,274,0.26,539
6862,Juliana,1,Entire home/apt,130,292,0.23,422
6863,Mariano,2,Entire home/apt,85,351,0.08,436
6864,Dana,2,Private room,70,314,0.02,384
6865,Owen,2,Entire home/apt,210,0,0.57,210
6867,Ruth,2,Private room,46,333,0.15,379
6869,Jessica,2,Entire home/apt,126,180,1.95,306
6870,Dave,2,Private room,88,261,0.82,349
6871,Antoinette,1,Entire home/apt,150,66,0.26,216
6872,Dennis,2,Entire home/apt,175,0,1.77,175
6873,Elem,1,Entire home/apt,380,332,0.11,712
6874,Charles,2,Entire home/apt,500,89,0.53,589
6875,John,1,Private room,110,0,0.25,110
6876,Arnell,1,Entire home/apt,175,0,0.02,175
6877,Justin,1,Private room,78,0,0.02,78
6878,Damien,1,Entire home/apt,250,358,0.21,608
6879,Evan,1,Entire home/apt,125,121,4.63,246
6880,Jamaal,2,Entire home/apt,200,16,0.1,216
6882,Natasha,2,Private room,65,280,0.17,345
6884,Juliana,1,Entire home/apt,205,274,0.38,479
6886,Richard,2,Private room,100,342,4.16,442
6887,Marlon,2,Private room,60,232,0.6,292
6888,Kyle,1,Private room,99,0,5.78,99
6889,Loydeen,1,Private room,50,151,0.5,201
6890,Marlon,2,Private room,50,329,0.72,379
6891,Fatou,2,Private room,68,329,1.78,397
6892,Adam,1,Entire home/apt,125,188,0.57,313
6893,Pete,1,Entire home/apt,175,0,0.02,175
6894,Ron,2,Entire home/apt,100,160,2.0,260
6896,Krystle,1,Entire home/apt,125,0,0.15,125
6897,Mariana,2,Private room,118,188,0.02,306
6898,Stacey,1,Entire home/apt,346,0,2.96,346
6899,Alanna,2,Private room,52,0,0.37,52
6900,Jason,3,Entire home/apt,107,311,0.29,418
6901,Zahid,1,Entire home/apt,99,46,3.1,145
6902,Dominik,1,Entire home/apt,150,264,0.36,414
6903,Gary,2,Private room,65,6,3.37,71
6904,Joel,1,Entire home/apt,85,7,0.11,92
6905,Christopher,1,Entire home/apt,155,0,0.19,155
6906,Alexandra,2,Entire home/apt,125,0,0.64,125
6907,Umut&Deniz,1,Private room,59,349,0.8,408
6908,Michael,3,Private room,70,90,1.18,160
6911,Vivienne,1,Entire home/apt,149,0,0.28,149
6913,Margrethe,2,Entire home/apt,190,265,0.6,455
6914,Lior,1,Entire home/apt,80,346,0.15,426
6916,James & Shaun,1,Private room,89,162,3.89,251
6917,Andreias,1,Private room,123,253,3.39,376
6918,Sasha,1,Private room,78,0,3.43,78
6919,Rivka,2,Private room,62,77,1.26,139
6920,Nick,2,Entire home/apt,120,0,2.76,120
6921,Emmanuel,3,Entire home/apt,80,108,4.69,188
6922,Solomon,1,Entire home/apt,180,36,0.81,216
6923,Amy,2,Entire home/apt,145,109,4.15,254
6924,Andreias,1,Private room,99,294,5.44,393
6925,Sameer,1,Entire home/apt,300,168,1.12,468
6926,Michael,1,Entire home/apt,87,7,0.1,94
6927,Vie,4,Entire home/apt,155,348,0.29,503
6928,Vie,4,Entire home/apt,250,357,1.08,607
6929,Alix,1,Private room,130,0,0.17,130
6930,Mizo,3,Shared room,65,1,0.11,66
6931,Chris,1,Entire home/apt,156,0,0.08,156
6932,Cindy,4,Private room,50,0,0.04,50
6935,Leecia,2,Entire home/apt,95,194,1.19,289
6936,Jorge,3,Private room,45,115,0.56,160
6937,Fernando,3,Shared room,60,0,0.87,60
6938,Anthony,1,Private room,100,162,2.44,262
6940,Marco,1,Private room,84,11,2.06,95
6941,Tonia,5,Entire home/apt,70,231,3.63,301
6942,Umut&Deniz,1,Private room,69,331,1.49,400
6943,Leah,2,Private room,62,319,0.06,381
6944,Brian,1,Entire home/apt,200,0,0.02,200
6945,Justin,2,Entire home/apt,100,0,0.08,100
6946,Lawrence,2,Private room,45,323,0.66,368
6947,Richard,1,Entire home/apt,170,316,1.0,486
6948,Lam,1,Entire home/apt,150,68,0.18,218
6949,Linden,3,Entire home/apt,99,189,1.29,288
6951,Lucie,1,Private room,95,117,1.38,212
6952,Citlali,2,Private room,95,0,0.02,95
6953,James,2,Private room,79,339,0.72,418
6954,Marc-Antoine,2,Entire home/apt,120,0,0.18,120
6955,Lora,1,Entire home/apt,375,147,0.59,522
6956,Ely,1,Entire home/apt,120,151,1.25,271
6958,Lilia,3,Private room,100,338,0.91,438
6959,Marco,1,Private room,84,8,2.06,92
6960,Lena,1,Entire home/apt,549,6,0.33,555
6961,Dan,2,Entire home/apt,230,5,0.24,235
6962,Margot,2,Private room,100,0,0.02,100
6963,Jin,2,Private room,70,47,4.45,117
6964,Sonia,3,Entire home/apt,72,10,0.71,82
6965,Ellen!,1,Private room,140,0,0.05,140
6967,Jack,1,Entire home/apt,135,287,3.21,422
6968,David,1,Entire home/apt,120,0,0.18,120
6969,Sayaka,2,Private room,49,25,0.82,74
6970,Nicole,2,Entire home/apt,240,238,0.43,478
6972,Yas,1,Entire home/apt,150,364,0.24,514
6973,Dong Ming,3,Private room,89,365,0.06,454
6974,Yas,1,Private room,100,364,0.55,464
6975,Megan,2,Private room,75,0,0.52,75
6976,Tommy,3,Private room,50,310,0.47,360
6977,Shula,2,Private room,60,322,0.5,382
6978,Fiona,1,Entire home/apt,760,292,0.04,1052
6979,Wesley William,2,Private room,85,82,0.57,167
6980,Viva,3,Private room,65,0,0.09,65
6981,Daniel,1,Entire home/apt,150,234,1.44,384
6982,Tom,1,Entire home/apt,169,310,2.76,479
6983,Jeremy,1,Entire home/apt,85,58,0.52,143
6984,Sol,1,Entire home/apt,350,69,0.36,419
6985,David,2,Entire home/apt,148,44,1.05,192
6986,David,2,Entire home/apt,100,0,0.26,100
6989,Mateo,2,Entire home/apt,80,0,0.22,80
6990,Jia,3,Entire home/apt,72,102,3.4,174
6991,Nicole,2,Private room,125,191,0.16,316
6992,Sophie,3,Private room,34,175,2.37,209
6993,Alex,2,Entire home/apt,288,0,0.05,288
6994,Jay,2,Entire home/apt,167,0,1.2,167
6995,Jordana,1,Entire home/apt,125,176,0.86,301
6996,Kyala,2,Entire home/apt,100,153,1.27,253
6998,Andy And TJ,1,Entire home/apt,229,61,0.12,290
6999,Katherine,2,Private room,100,149,0.9,249
7001,Bethany,2,Entire home/apt,225,275,1.63,500
7003,S.,2,Entire home/apt,174,269,3.7,443
7005,Juliana,1,Entire home/apt,250,304,0.25,554
7006,Juliana,1,Entire home/apt,105,285,0.31,390
7007,Jorge,3,Private room,40,336,1.75,376
7008,Jacqueline,2,Private room,50,313,0.8,363
7009,Pia,1,Private room,65,35,0.81,100
7010,Michelle,1,Private room,75,330,0.45,405
7011,Tarun,2,Entire home/apt,180,0,0.02,180
7013,Sonia,1,Private room,69,7,0.64,76
7014,Dor,1,Private room,150,294,0.71,444
7016,Sal,1,Entire home/apt,125,7,0.4,132
7017,David,1,Entire home/apt,795,249,0.42,1044
7018,Buddy,4,Entire home/apt,450,342,0.84,792
7020,Nick,2,Entire home/apt,300,0,0.22,300
7021,Laksen & Nikki,1,Shared room,80,357,0.62,437
7023,Howard,1,Private room,500,0,0.02,500
7024,Jane,1,Private room,135,332,0.28,467
7026,Alexa,1,Private room,80,238,2.9,318
7027,Will,2,Entire home/apt,85,0,0.42,85
7028,Lisa,2,Entire home/apt,150,273,2.23,423
7029,Karron,2,Private room,60,19,2.75,79
7030,Michael,1,Entire home/apt,249,158,1.59,407
7031,Juliana,1,Entire home/apt,155,316,0.32,471
7032,Helena S,2,Private room,65,0,0.27,65
7034,Brian,1,Entire home/apt,150,0,0.5,150
7035,Lauren & Chelsea,2,Private room,96,44,3.27,140
7037,William,1,Private room,89,365,0.03,454
7038,Javier,1,Private room,80,54,5.66,134
7039,Jorge,1,Private room,77,66,1.57,143
7040,Fiorella,2,Private room,60,170,3.39,230
7041,Marta,1,Entire home/apt,165,0,1.35,165
7042,Andrew,2,Private room,70,363,0.06,433
7045,Gregory,1,Entire home/apt,139,240,1.15,379
7046,Nina,2,Private room,50,227,0.33,277
7049,Scott,1,Entire home/apt,250,96,0.51,346
7050,Rod,1,Private room,177,213,0.51,390
7051,Andrew,1,Entire home/apt,150,0,0.13,150
7053,Pao,3,Entire home/apt,90,332,0.28,422
7054,Laura,2,Private room,150,179,0.03,329
7055,Dim,1,Entire home/apt,125,230,3.95,355
7057,Orli,2,Entire home/apt,415,0,0.06,415
7058,Stephanie & Linda,2,Private room,50,245,0.77,295
7059,Juliana,1,Entire home/apt,165,326,0.31,491
7060,Mahesh,1,Entire home/apt,175,7,0.55,182
7063,Nancy,1,Entire home/apt,100,0,0.02,100
7064,Elem,1,Entire home/apt,99,208,0.29,307
7065,Claude,3,Private room,80,59,0.35,139
7066,Matthew,2,Entire home/apt,140,0,0.08,140
7067,Neal,1,Private room,83,0,0.66,83
7068,Inez,3,Private room,99,7,0.08,106
7069,Jamie,2,Private room,79,89,0.09,168
7070,Adam,2,Private room,100,34,0.61,134
7071,Jen,2,Entire home/apt,160,0,0.3,160
7072,Alec,2,Private room,45,0,0.02,45
7073,William,2,Entire home/apt,225,0,1.27,225
7075,Shamim,2,Entire home/apt,90,0,0.07,90
7077,William,3,Entire home/apt,120,64,0.64,184
7078,Gore,1,Entire home/apt,150,5,0.41,155
7079,Nowme And Ra,2,Entire home/apt,80,306,0.97,386
7080,Erin,1,Entire home/apt,275,0,0.21,275
7081,Kat,3,Entire home/apt,110,177,0.69,287
7083,Cranford,1,Entire home/apt,245,0,0.06,245
7085,Carly,2,Entire home/apt,115,8,0.95,123
7086,Danielle,3,Private room,54,347,13.45,401
7087,Martha,2,Entire home/apt,195,0,0.06,195
7088,Gosia,2,Entire home/apt,995,328,0.82,1323
7089,Julia,1,Entire home/apt,120,0,0.13,120
7090,Buddy,1,Private room,135,0,1.68,135
7091,Tiba,1,Private room,150,307,0.77,457
7092,Christine,1,Private room,61,292,3.21,353
7094,Carrie,2,Private room,63,11,2.16,74
7095,Nick,1,Entire home/apt,185,27,0.4,212
7097,Forrest,2,Private room,33,282,0.37,315
7098,Robert,2,Private room,55,189,0.06,244
7099,Genesis,2,Entire home/apt,150,118,0.36,268
7100,Penelope,2,Entire home/apt,80,0,0.07,80
7102,Jinqiu,1,Private room,79,0,0.22,79
7103,Emmanuel,1,Entire home/apt,140,0,0.09,140
7104,Maggie,1,Entire home/apt,198,0,0.29,198
7106,M. Elizabeth,1,Entire home/apt,117,66,3.91,183
7107,Nadia Dara,1,Entire home/apt,125,0,0.05,125
7108,Christina,1,Entire home/apt,510,364,0.24,874
7109,Dirk,2,Entire home/apt,125,0,0.12,125
7111,Rachel,1,Private room,65,323,1.16,388
7112,David,2,Entire home/apt,195,42,0.44,237
7113,Lauren,1,Entire home/apt,115,183,0.15,298
7114,Ellen,1,Entire home/apt,135,0,0.63,135
7115,Julien,2,Entire home/apt,350,22,0.12,372
7116,Carlina,1,Private room,115,6,1.13,121
7117,Carlina,1,Private room,45,0,3.86,45
7118,Sara,2,Private room,65,0,0.43,65
7119,Serene,3,Entire home/apt,135,231,0.06,366
7122,James,1,Entire home/apt,199,215,2.21,414
7124,Maureen,1,Entire home/apt,195,329,0.11,524
7126,Mr. & Mrs. Kris,2,Entire home/apt,150,0,0.09,150
7127,Carmen,2,Private room,60,0,0.02,60
7128,Tejal,2,Private room,70,134,0.4,204
7130,Arti,2,Private room,100,10,1.06,110
7131,Alberto,1,Entire home/apt,180,0,0.06,180
7132,Amy,3,Entire home/apt,105,0,0.41,105
7133,Patricio,1,Entire home/apt,110,90,0.28,200
7134,Stat,3,Private room,38,313,0.11,351
7135,Vaida,2,Private room,70,0,0.02,70
7136,Marýa,2,Entire home/apt,72,0,0.21,72
7137,Julien,2,Private room,75,80,0.69,155
7138,Glenda,1,Private room,63,274,4.12,337
7139,Glenda,1,Private room,58,307,3.81,365
7141,Vladimir,1,Entire home/apt,145,242,1.24,387
7142,Kayla,2,Private room,45,0,0.08,45
7143,Robin Laverne,2,Private room,60,28,1.56,88
7144,Neda,1,Entire home/apt,158,290,0.04,448
7145,Catherine,2,Private room,139,0,0.06,139
7146,Nikki,2,Private room,45,52,0.38,97
7147,Elem,1,Entire home/apt,99,333,0.26,432
7148,Katherine,2,Entire home/apt,85,0,0.02,85
7149,Tara,1,Private room,85,18,0.27,103
7150,Kristen,2,Entire home/apt,95,0,0.04,95
7151,Evan,2,Entire home/apt,150,0,0.96,150
7152,Erin & Brad,2,Private room,96,289,1.58,385
7153,Alfred,1,Entire home/apt,230,0,0.02,230
7154,Alexandra,1,Entire home/apt,150,33,0.07,183
7155,Justin,1,Entire home/apt,225,0,0.04,225
7156,Louise,2,Entire home/apt,130,254,2.59,384
7158,Vanessa,1,Entire home/apt,115,0,0.02,115
7159,Amar,2,Entire home/apt,126,110,0.06,236
7160,Lisa And Jessica,2,Entire home/apt,174,15,0.32,189
7161,Eugene,1,Entire home/apt,149,0,0.24,149
7162,Harman,1,Entire home/apt,150,0,0.19,150
7163,Tom,2,Entire home/apt,100,292,0.03,392
7164,K. Zovia,5,Entire home/apt,150,299,0.33,449
7165,Tara & Carl,1,Private room,89,15,1.07,104
7166,Johnny,2,Entire home/apt,308,294,2.01,602
7168,Host,1,Entire home/apt,150,228,0.11,378
7169,Angelo,3,Private room,55,310,1.72,365
7170,Norman,1,Private room,55,0,0.52,55
7171,Jennifer,1,Entire home/apt,139,0,0.07,139
7172,Paul,3,Private room,90,365,0.55,455
7173,Douglas,1,Entire home/apt,249,159,2.91,408
7175,Erika,2,Entire home/apt,95,40,6.77,135
7176,Helena,2,Private room,135,11,1.49,146
7178,Olga,1,Entire home/apt,289,3,3.23,292
7179,Brett,2,Entire home/apt,97,345,0.88,442
7180,David,2,Entire home/apt,180,204,1.7,384
7181,Tara,1,Entire home/apt,75,4,0.67,79
7182,Francois,2,Entire home/apt,320,0,0.2,320
7183,Jeffrey,2,Private room,60,326,1.75,386
7184,Jeffrey,2,Private room,60,326,2.84,386
7185,Maggie,2,Entire home/apt,144,0,0.11,144
7189,Nicky,3,Private room,47,17,0.04,64
7191,Drew,2,Private room,100,0,0.42,100
7193,Host,1,Entire home/apt,250,365,0.06,615
7194,Anne,1,Entire home/apt,115,111,0.18,226
7195,Valentin,1,Private room,60,0,0.02,60
7196,Stephanie,1,Private room,135,241,3.69,376
7197,L & A,1,Private room,50,84,3.2,134
7198,Antal,1,Entire home/apt,149,0,0.02,149
7199,Philmore,2,Entire home/apt,120,140,1.0,260
7200,Matthew,1,Entire home/apt,150,6,0.41,156
7202,Evgenia,1,Private room,95,188,0.39,283
7203,Barrie,2,Entire home/apt,190,0,0.29,190
7204,Dawn,2,Entire home/apt,139,340,1.65,479
7206,Edna,1,Private room,130,150,0.94,280
7207,Chris,1,Private room,125,347,2.32,472
7208,Lisa,2,Private room,45,48,0.27,93
7209,Roza,1,Entire home/apt,110,0,0.15,110
7210,Rob,2,Entire home/apt,120,22,0.22,142
7211,Ali,2,Private room,50,0,0.02,50
7212,Alex,2,Entire home/apt,100,0,0.06,100
7213,Harish,2,Private room,75,0,0.27,75
7214,Vida,2,Entire home/apt,129,328,0.14,457
7215,Gabrielle,1,Entire home/apt,196,323,1.23,519
7217,Matteo,1,Entire home/apt,140,164,0.02,304
7219,Claire,2,Private room,55,0,0.1,55
7220,Clara,1,Entire home/apt,175,0,0.56,175
7221,Amy,2,Entire home/apt,90,29,0.45,119
7222,Guillaume,1,Entire home/apt,281,0,0.07,281
7223,Igor,2,Private room,50,179,1.47,229
7224,Eja,1,Shared room,65,353,0.93,418
7225,Dr.Sally,3,Private room,85,281,4.54,366
7226,Shawn(Ta),4,Private room,38,0,0.28,38
7227,Lex,1,Private room,59,330,0.29,389
7228,Janira,3,Private room,40,0,0.3,40
7229,Frank,1,Entire home/apt,229,0,0.06,229
7230,Casey,2,Entire home/apt,70,0,0.02,70
7231,Lisa E,1,Entire home/apt,190,135,2.0,325
7232,Isabel,2,Entire home/apt,150,343,2.1,493
7233,Steven,2,Private room,68,149,2.2,217
7234,Danielle,1,Private room,109,0,0.04,109
7235,Seb,1,Entire home/apt,37,82,0.06,119
7236,Lucas,1,Private room,124,62,3.21,186
7237,Ben,2,Entire home/apt,190,0,0.25,190
7238,Lina,1,Entire home/apt,160,265,3.93,425
7239,Jing,2,Entire home/apt,160,253,2.23,413
7241,Bryn,2,Private room,49,0,0.05,49
7242,Vida,2,Entire home/apt,159,362,0.21,521
7245,Nikki,1,Private room,150,364,0.16,514
7246,Hua,1,Private room,65,0,0.18,65
7247,Herman,3,Private room,50,347,0.47,397
7249,Laura,1,Entire home/apt,176,8,0.21,184
7250,Dan,2,Private room,90,0,0.02,90
7251,Kelsey,2,Entire home/apt,175,0,0.15,175
7252,Pat,1,Entire home/apt,125,0,0.04,125
7253,Eli,2,Entire home/apt,249,344,3.61,593
7254,Mike,1,Entire home/apt,87,365,0.18,452
7256,Gennaro,2,Entire home/apt,495,285,1.94,780
7257,Roy,2,Entire home/apt,120,219,0.4,339
7258,Stratos,1,Entire home/apt,110,161,0.49,271
7259,Eunice,1,Entire home/apt,159,10,0.25,169
7260,Dikla,2,Entire home/apt,189,235,3.33,424
7262,Brett,2,Private room,59,358,0.23,417
7264,Katie,1,Entire home/apt,199,0,0.03,199
7265,Alex,2,Private room,52,89,0.02,141
7266,Seth,1,Entire home/apt,199,33,1.88,232
7268,Joshua,1,Private room,54,14,0.91,68
7269,Ariel,2,Private room,49,99,1.12,148
7270,Vanessa,1,Private room,250,364,0.26,614
7271,Hardik,2,Private room,45,0,0.04,45
7272,Amy,3,Private room,50,56,4.08,106
7274,James,1,Entire home/apt,200,272,2.21,472
7275,Jakub,3,Private room,38,0,0.25,38
7276,Peter,2,Entire home/apt,300,274,1.19,574
7278,Fe,2,Private room,55,317,0.13,372
7279,Lyn,2,Private room,27,345,0.18,372
7280,Maria,1,Entire home/apt,200,0,0.03,200
7281,Elem,1,Entire home/apt,99,323,0.3,422
7282,Britta,2,Entire home/apt,80,0,0.09,80
7283,Victoria,1,Entire home/apt,250,222,4.39,472
7285,Luz & Ruben,1,Private room,59,157,0.28,216
7286,"Rossy,  Carmen And Juan",4,Private room,57,82,2.02,139
7287,Host,1,Entire home/apt,170,320,0.43,490
7288,Morgan,2,Private room,50,0,0.02,50
7289,Carl,1,Private room,49,0,0.02,49
7290,Kelvin,2,Private room,65,0,0.04,65
7291,John,1,Entire home/apt,250,266,2.07,516
7292,Shehzad,2,Entire home/apt,200,0,0.45,200
7293,Eleanor,1,Entire home/apt,110,0,0.19,110
7294,Cheri,1,Entire home/apt,250,274,0.25,524
7295,Ashley,2,Private room,73,142,4.15,215
7297,Darcy,2,Entire home/apt,125,0,0.02,125
7300,Calogero,3,Private room,36,354,1.32,390
7301,Johnny,2,Entire home/apt,99,158,1.97,257
7302,Nat,2,Entire home/apt,100,359,0.17,459
7303,Jeff,1,Private room,71,131,1.08,202
7304,Alexsis,2,Entire home/apt,100,0,0.08,100
7305,Erin,2,Private room,85,0,0.53,85
7306,Michelle,1,Entire home/apt,169,0,0.31,169
7307,Debra,1,Entire home/apt,149,0,0.1,149
7308,Melissa,1,Private room,89,166,1.71,255
7309,Stat,2,Private room,44,273,0.03,317
7310,Alan,2,Entire home/apt,150,5,4.38,155
7311,Madeline,2,Entire home/apt,125,20,1.39,145
7312,Stat,3,Private room,42,151,0.04,193
7315,Martha &  Remo,3,Entire home/apt,300,42,0.16,342
7316,Michael,1,Private room,250,0,0.06,250
7317,Charles,1,Private room,70,108,6.19,178
7318,Sayam,2,Entire home/apt,80,0,0.04,80
7320,Zach,3,Private room,65,261,2.54,326
7321,Ashia,2,Entire home/apt,167,0,0.04,167
7322,Host,1,Entire home/apt,130,311,0.2,441
7323,Alex,2,Entire home/apt,115,0,1.15,115
7324,Estefania,2,Private room,94,246,3.75,340
7325,Anatha Angèle,1,Entire home/apt,185,261,2.83,446
7326,Adrienne,1,Entire home/apt,195,0,0.29,195
7327,Brett,2,Entire home/apt,90,0,0.02,90
7328,Ashley,1,Private room,99,337,0.14,436
7329,Srini,1,Entire home/apt,499,364,0.09,863
7330,Gagandeep,2,Entire home/apt,180,151,2.62,331
7331,Francesca And Angelique,2,Entire home/apt,300,0,0.07,300
7332,Cara,1,Private room,100,197,3.9,297
7333,Vanessa,1,Private room,134,3,2.66,137
7334,Diego,3,Private room,49,303,0.95,352
7335,Murat,2,Private room,47,51,1.73,98
7336,Patricia,2,Entire home/apt,120,0,0.33,120
7337,Juliana,1,Entire home/apt,185,342,0.18,527
7338,Michael,2,Entire home/apt,169,279,2.7,448
7339,David,2,Entire home/apt,130,33,0.48,163
7340,Dominique,2,Entire home/apt,110,0,0.06,110
7341,Raviv,2,Entire home/apt,122,306,0.41,428
7342,Dana,2,Private room,150,0,0.04,150
7343,Vida,2,Entire home/apt,129,340,0.07,469
7344,Amy,3,Private room,65,25,1.46,90
7345,Juliana,1,Entire home/apt,115,311,0.35,426
7346,Stella,3,Private room,60,312,1.6,372
7347,Michael & Andrea,2,Entire home/apt,150,0,0.02,150
7348,Michael,1,Entire home/apt,200,11,0.69,211
7349,Ingrid,1,Entire home/apt,110,188,0.02,298
7350,Ann,3,Entire home/apt,259,257,1.37,516
7351,Steven,1,Entire home/apt,150,0,0.1,150
7353,Gabriella,1,Private room,140,0,0.04,140
7354,Randy,2,Private room,70,359,0.94,429
7355,Aliya,3,Entire home/apt,134,90,0.57,224
7356,Patricia,1,Entire home/apt,825,290,0.59,1115
7360,Nazieh,1,Entire home/apt,250,15,0.4,265
7361,Sandra,2,Private room,58,0,0.17,58
7362,Francis,2,Entire home/apt,142,247,2.07,389
7363,Jane,2,Entire home/apt,120,213,3.72,333
7364,O,1,Entire home/apt,136,338,0.85,474
7365,L & A,1,Private room,55,0,1.34,55
7367,Amanda,2,Private room,75,188,0.02,263
7368,Eric,1,Entire home/apt,103,237,1.94,340
7369,Benjamin,2,Entire home/apt,193,311,0.13,504
7370,Aswad,2,Entire home/apt,700,322,0.13,1022
7371,Anna,1,Entire home/apt,200,284,0.29,484
7372,Host,1,Entire home/apt,145,351,0.24,496
7373,Ashley,2,Entire home/apt,200,0,0.28,200
7374,Marcia,2,Private room,160,10,1.03,170
7375,Sam,2,Private room,45,302,0.82,347
7376,Sara,1,Entire home/apt,151,0,0.24,151
7377,Jeehee,1,Private room,98,0,0.41,98
7379,Host,1,Entire home/apt,185,336,0.29,521
7380,Farah,4,Entire home/apt,150,346,0.32,496
7381,Adam,2,Entire home/apt,170,0,0.14,170
7382,Dara,2,Entire home/apt,119,217,1.58,336
7383,Veronique Camille,1,Entire home/apt,229,43,0.09,272
7384,Deena,1,Private room,80,0,0.1,80
7386,Dee,2,Entire home/apt,500,313,1.41,813
7387,Dimitriy,1,Entire home/apt,120,163,0.24,283
7389,Vanessa & Christian,2,Entire home/apt,135,8,0.32,143
7390,Marea,1,Entire home/apt,524,115,1.14,639
7392,Tina,2,Entire home/apt,159,24,2.74,183
7394,Dean&Paula,3,Private room,73,347,3.82,420
7395,Amanda,2,Shared room,70,0,0.04,70
7396,Jacob,2,Private room,168,179,0.02,347
7398,Gabriela,1,Entire home/apt,169,126,1.48,295
7399,Saad,3,Entire home/apt,85,0,0.11,85
7400,Stat,2,Private room,38,331,0.29,369
7401,Stat,2,Private room,48,306,0.04,354
7402,Shawn(Ta),4,Private room,42,0,0.47,42
7403,Nina,1,Private room,80,245,1.1,325
7404,Aram,2,Entire home/apt,145,0,0.16,145
7405,Douglas,1,Private room,72,145,0.35,217
7406,Alessandra,2,Private room,95,62,3.75,157
7407,Lord Daniel,2,Private room,45,40,0.93,85
7408,Jardeen,1,Entire home/apt,250,27,1.96,277
7409,Marion,1,Private room,73,0,0.08,73
7410,Anna Meng,1,Private room,100,0,0.02,100
7411,Emily,2,Private room,50,0,0.03,50
7412,Gilad,2,Entire home/apt,165,365,1.45,530
7413,Amy,2,Entire home/apt,184,292,2.35,476
7415,Rocio & Dejan,3,Entire home/apt,135,0,1.85,135
7416,Mekado,1,Entire home/apt,160,0,1.06,160
7417,Andre,2,Entire home/apt,99,266,1.4,365
7418,Nick,2,Entire home/apt,85,0,0.06,85
7419,Paul,1,Entire home/apt,199,0,0.02,199
7420,Natalie,1,Entire home/apt,195,0,0.06,195
7421,Jesse,1,Private room,80,211,2.69,291
7422,Miklos,2,Private room,69,360,0.43,429
7423,Meggie,1,Entire home/apt,145,0,0.25,145
7424,Janine,2,Private room,52,27,0.15,79
7425,Nadeen,1,Entire home/apt,80,0,0.06,80
7426,Kristin,1,Entire home/apt,300,0,0.18,300
7427,Naio,1,Entire home/apt,75,100,0.04,175
7428,Amanda,1,Entire home/apt,180,0,0.15,180
7429,Arya,1,Private room,62,317,1.27,379
7430,Ross,1,Entire home/apt,750,345,1.07,1095
7432,Dwayne,2,Entire home/apt,250,72,0.31,322
7433,Steven,1,Entire home/apt,99,0,0.23,99
7434,Andrzej,2,Entire home/apt,120,0,0.33,120
7435,Edythe,1,Entire home/apt,150,40,2.78,190
7437,Colleen,1,Entire home/apt,150,0,0.12,150
7438,Sidiq,2,Private room,99,76,0.68,175
7439,Julia,1,Entire home/apt,200,342,0.17,542
7443,Qudsia,2,Private room,59,322,1.46,381
7444,Denise,2,Private room,84,364,0.1,448
7445,Juliana,1,Entire home/apt,140,204,0.22,344
7446,Demetria,2,Private room,90,0,0.16,90
7448,Sarah,1,Private room,250,38,2.31,288
7450,Mimi,2,Entire home/apt,190,243,2.42,433
7451,Che-Wei,2,Entire home/apt,298,35,0.33,333
7452,Jeff & TJ,1,Private room,99,33,2.67,132
7453,Erin,1,Entire home/apt,250,0,0.26,250
7454,Nya,1,Private room,95,335,0.14,430
7456,Nick,1,Private room,59,284,2.08,343
7457,Michelle,1,Shared room,115,0,0.15,115
7458,Kate,3,Entire home/apt,200,349,0.13,549
7459,Laura & Tim,2,Private room,75,281,0.17,356
7460,Galya,2,Entire home/apt,115,0,0.08,115
7461,Niki,1,Entire home/apt,146,211,0.87,357
7462,Simon,2,Private room,110,0,0.08,110
7464,Jason,2,Entire home/apt,450,226,2.63,676
7465,Lina,1,Entire home/apt,160,238,3.22,398
7466,Lina,1,Entire home/apt,149,0,0.29,149
7467,Svetlana,1,Entire home/apt,100,0,0.62,100
7468,Sam,1,Entire home/apt,220,180,2.26,400
7469,Danica,2,Entire home/apt,120,187,5.51,307
7470,April,2,Entire home/apt,99,0,0.46,99
7471,Sofia,1,Private room,65,1,0.52,66
7472,Elvira,3,Private room,50,0,0.02,50
7475,Yohan,1,Private room,75,303,0.16,378
7476,Kimesha,2,Private room,85,353,0.22,438
7477,Sam,2,Private room,2000,0,0.54,2000
7478,Jaclyn,2,Entire home/apt,149,0,0.02,149
7479,Clémentine,2,Private room,53,0,0.13,53
7480,Bennett,1,Entire home/apt,325,0,0.04,325
7481,Meaghan,2,Private room,45,0,0.25,45
7482,Stat,3,Private room,38,222,0.08,260
7483,Em,1,Shared room,120,178,0.74,298
7484,Stat,3,Private room,38,312,0.1,350
7486,Maria,2,Private room,60,147,0.77,207
7487,Maria,2,Entire home/apt,190,0,0.4,190
7488,Jenna,1,Private room,125,18,0.37,143
7490,Taylor & Tee,1,Private room,70,0,2.5,70
7491,Nicole,2,Entire home/apt,130,7,0.86,137
7492,Maryam,2,Private room,45,0,0.02,45
7493,Sue,1,Entire home/apt,110,67,0.14,177
7494,Akemi,1,Private room,60,0,1.17,60
7495,Brianna,2,Private room,125,179,0.15,304
7496,Christian,1,Private room,81,0,0.68,81
7498,Alexandra,3,Entire home/apt,105,0,0.14,105
7499,Viviana,1,Entire home/apt,200,23,0.03,223
7502,Ippei,2,Entire home/apt,75,0,0.2,75
7503,Przemek,2,Entire home/apt,250,36,0.33,286
7504,Merylin & David,1,Entire home/apt,400,258,1.94,658
7505,Aundre,2,Entire home/apt,160,338,2.62,498
7506,Anna & Ben,1,Private room,110,43,3.34,153
7507,Dwayne,2,Entire home/apt,220,81,2.95,301
7508,Shean,2,Entire home/apt,135,134,2.86,269
7509,Stephanie,2,Private room,99,143,0.82,242
7510,Karly,1,Private room,89,35,0.14,124
7512,Christina,1,Private room,75,72,1.39,147
7513,Henry,1,Entire home/apt,2000,364,0.18,2364
7515,Lucas,1,Entire home/apt,475,141,1.11,616
7516,Cathy,1,Entire home/apt,230,236,0.8,466
7518,Kate,1,Private room,125,248,0.14,373
7519,Asaf,2,Entire home/apt,180,0,0.07,180
7520,Michelle & Sebastien,2,Entire home/apt,80,0,0.02,80
7521,Gerardo,1,Private room,55,0,0.18,55
7522,Dana,2,Entire home/apt,135,197,2.75,332
7523,Yedda,1,Entire home/apt,182,148,1.08,330
7524,Julia,1,Entire home/apt,209,0,0.28,209
7525,Sheresa,1,Private room,78,0,0.71,78
7527,Stat,2,Private room,48,224,0.06,272
7528,Nanie,2,Private room,81,15,3.26,96
7529,Pablo,1,Shared room,80,89,0.24,169
7531,Vida,2,Entire home/apt,129,342,0.1,471
7532,Aswini,2,Entire home/apt,100,0,0.54,100
7533,Tommy,2,Private room,35,0,1.18,35
7534,Naima,1,Entire home/apt,100,250,4.65,350
7535,Douglas,1,Private room,82,364,0.32,446
7537,Margenett,2,Entire home/apt,128,88,1.98,216
7538,Stephanie,1,Entire home/apt,159,265,0.3,424
7539,Kizzy,2,Entire home/apt,101,365,0.11,466
7540,Alexis,1,Private room,195,145,1.1,340
7541,Henry,1,Entire home/apt,2000,364,0.17,2364
7542,Becca,1,Entire home/apt,160,129,1.11,289
7544,Alexis,1,Private room,195,84,1.2,279
7545,Sarah,2,Private room,475,0,0.02,475
7546,Sarah,1,Entire home/apt,122,0,0.68,122
7547,Kallie,2,Private room,45,0,0.12,45
7548,Ana,2,Entire home/apt,235,0,0.21,235
7549,Clay,1,Entire home/apt,275,45,0.29,320
7550,Jennifer,2,Entire home/apt,99,15,0.76,114
7552,William,1,Entire home/apt,125,67,1.06,192
7553,Don,2,Entire home/apt,125,132,1.26,257
7555,Simone,1,Entire home/apt,165,138,1.72,303
7556,Steve,1,Entire home/apt,129,272,3.43,401
7557,Gian-Murray,2,Entire home/apt,150,209,0.09,359
7559,Lillybeth & Crystal,1,Private room,90,129,4.42,219
7560,Nora,1,Private room,175,0,1.65,175
7561,Tina,2,Entire home/apt,188,135,2.93,323
7562,Daniel,3,Private room,80,0,0.21,80
7563,Andrew,3,Entire home/apt,160,15,0.06,175
7565,Andrew And Coline,2,Entire home/apt,100,0,0.02,100
7567,Mark,2,Private room,50,324,0.32,374
7568,Inigo,1,Private room,70,0,0.07,70
7569,Devin,2,Entire home/apt,130,67,1.59,197
7571,C.,2,Entire home/apt,180,125,0.4,305
7572,Frank,1,Entire home/apt,150,86,0.06,236
7573,Karen,3,Private room,69,65,0.57,134
7574,Maggie,1,Private room,62,89,0.9,151
7575,Dallas,2,Entire home/apt,150,0,0.16,150
7576,Andrew,2,Entire home/apt,118,0,0.02,118
7577,Edna Luise,1,Entire home/apt,195,64,0.2,259
7578,Patricio,1,Private room,75,314,4.42,389
7579,Nancy,2,Entire home/apt,135,41,0.46,176
7580,Melissa,1,Entire home/apt,450,260,0.08,710
7581,Maria,1,Private room,45,0,0.19,45
7582,Eric,1,Entire home/apt,250,71,3.21,321
7584,Akshay,1,Entire home/apt,120,0,0.02,120
7585,Rachel,2,Private room,125,295,0.77,420
7586,AFI Apartments,1,Entire home/apt,118,283,0.08,401
7588,Irene & Alban,2,Entire home/apt,100,41,2.23,141
7589,Jerie,2,Private room,40,0,0.04,40
7590,Lauren,1,Entire home/apt,225,0,0.07,225
7591,Host,1,Entire home/apt,185,281,0.2,466
7592,Kat,1,Private room,225,365,0.34,590
7593,Annie,2,Entire home/apt,155,3,1.21,158
7594,Marie,1,Entire home/apt,165,210,3.3,375
7595,Benjamin,2,Entire home/apt,165,339,0.06,504
7596,Vida,2,Entire home/apt,149,357,0.05,506
7597,AFI Apartments,1,Entire home/apt,142,315,0.1,457
7598,S,3,Private room,59,35,2.69,94
7599,Shira,1,Entire home/apt,200,0,0.12,200
7600,Heather,2,Entire home/apt,125,0,0.03,125
7601,Nick,2,Entire home/apt,181,302,4.57,483
7602,Joseph,2,Private room,90,18,1.73,108
7603,Annalyn,2,Private room,70,0,0.17,70
7604,Veronica And Tyler,1,Entire home/apt,150,0,0.13,150
7605,Adam,1,Entire home/apt,225,0,0.25,225
7606,Jeff,1,Entire home/apt,240,38,0.16,278
7607,Aubrey,2,Entire home/apt,98,0,0.24,98
7608,Eric,1,Entire home/apt,100,30,0.29,130
7609,Luis,1,Entire home/apt,200,0,0.19,200
7610,Lindsay,2,Entire home/apt,150,0,0.04,150
7612,James,2,Private room,129,339,0.36,468
7613,Jeffrey,2,Private room,65,0,0.02,65
7614,Hans,1,Private room,70,318,0.28,388
7615,Allie,1,Entire home/apt,200,0,0.19,200
7616,Deniz,3,Private room,58,129,0.66,187
7617,Danny,2,Entire home/apt,180,304,1.32,484
7618,Nat,1,Private room,120,0,0.06,120
7619,Jen,1,Entire home/apt,244,222,0.74,466
7620,Sergii,2,Private room,40,131,0.38,171
7622,Adam & Allen,2,Entire home/apt,135,248,4.84,383
7625,Julien,2,Private room,65,80,0.47,145
7626,Susan,2,Entire home/apt,140,326,4.46,466
7628,Vida,2,Entire home/apt,129,311,0.12,440
7629,Ray,3,Entire home/apt,112,338,0.35,450
7630,Mary & Ewen,2,Private room,80,0,0.93,80
7631,Amy,1,Entire home/apt,149,241,0.12,390
7632,Peter,1,Private room,99,0,0.04,99
7633,Nina,1,Private room,50,0,0.12,50
7634,Daniel,2,Entire home/apt,190,341,0.69,531
7635,Alberto,3,Private room,70,349,3.45,419
7636,Shawn(Ta),4,Private room,30,0,0.45,30
7637,Erion,1,Private room,96,3,1.38,99
7640,AFI Apartments,1,Entire home/apt,118,204,0.11,322
7641,Sarah,1,Entire home/apt,150,191,0.4,341
7644,Matias & Marlana,1,Entire home/apt,350,365,0.08,715
7646,Greg,2,Entire home/apt,225,255,1.58,480
7647,Ariel,1,Entire home/apt,110,276,0.34,386
7648,Axel,1,Entire home/apt,245,52,0.16,297
7649,Cheryl,1,Private room,65,24,1.12,89
7651,Amy,3,Private room,60,76,1.93,136
7652,Nadia,1,Shared room,68,302,2.09,370
7654,Rachel,2,Entire home/apt,195,0,0.12,195
7656,Anael,2,Entire home/apt,80,0,0.06,80
7657,Monica,1,Entire home/apt,195,34,1.09,229
7658,Jonny,1,Entire home/apt,275,0,0.02,275
7659,"Hans, Sandra & Son",5,Private room,49,277,3.06,326
7660,Janine,2,Private room,30,1,0.02,31
7661,Aryeh,1,Entire home/apt,150,0,0.93,150
7662,Elizabeth,2,Entire home/apt,140,0,0.1,140
7663,Jules,1,Entire home/apt,160,0,0.24,160
7664,Peter,1,Private room,125,0,0.08,125
7666,Fatou,2,Private room,50,285,1.17,335
7667,Sarah,1,Private room,100,76,6.1,176
7668,Sarah,1,Shared room,50,46,3.49,96
7669,Roger,1,Entire home/apt,320,215,0.19,535
7670,Eric,1,Private room,200,87,0.8,287
7671,Loyda,1,Private room,70,202,3.92,272
7672,Jordan,2,Private room,70,0,0.49,70
7673,Jane,2,Entire home/apt,200,0,0.05,200
7674,Nina,1,Entire home/apt,100,248,1.42,348
7675,Val,1,Private room,150,0,0.04,150
7676,Samantha,1,Entire home/apt,185,0,0.24,185
7677,Warren & Jessica,1,Entire home/apt,125,228,2.29,353
7678,Linda,2,Private room,148,90,0.22,238
7679,Nadine,1,Private room,295,0,0.12,295
7681,Carol,4,Private room,45,325,0.55,370
7682,Marc,2,Entire home/apt,114,160,1.57,274
7684,John,2,Private room,45,0,0.25,45
7685,Alex,2,Entire home/apt,85,0,0.28,85
7688,Carlina,1,Private room,65,137,3.04,202
7689,Marina,1,Entire home/apt,280,113,2.35,393
7690,Jessica,2,Private room,65,0,0.02,65
7691,Nancy,2,Private room,65,11,5.72,76
7692,Alberto,3,Private room,65,355,2.35,420
7694,Ron&Leetal,2,Entire home/apt,255,66,0.24,321
7695,Marina,3,Private room,54,321,0.93,375
7697,Katie Graham,2,Private room,90,338,0.58,428
7698,Katie Graham,2,Private room,90,297,0.91,387
7699,Katie Graham,2,Private room,90,323,0.92,413
7700,Mark,1,Entire home/apt,120,355,0.82,475
7701,William,2,Entire home/apt,210,0,0.06,210
7702,Matthew,1,Entire home/apt,150,0,0.05,150
7703,Todd,1,Entire home/apt,140,228,2.68,368
7704,Qasim,4,Private room,80,255,0.32,335
7705,Vasuki,2,Entire home/apt,200,341,1.18,541
7706,Ed,2,Entire home/apt,450,2,0.24,452
7708,Celine And Ken,1,Private room,116,89,2.5,205
7709,Kiki,1,Entire home/apt,215,0,1.45,215
7710,Geoff,1,Entire home/apt,160,0,0.7,160
7711,Didi,1,Private room,150,110,0.04,260
7713,Vida,2,Entire home/apt,149,335,0.15,484
7714,Devin,1,Entire home/apt,65,0,2.1,65
7715,Timothy,2,Entire home/apt,260,132,1.08,392
7716,Shae,2,Entire home/apt,400,179,0.04,579
7717,Auminea,2,Private room,90,0,0.02,90
7718,Kristin,3,Private room,75,0,0.12,75
7719,Jemar,1,Private room,75,123,0.94,198
7720,Avraham,1,Entire home/apt,110,0,0.07,110
7721,Ame,2,Private room,115,0,3.0,115
7725,Ami,1,Entire home/apt,82,0,0.07,82
7726,Ellie,1,Private room,90,0,0.1,90
7727,Hassan And Patti,2,Private room,69,112,2.86,181
7728,Hassan And Patti,2,Private room,69,40,2.48,109
7729,Anthony,2,Entire home/apt,249,156,0.65,405
7730,Hassan And Patti,2,Private room,89,83,2.24,172
7731,Hassan And Patti,2,Private room,159,254,0.59,413
7732,M&J,1,Entire home/apt,220,0,0.02,220
7733,Samantha,2,Private room,95,0,0.25,95
7734,Stephanie,2,Private room,60,0,0.39,60
7735,Chad,1,Entire home/apt,179,0,0.14,179
7738,Lendy,1,Private room,86,325,0.17,411
7739,Cecilia,2,Private room,62,24,1.14,86
7740,CA & Gray,1,Entire home/apt,165,3,0.92,168
7741,Jen,2,Entire home/apt,89,343,0.11,432
7742,AFI Apartments,1,Entire home/apt,116,333,0.05,449
7743,Benjamin,2,Entire home/apt,172,221,0.14,393
7744,LisaMarie,1,Entire home/apt,125,20,0.22,145
7745,Kristine,3,Entire home/apt,90,0,0.31,90
7747,Cynthia,1,Entire home/apt,250,0,0.07,250
7748,Sarah,2,Entire home/apt,185,298,4.14,483
7749,Ayesha,4,Entire home/apt,63,235,2.24,298
7750,Sari,1,Entire home/apt,163,0,0.24,163
7752,Majeed,1,Private room,195,178,0.37,373
7753,Qudsia,2,Private room,89,365,1.31,454
7754,Reynaldo,1,Shared room,45,0,0.04,45
7755,Kaley,2,Private room,60,0,0.1,60
7756,Dominik,1,Private room,125,284,1.15,409
7758,Leeore,2,Entire home/apt,85,0,0.78,85
7759,Anita,2,Entire home/apt,165,237,1.42,402
7760,Jessica M.,1,Entire home/apt,144,0,0.35,144
7762,Francisca,2,Private room,60,25,0.09,85
7763,Graham And Ben,2,Private room,95,331,0.8,426
7764,Graham And Ben,2,Private room,95,201,1.05,296
7765,Graham And Ben,2,Private room,95,317,0.9,412
7766,Graham And Ben,2,Private room,95,340,0.69,435
7767,Graham And Ben,2,Private room,95,312,0.84,407
7768,Rawn,4,Private room,65,150,0.69,215
7769,Inessa,5,Entire home/apt,65,336,1.22,401
7770,Adam & Allen,2,Entire home/apt,110,1,4.82,111
7771,Don Luis,3,Private room,47,236,0.13,283
7772,Liza,3,Private room,175,283,0.31,458
7773,Faye,2,Entire home/apt,234,0,0.23,234
7774,Gabrielle,2,Entire home/apt,105,319,0.83,424
7775,Anna,3,Private room,47,311,0.81,358
7776,Anna,3,Private room,55,342,1.12,397
7777,Tom,1,Entire home/apt,146,239,2.17,385
7778,Jason,5,Entire home/apt,60,17,2.54,77
7779,Jill,1,Private room,61,102,0.6,163
7780,Daniel,1,Private room,84,2,0.08,86
7781,Michael And Kimberly,1,Entire home/apt,179,185,1.06,364
7783,Cristina,2,Entire home/apt,175,0,0.02,175
7784,Adam,1,Entire home/apt,250,0,0.02,250
7786,Francis,2,Entire home/apt,83,264,1.13,347
7787,Amy,2,Entire home/apt,105,213,1.15,318
7788,Tim,2,Entire home/apt,125,0,0.1,125
7789,David,2,Private room,150,0,0.25,150
7790,Zack,2,Private room,69,225,0.45,294
7791,Lauren,2,Entire home/apt,190,0,0.04,190
7792,Maria Ana,2,Private room,76,39,0.7,115
7794,Veronica,1,Private room,142,188,0.16,330
7795,Arturo,1,Entire home/apt,125,0,0.08,125
7796,Mike,1,Entire home/apt,200,9,0.32,209
7797,Jessica,2,Private room,259,365,1.85,624
7798,Richard,2,Entire home/apt,275,0,0.03,275
7799,Sumit,1,Entire home/apt,179,0,0.54,179
7800,Steve,2,Private room,70,249,3.02,319
7803,David,2,Entire home/apt,259,296,3.07,555
7805,Nikki,1,Entire home/apt,300,0,0.27,300
7806,Jose,2,Entire home/apt,95,270,0.08,365
7807,Jessica,2,Private room,132,273,2.99,405
7808,Adam,3,Private room,80,0,0.06,80
7809,Idamil,1,Private room,85,0,0.09,85
7811,Stavros,3,Private room,50,243,3.05,293
7812,Auran,2,Entire home/apt,75,0,0.14,75
7813,Ellen,1,Entire home/apt,209,197,0.53,406
7814,Kristy,1,Entire home/apt,330,0,0.08,330
7815,Kia,3,Shared room,55,84,0.55,139
7816,Juliette,1,Private room,60,0,0.02,60
7817,Peggy,2,Entire home/apt,180,13,0.13,193
7818,John,1,Entire home/apt,300,198,1.18,498
7819,Eva,1,Entire home/apt,175,0,0.13,175
7820,Lindiwe,1,Private room,100,358,0.08,458
7821,Peter,2,Entire home/apt,175,0,0.41,175
7823,Jana,2,Entire home/apt,175,189,0.03,364
7824,Sterling,1,Private room,105,105,3.08,210
7825,Beth,2,Entire home/apt,49,34,0.42,83
7826,Crystal,2,Private room,65,0,0.78,65
7827,Alexis,1,Entire home/apt,450,108,0.86,558
7828,Katie,1,Entire home/apt,185,4,1.17,189
7829,Richard,2,Private room,57,0,2.33,57
7830,Sol And Coach,2,Entire home/apt,79,255,1.81,334
7831,Peter,2,Entire home/apt,218,250,2.79,468
7832,Lior,1,Entire home/apt,70,333,0.23,403
7833,Brandon,2,Entire home/apt,350,287,1.45,637
7834,Marj,2,Private room,100,22,2.36,122
7835,David,2,Entire home/apt,150,180,1.07,330
7837,Leslie,3,Private room,46,262,0.39,308
7838,Anna,2,Private room,50,0,0.06,50
7839,Florence,1,Entire home/apt,285,284,1.47,569
7840,Lynn,2,Entire home/apt,220,0,0.1,220
7841,Chad,1,Private room,125,0,0.02,125
7842,Elisa,1,Private room,80,102,1.36,182
7843,Don Luis,3,Private room,58,249,0.04,307
7844,Micah,2,Entire home/apt,100,0,3.41,100
7845,Maggie,2,Entire home/apt,175,0,0.82,175
7846,Eric,1,Entire home/apt,1200,309,0.9,1509
7848,Susanne,2,Entire home/apt,160,18,2.05,178
7849,Jennifer,1,Private room,65,341,0.12,406
7850,Albert,1,Entire home/apt,499,332,0.52,831
7851,Simone,1,Entire home/apt,350,0,0.2,350
7852,Kathryn,2,Entire home/apt,105,113,3.88,218
7853,Sam,2,Entire home/apt,245,305,0.63,550
7854,Ettrick,2,Entire home/apt,139,175,2.31,314
7855,T.,1,Private room,50,300,0.24,350
7857,Jai,3,Entire home/apt,90,0,0.04,90
7858,Arpan,1,Private room,250,0,0.02,250
7859,Sehrish,2,Private room,70,0,0.02,70
7860,Michael,1,Entire home/apt,150,0,0.91,150
7862,Kathryn,2,Entire home/apt,109,0,2.07,109
7863,Ike,1,Entire home/apt,140,268,1.17,408
7864,Kay,2,Private room,31,0,0.02,31
7865,Juliana,1,Entire home/apt,140,312,0.17,452
7866,Lilian,1,Private room,65,273,0.74,338
7867,Kiela,1,Entire home/apt,85,90,0.38,175
7869,D,1,Entire home/apt,155,99,1.7,254
7873,Kate,1,Private room,125,0,0.04,125
7874,Brittany,1,Entire home/apt,170,0,0.04,170
7875,Loli,2,Private room,65,249,5.51,314
7876,Ana,2,Private room,38,0,0.05,38
7878,Arthur,2,Private room,110,0,0.08,110
7879,Poppy,2,Entire home/apt,100,52,2.28,152
7880,Chris,1,Entire home/apt,125,0,0.21,125
7881,Tianhui,1,Private room,60,0,0.02,60
7882,Irene,1,Private room,80,78,2.52,158
7883,Juliana,1,Entire home/apt,95,97,0.25,192
7884,Sne,1,Private room,163,143,7.71,306
7885,Vanessa & Martin,2,Entire home/apt,225,56,0.58,281
7887,Mark,2,Entire home/apt,170,0,0.04,170
7888,Mo,1,Entire home/apt,65,307,0.79,372
7889,Clara,2,Private room,60,0,0.32,60
7890,Margaret,1,Entire home/apt,168,58,0.25,226
7891,Meg,2,Entire home/apt,100,0,0.09,100
7893,Monika,3,Entire home/apt,89,268,3.0,357
7894,Elena,1,Private room,109,243,3.75,352
7898,Matt,1,Entire home/apt,120,0,0.02,120
7899,Ksenia & Masha,2,Private room,40,180,2.01,220
7900,Host,1,Entire home/apt,150,67,0.21,217
7901,Gabriela,1,Private room,45,0,0.07,45
7902,John,2,Entire home/apt,159,51,0.81,210
7903,Omri,1,Entire home/apt,149,0,0.28,149
7904,Collin,3,Entire home/apt,125,0,0.06,125
7905,Alina,2,Entire home/apt,75,0,0.53,75
7906,Pete,2,Entire home/apt,109,0,0.12,109
7907,Lori,1,Entire home/apt,499,296,0.38,795
7909,Ame,2,Private room,220,251,0.2,471
7910,David,2,Private room,55,340,1.0,395
7911,Jango,1,Entire home/apt,341,58,2.87,399
7912,Jaclyn,2,Entire home/apt,108,33,0.06,141
7913,Sarah,2,Entire home/apt,128,52,1.63,180
7914,Eric,4,Entire home/apt,110,283,1.91,393
7915,Maria,2,Entire home/apt,179,113,0.77,292
7916,Jesse,1,Entire home/apt,175,0,0.04,175
7917,Marcel,2,Entire home/apt,80,0,0.16,80
7918,Charles,2,Entire home/apt,149,365,0.49,514
7919,Mekkie,1,Private room,50,191,0.15,241
7920,Dimitri,3,Shared room,75,0,0.08,75
7921,Jami,1,Private room,100,186,0.48,286
7922,Ann,3,Entire home/apt,369,256,1.46,625
7923,Sebastian,2,Entire home/apt,198,4,0.14,202
7924,Paul & Hana,3,Private room,100,365,0.96,465
7925,Kevin,1,Entire home/apt,195,85,1.33,280
7926,Eric,1,Entire home/apt,257,0,0.22,257
7927,Sharon,3,Entire home/apt,145,125,0.75,270
7928,Naichen,1,Private room,45,0,0.14,45
7929,Nia,3,Private room,60,81,1.65,141
7931,Kim,2,Private room,80,331,0.22,411
7933,Edwin,2,Entire home/apt,99,196,3.74,295
7934,Courtney,1,Entire home/apt,180,0,0.02,180
7935,Petya,3,Private room,40,364,0.1,404
7936,Brett,2,Private room,96,0,0.56,96
7937,Dana,1,Entire home/apt,105,0,0.18,105
7938,Silvia,3,Entire home/apt,80,196,3.66,276
7939,Arlen,1,Entire home/apt,100,0,0.03,100
7940,Elisabeth,2,Private room,58,83,5.29,141
7941,Guillermo,2,Private room,89,0,0.12,89
7942,Troy,1,Private room,105,316,3.21,421
7944,Maral,2,Private room,68,0,0.11,68
7945,Luke,1,Entire home/apt,200,0,0.65,200
7946,Michele,1,Entire home/apt,170,115,0.55,285
7947,Shante,2,Entire home/apt,60,0,0.19,60
7948,Florence,1,Entire home/apt,285,249,2.07,534
7949,Willa,1,Entire home/apt,90,71,2.74,161
7950,Ayal,2,Entire home/apt,75,62,2.06,137
7951,Sopchok,3,Entire home/apt,115,78,1.03,193
7952,Rajesh,2,Entire home/apt,118,68,0.02,186
7953,Zachary,2,Private room,76,89,0.7,165
7954,Edward,2,Entire home/apt,245,67,0.12,312
7956,Tatiana,1,Entire home/apt,75,0,0.06,75
7957,Danielle,1,Entire home/apt,200,188,0.7,388
7958,Mike,1,Entire home/apt,85,342,0.12,427
7959,Andrea,2,Entire home/apt,350,12,0.23,362
7960,Barbi,1,Private room,101,138,1.28,239
7962,Liza,1,Private room,125,0,0.02,125
7963,Chris,1,Private room,89,0,0.41,89
7965,Luiz,2,Entire home/apt,120,128,0.05,248
7967,Brooke,1,Entire home/apt,299,176,0.16,475
7968,Robert,1,Entire home/apt,195,16,1.18,211
7969,Jessica,1,Private room,78,0,0.06,78
7970,Dimitri,1,Entire home/apt,250,328,0.56,578
7971,Dawn,1,Entire home/apt,150,0,0.02,150
7973,Ester,3,Private room,78,285,2.23,363
7974,Ali,2,Private room,55,0,0.02,55
7975,Richard,1,Entire home/apt,300,239,2.04,539
7976,Garnet,2,Private room,38,99,0.86,137
7977,Tim,1,Entire home/apt,150,0,0.71,150
7979,André,2,Private room,52,0,0.02,52
7980,Lalo,1,Entire home/apt,198,252,3.21,450
7981,Erika,2,Private room,49,8,1.56,57
7982,Diane,1,Entire home/apt,950,274,0.13,1224
7983,Ariel,1,Entire home/apt,105,227,0.24,332
7984,Jon,1,Entire home/apt,225,338,5.54,563
7985,Jessica,2,Private room,125,339,0.32,464
7986,Scarlet,2,Entire home/apt,110,0,0.44,110
7987,Morteza,2,Private room,44,0,0.02,44
7988,Alexandra,1,Shared room,77,311,1.13,388
7989,Al,2,Entire home/apt,97,326,1.23,423
7990,Sandra And Cary,2,Private room,45,247,1.46,292
7991,Emma,2,Entire home/apt,157,0,0.02,157
7992,Adam,2,Private room,80,0,0.02,80
7993,Esther,1,Private room,50,0,0.07,50
7994,Rosario,3,Entire home/apt,275,333,1.9,608
7995,Brett,2,Private room,129,156,2.02,285
7996,Christina,1,Entire home/apt,250,0,0.03,250
7997,Yana,1,Shared room,36,347,2.26,383
7999,Sara,1,Entire home/apt,185,0,0.08,185
8000,Ryan,1,Entire home/apt,130,0,0.04,130
8001,Angela,3,Private room,65,331,9.16,396
8002,Rajan,2,Entire home/apt,275,0,1.53,275
8003,Giulia,1,Entire home/apt,120,0,0.18,120
8004,Tzveta,1,Entire home/apt,180,200,0.51,380
8005,Sara,2,Entire home/apt,123,0,0.04,123
8007,Laurence,1,Entire home/apt,210,0,0.14,210
8008,Rachel,1,Entire home/apt,139,0,0.08,139
8009,Lena,2,Shared room,45,0,0.02,45
8010,Alice,1,Private room,79,0,0.04,79
8012,Afaliah,2,Private room,90,364,0.06,454
8013,Vanesa,3,Entire home/apt,150,171,1.32,321
8015,Mike,1,Entire home/apt,200,0,0.28,200
8016,Alexander,2,Entire home/apt,100,290,2.62,390
8018,Gennady + Laura,2,Private room,45,269,2.34,314
8019,Sagnes,1,Private room,115,0,0.02,115
8020,Grover,4,Private room,56,52,2.61,108
8021,Grady & Cristina,1,Entire home/apt,210,0,1.16,210
8022,Mike,1,Entire home/apt,87,275,0.1,362
8023,Elvis,5,Private room,40,354,0.12,394
8024,Odalys & Maya,2,Private room,58,332,0.02,390
8025,Danny,2,Entire home/apt,125,0,0.14,125
8026,Clayton,2,Entire home/apt,100,0,0.06,100
8027,Alexander,2,Entire home/apt,195,0,0.06,195
8028,Delphine,2,Entire home/apt,90,173,0.68,263
8029,Lilian,1,Private room,65,279,0.85,344
8031,Martha,1,Entire home/apt,200,212,0.04,412
8032,Jess,1,Private room,75,212,0.45,287
8033,Matt,1,Entire home/apt,220,0,0.08,220
8034,Jennifer,2,Entire home/apt,225,0,0.02,225
8035,Marc,2,Entire home/apt,163,186,0.74,349
8036,Greg,2,Private room,85,327,2.38,412
8037,Ambre,3,Entire home/apt,150,0,0.02,150
8038,Elisabeth,2,Shared room,38,56,4.63,94
8039,Oliver,1,Entire home/apt,79,0,0.09,79
8040,Bridgette,2,Entire home/apt,90,28,1.17,118
8041,Myrta,2,Private room,100,300,1.91,400
8042,Ariel,1,Entire home/apt,99,197,0.17,296
8043,Jen,2,Entire home/apt,200,364,0.65,564
8044,Alexandra,1,Entire home/apt,190,0,0.02,190
8048,Jacob,1,Private room,75,6,3.01,81
8049,Ksenia,1,Private room,70,0,0.3,70
8050,Jiaying,1,Private room,85,0,0.02,85
8051,Javier,2,Private room,50,0,0.04,50
8052,Sabrina,1,Entire home/apt,130,0,0.69,130
8054,Daniel,1,Entire home/apt,150,0,0.1,150
8055,Shell,2,Entire home/apt,750,364,0.34,1114
8057,Betsy,2,Shared room,62,325,0.9,387
8059,Lana,1,Entire home/apt,250,0,0.51,250
8060,Milyoung,2,Entire home/apt,350,0,0.04,350
8061,Sophie,2,Private room,65,208,1.14,273
8062,Ariel,1,Entire home/apt,95,137,0.27,232
8063,Mike,3,Entire home/apt,153,252,1.62,405
8064,Katie,2,Entire home/apt,150,0,1.88,150
8065,Matei,1,Entire home/apt,280,64,3.17,344
8066,Yi,1,Private room,70,0,0.04,70
8067,Luca,1,Entire home/apt,155,362,0.44,517
8068,Jaclyn,2,Private room,71,332,3.18,403
8069,Yedda,1,Entire home/apt,182,317,1.03,499
8070,Yana,1,Private room,105,338,1.57,443
8071,Samantha,1,Entire home/apt,100,205,0.13,305
8073,Shari,2,Entire home/apt,109,188,0.46,297
8074,Seth,2,Entire home/apt,95,0,0.08,95
8075,Sophie,2,Private room,65,252,1.31,317
8078,Damien,1,Private room,130,364,0.02,494
8079,Heather,1,Entire home/apt,120,231,2.29,351
8080,Duygu,3,Entire home/apt,200,0,0.04,200
8081,Karen,1,Entire home/apt,190,21,0.04,211
8083,Laurence,2,Private room,85,150,3.11,235
8084,Peter,2,Entire home/apt,125,249,3.27,374
8086,Saf,2,Entire home/apt,130,0,1.92,130
8087,Marilyn,2,Private room,70,341,2.63,411
8088,Marco,2,Entire home/apt,184,6,0.03,190
8089,Alleyne,2,Private room,180,364,0.36,544
8090,Richard,2,Entire home/apt,100,1,5.17,101
8091,Junior,4,Entire home/apt,125,342,0.81,467
8092,Juliana,2,Entire home/apt,150,0,0.06,150
8093,Sarah,1,Entire home/apt,105,0,0.1,105
8094,Memo & Iso,2,Private room,35,162,3.2,197
8095,Memo & Iso,2,Private room,30,134,3.21,164
8096,Memo & Iso,2,Private room,30,165,3.34,195
8097,Ashley,1,Entire home/apt,125,0,0.06,125
8098,Allyssa,2,Entire home/apt,190,0,0.02,190
8099,Susana,1,Shared room,95,27,3.03,122
8100,Geoff,2,Private room,55,0,0.08,55
8101,Jordan,1,Entire home/apt,130,0,0.04,130
8102,Sandra,4,Entire home/apt,119,223,0.98,342
8103,Pooja,1,Private room,67,271,5.92,338
8104,Dario,1,Private room,90,0,0.08,90
8106,Christine,2,Entire home/apt,199,0,0.2,199
8107,Christiana,2,Entire home/apt,150,291,0.96,441
8108,Gomez,2,Private room,115,18,2.8,133
8109,Christelle,1,Entire home/apt,100,0,0.04,100
8110,Sj,2,Entire home/apt,165,0,0.59,165
8111,Junior,4,Entire home/apt,105,365,1.66,470
8112,Jasmine,2,Private room,49,356,3.36,405
8113,Annie,2,Entire home/apt,100,0,0.02,100
8114,Elissa,2,Private room,94,72,1.81,166
8115,Oliver,1,Private room,75,0,0.06,75
8117,Kenneth,1,Entire home/apt,322,76,1.76,398
8118,Elliott,2,Private room,119,0,2.49,119
8119,Steve,2,Entire home/apt,100,321,1.25,421
8121,Ted,1,Private room,90,0,0.08,90
8122,Dennis,1,Private room,150,0,0.02,150
8123,Prerna,1,Entire home/apt,230,0,0.02,230
8124,Champson,3,Private room,59,0,0.04,59
8125,Amanda,1,Private room,90,175,1.88,265
8126,Tanner,1,Private room,95,60,4.87,155
8129,Naama,2,Entire home/apt,85,0,0.08,85
8130,Michael,2,Entire home/apt,150,238,2.74,388
8131,James,1,Entire home/apt,189,0,0.25,189
8132,James,1,Private room,99,28,0.69,127
8133,正川,3,Private room,41,0,3.09,41
8135,Nancy,1,Private room,90,359,1.49,449
8136,正川,3,Private room,37,20,2.53,57
8138,Daniel,2,Private room,380,0,0.02,380
8141,Aracelli,1,Private room,50,188,0.13,238
8142,Randall,2,Entire home/apt,225,17,0.47,242
8143,Lori,1,Entire home/apt,150,0,0.04,150
8144,Kham,2,Private room,55,0,0.05,55
8146,Shir,1,Entire home/apt,276,9,1.15,285
8148,Carrie,1,Entire home/apt,199,192,0.89,391
8149,Yohan,1,Private room,48,341,0.15,389
8150,Mario,2,Entire home/apt,145,327,1.97,472
8152,Alex & Laura,2,Private room,62,0,0.24,62
8153,Guy,1,Entire home/apt,230,0,0.13,230
8154,Hien,1,Private room,90,81,2.64,171
8155,Yury,2,Entire home/apt,83,227,0.58,310
8156,Yvette,2,Entire home/apt,120,239,0.17,359
8157,Sophie,2,Private room,65,307,1.13,372
8158,Branden,2,Entire home/apt,140,0,0.04,140
8159,Tommy,2,Private room,80,0,0.04,80
8164,Jonas,1,Entire home/apt,120,0,0.12,120
8165,Tami,2,Entire home/apt,100,0,0.1,100
8166,Danielle,2,Private room,65,30,0.45,95
8167,Dov,2,Private room,80,0,0.05,80
8168,Alexandra,1,Entire home/apt,299,0,0.06,299
8169,Silvia,1,Entire home/apt,16,0,0.16,16
8171,Rachel,1,Entire home/apt,245,350,1.23,595
8172,Cliff,2,Private room,55,0,0.02,55
8173,Josette,1,Private room,45,0,0.02,45
8174,Jacqueline Mia,2,Entire home/apt,100,0,0.04,100
8176,Ollie,2,Private room,60,236,0.52,296
8177,Ollie,2,Private room,60,244,0.48,304
8178,Michael,2,Entire home/apt,140,0,0.14,140
8179,Jon,2,Entire home/apt,300,0,0.03,300
8180,Nicholas,2,Entire home/apt,249,0,0.08,249
8181,Thomas,2,Entire home/apt,175,45,0.02,220
8183,Sanam,2,Private room,55,0,0.08,55
8184,Nadia,2,Entire home/apt,135,0,0.04,135
8185,Sarah,1,Private room,60,0,0.02,60
8186,Anthony,1,Private room,75,345,0.14,420
8190,Kamilya,2,Private room,129,75,0.26,204
8191,Manny,2,Entire home/apt,280,274,3.01,554
8192,Dana,2,Entire home/apt,132,214,2.37,346
8193,Alejandra,2,Private room,70,0,0.02,70
8194,Sho-Boo Of Sho-Boo Suite,2,Private room,52,332,0.52,384
8195,Qudsia,2,Private room,148,365,0.16,513
8196,Francesca,3,Entire home/apt,115,0,0.13,115
8200,Kevin & Yuan,2,Entire home/apt,109,0,0.04,109
8201,Fabian,2,Private room,60,0,0.18,60
8202,Jillian,1,Entire home/apt,150,99,2.16,249
8203,Jeffrey,1,Entire home/apt,207,0,0.02,207
8204,Faiven,1,Shared room,63,0,0.04,63
8205,Ruby,1,Entire home/apt,185,275,0.21,460
8206,Beth,2,Entire home/apt,445,0,0.02,445
8207,Marc,1,Entire home/apt,125,0,0.13,125
8208,Memo & Iso,2,Private room,35,153,3.45,188
8209,Joel,1,Entire home/apt,200,0,0.06,200
8210,Natalia,1,Entire home/apt,141,0,0.16,141
8211,Eduardo,1,Entire home/apt,120,0,0.04,120
8212,Tammy,1,Entire home/apt,145,252,2.95,397
8213,Troy,1,Private room,120,283,2.81,403
8214,Jason,5,Entire home/apt,89,25,2.57,114
8215,Shatia,2,Entire home/apt,90,0,0.04,90
8216,Tim,2,Entire home/apt,95,83,1.61,178
8218,Esef,1,Entire home/apt,295,272,1.98,567
8219,Danielle,2,Entire home/apt,104,320,1.2,424
8220,Michael,2,Entire home/apt,150,0,1.26,150
8221,Michael,2,Private room,75,247,2.54,322
8223,Benjamin,1,Entire home/apt,194,0,0.16,194
8225,Hollie,2,Entire home/apt,125,155,1.88,280
8226,Eric,2,Private room,84,254,3.82,338
8227,Casey,1,Entire home/apt,140,0,0.04,140
8228,Nina,1,Private room,50,310,0.28,360
8229,Marco,1,Private room,89,0,0.18,89
8230,Acadia,2,Private room,55,0,0.1,55
8231,Sho-Boo Of Sho-Boo Suite,2,Private room,62,343,1.1,405
8233,Chadanut,2,Private room,40,99,0.87,139
8234,Tracy,2,Entire home/apt,350,0,0.02,350
8236,Jaime,1,Entire home/apt,190,0,0.15,190
8238,Drew,1,Entire home/apt,300,0,0.03,300
8239,Laurie,1,Entire home/apt,295,0,0.12,295
8240,Judy,1,Private room,113,0,0.04,113
8241,Judy,1,Private room,95,0,0.04,95
8242,Yukee,1,Private room,59,319,1.42,378
8244,Vigil,1,Private room,69,329,0.8,398
8245,Dajana,1,Private room,190,0,0.02,190
8247,Shay,2,Entire home/apt,65,0,0.02,65
8248,Alex & Family,2,Entire home/apt,185,309,1.4,494
8249,Beatrice,2,Entire home/apt,152,0,0.02,152
8250,Iz,1,Entire home/apt,249,0,0.06,249
8252,Florence And Peter,1,Private room,95,69,0.51,164
8253,Gino,1,Entire home/apt,130,0,0.06,130
8254,Sylvia,2,Entire home/apt,145,0,0.37,145
8255,Gregory,1,Entire home/apt,325,67,1.33,392
8256,Sundar,1,Private room,75,0,0.02,75
8258,Jerry,3,Entire home/apt,75,317,1.78,392
8259,Ksenia & Masha,2,Private room,50,364,2.02,414
8261,Ofer,1,Entire home/apt,99,140,0.27,239
8262,Ilana,2,Private room,50,0,0.48,50
8264,Elly,1,Entire home/apt,150,0,0.18,150
8265,Andrew,1,Private room,88,122,0.97,210
8266,Robin,1,Entire home/apt,190,0,0.16,190
8267,Wing-Yee,1,Private room,125,0,0.02,125
8268,A.J.,1,Entire home/apt,284,0,0.22,284
8269,Shehzad,1,Private room,150,0,0.02,150
8270,Elena,1,Private room,16,154,1.66,170
8272,Miriam,2,Private room,60,70,1.39,130
8273,Ulysse,1,Private room,99,97,0.97,196
8274,Michael Shane,1,Entire home/apt,100,7,1.25,107
8275,Catherine,1,Private room,35,0,0.08,35
8276,Christopher,1,Entire home/apt,167,14,0.07,181
8277,Tiba,1,Private room,140,249,3.17,389
8278,Emily,1,Entire home/apt,175,0,0.08,175
8279,Brian,1,Entire home/apt,249,0,0.12,249
8282,Alec,2,Private room,129,236,2.38,365
8283,Luke,1,Private room,95,47,2.4,142
8284,Gat,1,Entire home/apt,280,0,0.02,280
8285,Jocelyn,1,Entire home/apt,200,0,0.06,200
8286,Birgitta,2,Entire home/apt,276,78,0.38,354
8287,Curtis,1,Entire home/apt,130,0,0.51,130
8288,Luis,1,Entire home/apt,40,0,0.05,40
8290,Smit,1,Private room,64,0,0.08,64
8291,Scott,1,Entire home/apt,399,354,0.61,753
8292,Sylvie,1,Entire home/apt,495,0,0.16,495
8293,Maeva & Aaron,2,Entire home/apt,145,0,0.06,145
8294,Miriam,2,Private room,53,81,1.12,134
8295,Kyoung,3,Entire home/apt,100,0,1.46,100
8296,May,2,Private room,42,298,0.1,340
8297,Mor,1,Entire home/apt,200,353,0.09,553
8298,Emiliano,2,Entire home/apt,130,348,1.95,478
8299,Chris,1,Private room,200,365,0.16,565
8300,Kim,2,Private room,75,0,0.02,75
8301,Tine,2,Private room,45,0,0.19,45
8302,Loli,2,Private room,52,220,2.63,272
8303,Alex,1,Private room,100,0,0.02,100
8304,Dorothy,2,Entire home/apt,350,0,0.3,350
8305,Vivian Yuen Ting,1,Private room,70,0,3.66,70
8306,Camilla,2,Private room,39,0,0.13,39
8308,Alison,1,Entire home/apt,239,0,0.18,239
8309,Ross,1,Entire home/apt,375,365,0.3,740
8310,Julianne,2,Entire home/apt,125,0,0.02,125
8312,Elle,2,Private room,45,0,0.06,45
8313,Ali,3,Private room,60,0,0.02,60
8314,Coral,2,Private room,75,65,0.55,140
8315,Jonathan,1,Private room,70,348,0.87,418
8316,Justin,4,Entire home/apt,65,210,2.3,275
8318,Sasha,1,Private room,99,296,0.55,395
8319,Jordan,2,Private room,95,0,0.06,95
8321,Nikhil,1,Entire home/apt,275,0,0.7,275
8322,John,3,Entire home/apt,168,336,2.64,504
8323,Ron,2,Private room,45,0,0.06,45
8324,Andres,2,Entire home/apt,80,0,2.0,80
8326,Akiea,1,Entire home/apt,115,0,0.08,115
8327,Candice,2,Private room,65,0,0.13,65
8328,Nick And Jade,2,Entire home/apt,201,68,3.53,269
8330,Surabhi,2,Private room,120,0,0.08,120
8331,Alina,3,Private room,50,0,0.02,50
8332,Robert,1,Entire home/apt,100,0,0.09,100
8333,Alana,1,Entire home/apt,100,0,0.04,100
8334,Christopher,2,Entire home/apt,59,0,0.19,59
8335,Jarad,2,Shared room,44,0,0.54,44
8336,Joshua,2,Private room,79,0,0.06,79
8337,Robbie,2,Private room,56,0,0.04,56
8338,Carole,1,Entire home/apt,140,0,0.16,140
8339,Joshua,1,Entire home/apt,160,0,0.1,160
8340,Michael,2,Entire home/apt,119,316,1.81,435
8341,Stacey,1,Entire home/apt,185,0,0.52,185
8343,Elizabeth And Elias,1,Private room,58,280,3.58,338
8344,Mo,2,Private room,85,0,0.08,85
8345,Kat,2,Private room,100,0,0.02,100
8346,Seth,2,Entire home/apt,110,0,0.1,110
8347,Billy,1,Private room,80,0,0.02,80
8348,Vie,4,Entire home/apt,115,364,0.18,479
8349,Matthew,2,Private room,99,307,1.25,406
8350,Linda,3,Entire home/apt,105,313,4.05,418
8351,Jennifer,1,Private room,110,0,0.06,110
8352,Benjamin,2,Private room,70,35,7.97,105
8353,Mackenzie,1,Private room,160,0,0.14,160
8354,Tim,2,Private room,150,0,0.2,150
8355,Maurine,1,Entire home/apt,90,0,0.03,90
8357,Michael,2,Entire home/apt,86,302,0.33,388
8358,Candace,1,Entire home/apt,200,0,0.04,200
8359,Jason,1,Entire home/apt,272,360,0.89,632
8360,Yelena,1,Entire home/apt,86,0,0.13,86
8362,Jonathan,1,Private room,129,26,5.92,155
8363,Bobi,1,Private room,50,365,2.07,415
8364,Sharmilli,1,Private room,95,0,0.03,95
8365,Claire,2,Entire home/apt,400,85,0.1,485
8367,Kim,2,Entire home/apt,160,341,1.27,501
8368,Barr,1,Private room,90,0,0.02,90
8369,Gillian,2,Entire home/apt,145,15,0.34,160
8370,Nate,3,Entire home/apt,125,319,0.91,444
8372,Erica,2,Entire home/apt,100,6,1.98,106
8373,Misha,2,Private room,75,311,0.26,386
8374,Estelle,2,Private room,75,0,0.04,75
8376,Christopher,2,Entire home/apt,125,0,0.04,125
8377,Walter,2,Entire home/apt,85,197,4.14,282
8379,Hans,1,Entire home/apt,449,4,0.14,453
8380,Mary Kate,2,Entire home/apt,150,0,0.02,150
8381,Gigi,2,Entire home/apt,250,275,3.51,525
8383,Leah,2,Entire home/apt,120,314,1.11,434
8384,Michael,1,Private room,115,69,4.94,184
8385,Jada,1,Private room,89,0,0.06,89
8386,Jeffrey,1,Entire home/apt,180,0,0.04,180
8387,Faye,3,Entire home/apt,70,0,0.04,70
8388,Giselle,1,Private room,140,0,1.01,140
8389,Nancy,2,Private room,37,322,1.43,359
8390,Zuzi,2,Private room,70,0,0.08,70
8391,Simon,2,Private room,88,0,0.14,88
8392,Simon,2,Entire home/apt,320,141,1.13,461
8394,Alexander,2,Private room,55,0,0.02,55
8395,Patrick,1,Entire home/apt,195,0,0.1,195
8398,Simon,1,Entire home/apt,155,247,2.36,402
8399,Casey,1,Entire home/apt,170,0,0.02,170
8403,Mark,1,Entire home/apt,125,0,0.44,125
8405,Danny And June,2,Entire home/apt,110,118,3.56,228
8406,Neil,2,Entire home/apt,395,10,0.25,405
8407,Marek,2,Entire home/apt,215,0,0.33,215
8408,Kamilah,2,Entire home/apt,150,336,0.37,486
8409,Cristy,1,Private room,295,0,0.46,295
8410,Anisia,2,Private room,60,2,0.13,62
8411,Viktoriya,2,Private room,55,22,2.79,77
8412,Sarah,3,Entire home/apt,85,0,0.06,85
8415,Chao,2,Private room,90,0,2.29,90
8416,Olga,1,Private room,49,182,1.66,231
8417,Frank,1,Private room,50,71,8.82,121
8418,Felami,2,Entire home/apt,85,24,1.05,109
8419,Jennifer,2,Entire home/apt,350,14,0.39,364
8420,Sidra,2,Private room,38,0,0.05,38
8421,Kate,2,Private room,158,0,0.08,158
8422,Matt,1,Entire home/apt,245,0,0.58,245
8423,Dave & Theresa,2,Entire home/apt,110,154,3.51,264
8426,Lisa,1,Private room,50,0,0.74,50
8427,Freda,3,Private room,45,318,0.09,363
8428,A,1,Private room,85,0,1.7,85
8429,Debra,2,Entire home/apt,150,299,0.51,449
8430,Andreas Per Daniel,1,Entire home/apt,247,0,0.51,247
8431,Eliana,1,Private room,105,273,0.1,378
8432,Ella,1,Entire home/apt,400,44,0.19,444
8433,Chris,3,Entire home/apt,155,173,0.11,328
8434,Nina,1,Entire home/apt,150,217,0.13,367
8436,Champson,3,Private room,69,0,0.28,69
8437,Zachariah,1,Entire home/apt,199,0,1.42,199
8438,Meriem,1,Entire home/apt,499,0,0.06,499
8439,Ryan,1,Entire home/apt,150,2,2.99,152
8441,Franky,2,Entire home/apt,105,8,0.66,113
8442,Freda,3,Private room,45,307,0.53,352
8443,Gan,2,Entire home/apt,105,0,0.06,105
8444,Costanza,1,Private room,130,293,0.63,423
8445,Shef,1,Private room,75,0,0.08,75
8446,Meredith & Dave,2,Entire home/apt,150,0,0.31,150
8447,Vida,2,Entire home/apt,159,340,0.07,499
8448,Souheil,2,Entire home/apt,100,0,0.3,100
8449,Oleg,2,Entire home/apt,145,157,1.24,302
8450,Chloe,1,Entire home/apt,220,0,0.26,220
8451,Randy,2,Entire home/apt,160,365,0.18,525
8452,Myrdith,2,Entire home/apt,175,300,2.98,475
8453,Goldwyn,1,Private room,82,0,0.23,82
8454,Joe,1,Entire home/apt,200,182,1.95,382
8457,Brooke,3,Private room,85,2,3.75,87
8458,McClain,1,Entire home/apt,135,0,0.22,135
8459,Jessica,1,Entire home/apt,150,0,0.04,150
8460,Donovan,2,Private room,65,310,1.42,375
8461,Britt,2,Entire home/apt,395,67,0.32,462
8462,Ashley,1,Entire home/apt,379,364,0.91,743
8463,Milan,1,Entire home/apt,250,0,0.14,250
8464,El,1,Private room,90,282,0.22,372
8465,Jaamil,2,Private room,40,4,0.47,44
8466,Seán,1,Entire home/apt,200,0,0.02,200
8467,Jessica,2,Entire home/apt,133,319,1.0,452
8468,Yelena,1,Entire home/apt,140,0,0.04,140
8469,Elem,1,Entire home/apt,100,342,0.25,442
8470,Kyle,2,Entire home/apt,85,0,0.09,85
8473,Becky And John,2,Entire home/apt,140,0,0.28,140
8474,Whitney,1,Entire home/apt,120,0,0.02,120
8475,Esther,1,Entire home/apt,110,0,0.06,110
8477,Leonarda,1,Entire home/apt,115,4,1.43,119
8478,Ambrose And Florence,3,Entire home/apt,120,14,0.53,134
8479,Michael,3,Entire home/apt,300,344,1.34,644
8480,Leonit,2,Private room,59,319,0.13,378
8481,Nick,3,Entire home/apt,140,363,1.33,503
8482,Jules,2,Private room,99,1,2.11,100
8483,Nicole,3,Private room,52,0,0.08,52
8484,John,1,Entire home/apt,125,0,0.09,125
8486,Svjetlana,1,Private room,65,196,0.76,261
8489,Sam,3,Private room,53,0,0.22,53
8490,Dana,1,Entire home/apt,340,0,0.38,340
8491,Grant,2,Private room,80,0,0.04,80
8493,Daniela,2,Private room,80,140,2.64,220
8494,Emeka,2,Private room,78,0,0.02,78
8495,Samantha,2,Entire home/apt,149,0,0.83,149
8496,Cynthia,2,Private room,80,251,2.5,331
8497,Stephanie,2,Entire home/apt,115,0,0.02,115
8498,Kirsten,1,Private room,90,60,3.71,150
8499,Jeffrey,2,Entire home/apt,175,0,0.2,175
8501,L,1,Entire home/apt,194,0,0.74,194
8502,Patty,1,Entire home/apt,175,0,0.1,175
8504,Jennifer,1,Private room,63,0,0.13,63
8505,Zach,2,Entire home/apt,150,94,0.08,244
8507,Clay,2,Private room,64,14,0.64,78
8508,Peter,1,Entire home/apt,185,35,1.04,220
8509,Justin,1,Private room,80,173,2.65,253
8510,Jodil H.,1,Entire home/apt,75,0,0.32,75
8511,Jean,5,Entire home/apt,105,343,1.49,448
8512,Eli,3,Entire home/apt,130,197,2.82,327
8513,Mike,1,Entire home/apt,264,0,0.12,264
8514,Kt,2,Entire home/apt,215,0,0.1,215
8515,Bridget,1,Private room,85,128,0.06,213
8517,Freda,3,Private room,50,358,0.24,408
8518,Penny,2,Entire home/apt,145,0,0.04,145
8519,Erica,1,Entire home/apt,150,0,0.04,150
8520,Angeline,2,Entire home/apt,175,0,0.2,175
8522,Bishal,1,Entire home/apt,900,24,0.26,924
8524,Dan,2,Private room,60,96,1.75,156
8525,Sophie,2,Private room,70,288,1.17,358
8526,Joe,1,Entire home/apt,240,158,1.87,398
8527,Eleanor & Greg,2,Entire home/apt,150,0,0.33,150
8529,Adrianna,1,Entire home/apt,175,0,0.08,175
8530,Henry,1,Entire home/apt,1000,364,0.57,1364
8532,Stephanie,2,Private room,42,0,0.02,42
8533,Elizabeth,1,Private room,80,326,0.36,406
8534,Gloria,2,Entire home/apt,150,342,0.34,492
8535,Karen,1,Entire home/apt,195,0,0.04,195
8536,Gregory,2,Entire home/apt,145,105,2.63,250
8537,L & A,1,Private room,75,0,1.04,75
8539,Maria,2,Entire home/apt,90,4,1.99,94
8540,Drew,2,Private room,53,0,0.23,53
8541,Meagan,1,Entire home/apt,155,164,0.8,319
8542,Maria,2,Private room,49,181,0.26,230
8543,Ksenia & Masha,2,Private room,78,158,2.17,236
8547,Jaclyn,2,Private room,199,346,0.06,545
8548,Anthony,1,Entire home/apt,350,0,0.74,350
8549,Ruby,1,Entire home/apt,120,0,0.06,120
8550,Nanda,3,Private room,70,310,2.47,380
8552,Rebecca,1,Private room,180,261,1.34,441
8553,Megan,2,Entire home/apt,145,8,0.02,153
8555,Natasha,3,Private room,149,361,1.14,510
8556,Lauren,1,Private room,60,0,0.1,60
8557,Chris,1,Entire home/apt,140,29,2.43,169
8560,Kari,2,Entire home/apt,175,0,0.1,175
8561,Clement,1,Private room,110,0,0.04,110
8562,Theresa,1,Entire home/apt,177,199,2.49,376
8563,Eric,2,Entire home/apt,275,70,0.25,345
8564,Nick,3,Entire home/apt,99,0,0.99,99
8565,Kate,1,Private room,105,92,2.31,197
8566,Mike,3,Entire home/apt,200,129,0.64,329
8567,Jennifer,1,Private room,58,0,0.54,58
8568,Valentino,1,Private room,100,0,0.06,100
8570,Rosie,2,Private room,110,0,2.17,110
8571,Mateo,1,Entire home/apt,80,0,0.06,80
8574,Gohe,2,Entire home/apt,165,0,0.27,165
8575,Lauren,2,Private room,80,356,0.38,436
8576,Marc,2,Entire home/apt,145,277,3.69,422
8578,Kate,2,Private room,45,0,0.04,45
8579,Memo & Iso,2,Private room,30,345,2.18,375
8580,Simone,1,Private room,81,334,0.41,415
8581,Yovel,2,Entire home/apt,49,179,0.2,228
8582,Christopher,2,Entire home/apt,225,297,1.12,522
8583,Amber,2,Private room,70,255,2.63,325
8584,Jon,2,Entire home/apt,120,0,0.43,120
8585,LaNola,1,Entire home/apt,175,123,1.62,298
8587,Rindon,2,Entire home/apt,130,0,0.04,130
8588,Nicholas,1,Entire home/apt,150,319,0.24,469
8589,Andrew,2,Entire home/apt,95,207,3.22,302
8590,Greg,2,Entire home/apt,300,217,0.45,517
8591,Rafik,3,Entire home/apt,180,33,3.55,213
8592,Greg,2,Entire home/apt,375,217,1.07,592
8594,Marg,1,Private room,75,239,1.34,314
8596,Lisa,1,Entire home/apt,300,0,0.1,300
8597,Jake,3,Private room,60,0,0.22,60
8598,Myrta,2,Private room,60,0,0.36,60
8599,Kate,2,Private room,158,0,0.06,158
8600,Aixa,1,Entire home/apt,184,273,1.2,457
8602,Anastasia,1,Entire home/apt,230,0,0.02,230
8603,Dave,1,Private room,95,334,0.49,429
8604,Nowme And Ra,2,Entire home/apt,110,205,1.18,315
8605,Georgina,1,Entire home/apt,120,8,0.19,128
8606,Eva Maria,2,Entire home/apt,189,239,1.95,428
8607,Rachel,2,Entire home/apt,98,0,0.14,98
8608,Lola,1,Entire home/apt,150,38,0.24,188
8609,Sarah,2,Entire home/apt,100,0,0.02,100
8610,Ginevra,2,Private room,85,154,0.33,239
8612,Jim,1,Entire home/apt,450,0,0.02,450
8613,Justin,2,Entire home/apt,250,0,0.02,250
8614,Dave & Nat,2,Private room,100,0,0.02,100
8615,Ernesto,3,Private room,40,0,0.73,40
8618,Julia,2,Entire home/apt,90,0,0.69,90
8619,Danny And June,2,Entire home/apt,150,22,0.06,172
8620,Brittany,2,Private room,80,0,0.14,80
8621,Levi & Kaz,1,Private room,89,155,2.8,244
8622,Nick,2,Private room,90,188,0.41,278
8623,Helen,2,Entire home/apt,91,10,1.7,101
8624,Abigail,1,Private room,85,0,0.05,85
8625,Andrea,1,Entire home/apt,250,166,1.36,416
8626,Carlos,3,Private room,50,107,1.62,157
8628,Romain,1,Private room,60,0,0.15,60
8629,Robert,2,Entire home/apt,150,0,0.34,150
8631,Previn,1,Entire home/apt,225,0,0.23,225
8632,Jonathan,3,Entire home/apt,290,277,0.28,567
8633,Chris,2,Entire home/apt,95,0,0.02,95
8634,Florian,1,Entire home/apt,139,0,0.07,139
8635,Sveva,2,Entire home/apt,295,19,0.13,314
8636,Ariel,1,Private room,140,187,4.59,327
8637,Anna,1,Entire home/apt,399,311,0.77,710
8638,Michael,1,Private room,100,0,0.22,100
8639,Alex,2,Private room,80,0,0.02,80
8640,Joseph,1,Entire home/apt,135,0,0.16,135
8642,Nick,2,Entire home/apt,175,0,0.05,175
8643,Kristy,1,Private room,70,63,0.64,133
8644,Brian,2,Private room,50,0,0.02,50
8645,Laramie,2,Private room,52,76,0.49,128
8646,Kristin,1,Private room,140,5,1.29,145
8647,Gunnar,1,Entire home/apt,169,0,0.22,169
8648,Francesca,2,Entire home/apt,173,0,0.02,173
8649,Susan,2,Entire home/apt,169,4,1.0,173
8651,Nacer,1,Entire home/apt,150,0,0.12,150
8652,Kim,2,Entire home/apt,145,0,0.51,145
8653,Claudio & Rose,1,Private room,70,313,1.28,383
8654,Anna,2,Entire home/apt,205,0,0.16,205
8655,Kate,1,Entire home/apt,145,179,0.38,324
8656,Pauline,2,Private room,88,180,0.26,268
8658,Elvira,2,Entire home/apt,200,173,0.14,373
8659,Carly,2,Entire home/apt,165,0,0.27,165
8661,Besinfe,1,Private room,85,355,1.39,440
8662,Jeremy,1,Entire home/apt,240,0,0.09,240
8663,Marc,2,Entire home/apt,95,0,0.08,95
8665,Julie,2,Private room,70,332,0.42,402
8666,Peter,2,Entire home/apt,99,0,0.06,99
8667,Marc,2,Entire home/apt,177,177,1.68,354
8669,Tom,1,Entire home/apt,300,0,0.14,300
8670,Claudio & Rose,1,Private room,40,257,1.35,297
8671,Diana,1,Entire home/apt,280,0,0.59,280
8672,Iris,3,Private room,59,318,0.26,377
8673,Alison,2,Entire home/apt,100,0,0.03,100
8674,Admir,1,Entire home/apt,150,0,0.02,150
8675,Linda,1,Entire home/apt,140,222,1.05,362
8676,Yaron,1,Entire home/apt,400,0,0.08,400
8678,Jessica,1,Private room,75,0,1.19,75
8679,Jessica,2,Entire home/apt,175,286,0.79,461
8680,Alfredo,1,Private room,85,365,0.39,450
8683,Michelle,1,Entire home/apt,150,304,0.14,454
8684,Sally,1,Entire home/apt,197,191,0.06,388
8686,Natasha,1,Entire home/apt,150,0,0.02,150
8688,Sandra,1,Entire home/apt,200,0,0.08,200
8690,Megan,1,Private room,130,106,0.23,236
8692,Julie,2,Shared room,50,365,0.19,415
8693,Hadrien,2,Entire home/apt,175,0,0.1,175
8694,Samuel,2,Private room,100,0,0.02,100
8695,Alexandre,2,Entire home/apt,150,293,1.54,443
8696,Heather,1,Entire home/apt,145,189,0.05,334
8698,Leiya,1,Private room,130,0,0.04,130
8699,Stavros,3,Private room,45,170,3.74,215
8700,Nadine,2,Entire home/apt,600,295,0.58,895
8701,Nicholas,2,Entire home/apt,125,0,0.4,125
8703,Lauren,1,Entire home/apt,130,0,0.26,130
8704,Alexa,3,Private room,44,275,0.39,319
8707,Carole,2,Entire home/apt,199,0,0.02,199
8708,Abe,2,Entire home/apt,49,0,0.02,49
8709,Meagan,1,Private room,45,0,0.02,45
8710,Nat,1,Entire home/apt,265,11,1.95,276
8711,Alissa,2,Entire home/apt,220,0,0.02,220
8712,Susan,2,Private room,52,55,2.87,107
8713,Chris,2,Entire home/apt,180,0,0.14,180
8714,David & Derek,1,Entire home/apt,127,0,0.62,127
8715,Corey,1,Private room,108,0,0.35,108
8716,Iris,3,Entire home/apt,150,0,0.02,150
8717,Sean,2,Entire home/apt,440,7,0.47,447
8718,Alice,1,Private room,100,0,0.04,100
8719,Marla,2,Entire home/apt,200,14,0.53,214
8721,Alberto,1,Entire home/apt,180,2,0.76,182
8722,Yazmany,1,Entire home/apt,250,5,0.45,255
8725,Amanda,2,Entire home/apt,150,0,0.1,150
8726,Liora,3,Private room,49,128,0.3,177
8727,Allison,1,Entire home/apt,1495,0,0.22,1495
8729,Tara,2,Private room,110,0,0.02,110
8730,Ryan,3,Private room,45,0,0.02,45
8731,Jessica,1,Entire home/apt,399,5,0.31,404
8732,Ali,2,Private room,103,0,0.03,103
8733,Maria,4,Private room,33,0,0.82,33
8734,Anthony And Laura,3,Entire home/apt,86,0,0.09,86
8735,Khamis,3,Entire home/apt,110,0,0.1,110
8736,Ian,2,Entire home/apt,160,359,0.06,519
8738,Mike,2,Private room,55,0,0.02,55
8740,Justin,1,Private room,80,203,3.72,283
8741,Tiphaine,3,Entire home/apt,85,0,0.04,85
8743,Mike,2,Entire home/apt,275,5,0.44,280
8744,L.M.,1,Entire home/apt,450,364,0.04,814
8747,Aparna,1,Entire home/apt,120,0,0.02,120
8749,Stefanie,2,Entire home/apt,250,0,0.03,250
8750,Yassine,3,Private room,85,0,0.06,85
8751,Tim,1,Private room,100,0,0.04,100
8752,Pj,2,Private room,65,0,2.17,65
8753,Frances,3,Private room,68,330,4.48,398
8754,Willem,1,Entire home/apt,170,0,0.24,170
8755,Michelle,2,Private room,50,81,1.41,131
8756,Tanni,2,Private room,45,0,0.03,45
8757,Stat,2,Private room,48,249,0.06,297
8758,Stat,2,Private room,43,347,0.02,390
8760,Georgina,1,Entire home/apt,260,0,0.18,260
8763,Rony,4,Entire home/apt,159,112,0.17,271
8764,Victoria,2,Private room,50,31,0.06,81
8766,Beverly,2,Entire home/apt,60,0,0.1,60
8767,Adrienne,2,Private room,80,0,0.19,80
8768,Adrienne,2,Entire home/apt,115,18,0.64,133
8769,Sabrina,1,Entire home/apt,200,0,0.09,200
8770,Dalton,3,Entire home/apt,160,179,0.59,339
8771,Liu,1,Entire home/apt,109,0,0.02,109
8772,Sammy,2,Private room,25,158,0.27,183
8773,Dimitri,2,Entire home/apt,280,0,0.1,280
8775,Thomas,2,Entire home/apt,98,0,0.21,98
8776,Sandy,2,Private room,70,37,2.02,107
8777,Juliet,2,Private room,55,301,0.31,356
8778,Elimara,3,Entire home/apt,100,0,1.41,100
8779,Alexander,1,Entire home/apt,200,0,0.02,200
8780,Claire,1,Entire home/apt,120,0,0.27,120
8781,Naum & Alexandra,2,Entire home/apt,150,0,0.02,150
8782,Florence,5,Entire home/apt,155,0,1.29,155
8783,Mariano,2,Private room,60,0,0.13,60
8784,Adriana,1,Private room,200,0,0.02,200
8785,Ana,1,Entire home/apt,200,0,0.95,200
8786,Chris,2,Shared room,25,358,0.5,383
8787,Lydia,1,Entire home/apt,199,0,0.29,199
8788,"Hans, Sandra & Son",5,Private room,49,284,2.12,333
8789,Andrea,1,Entire home/apt,105,5,0.69,110
8790,Rhemy,2,Private room,49,69,2.19,118
8791,Roger,1,Entire home/apt,256,0,0.23,256
8792,Tom,1,Entire home/apt,499,223,0.72,722
8793,Christina,2,Private room,90,295,0.67,385
8794,Simone,2,Entire home/apt,80,142,3.08,222
8795,Damien,2,Entire home/apt,180,18,0.71,198
8796,Amanda,1,Entire home/apt,145,0,0.04,145
8797,Samuel,2,Private room,100,0,0.02,100
8798,Doris,2,Entire home/apt,150,238,4.36,388
8800,Vuong,2,Private room,55,21,0.08,76
8801,Gabriela,2,Entire home/apt,147,5,1.29,152
8802,Liz,1,Entire home/apt,220,24,2.17,244
8805,Hans,1,Entire home/apt,888,35,0.86,923
8806,Peter,2,Private room,40,0,0.02,40
8807,Andrea,3,Private room,70,325,0.15,395
8808,Maddie,2,Private room,150,0,0.02,150
8809,Monica,2,Private room,75,0,0.03,75
8810,Sunita,2,Entire home/apt,85,0,0.04,85
8811,Scott,1,Entire home/apt,124,0,0.14,124
8812,Emanuel,1,Entire home/apt,89,346,0.79,435
8813,Alison,2,Entire home/apt,195,0,0.02,195
8814,Emma,2,Entire home/apt,160,193,0.55,353
8815,Sarah,1,Private room,60,0,0.1,60
8816,Julia,2,Private room,125,111,3.67,236
8817,Debra,1,Entire home/apt,225,0,0.12,225
8818,Maria,3,Private room,86,364,0.59,450
8819,Joffrey,2,Entire home/apt,119,0,0.12,119
8820,Raquel,2,Entire home/apt,70,0,0.19,70
8821,Cidinha,3,Private room,75,357,0.22,432
8822,Talia,3,Entire home/apt,150,0,0.06,150
8823,Loukia,2,Entire home/apt,145,0,0.02,145
8825,Andres,2,Entire home/apt,130,0,0.15,130
8826,Laramie,2,Private room,53,114,0.49,167
8828,Tammy,1,Entire home/apt,130,0,0.32,130
8829,Anna,3,Private room,48,153,1.07,201
8830,Dalton,3,Entire home/apt,105,0,0.14,105
8832,Antonio,3,Entire home/apt,65,311,2.4,376
8833,Gregory,3,Entire home/apt,100,0,0.02,100
8834,Antonio,3,Private room,39,346,5.28,385
8835,Alec,1,Entire home/apt,150,0,0.04,150
8836,Laurel,2,Private room,50,0,0.56,50
8837,Heidi,1,Private room,55,0,0.09,55
8838,Jillian,1,Entire home/apt,195,0,0.02,195
8839,Gabrielle & Malcolm,2,Entire home/apt,295,0,0.13,295
8842,Laramie,2,Private room,50,218,0.85,268
8844,Paul,1,Private room,110,0,0.26,110
8845,Eric,2,Private room,64,318,1.0,382
8846,Marites,2,Private room,75,52,0.22,127
8848,Melissa,1,Entire home/apt,130,0,0.13,130
8849,Juan,3,Private room,50,0,0.42,50
8850,Sari,2,Entire home/apt,270,7,0.09,277
8851,Catherine,1,Entire home/apt,78,15,0.09,93
8853,Yasu & Akiko,1,Private room,155,248,3.57,403
8854,Yasu & Akiko,1,Private room,210,249,3.69,459
8855,Katie,2,Private room,59,0,0.02,59
8856,Gabriel,2,Entire home/apt,140,0,0.17,140
8858,Uros,3,Entire home/apt,89,0,0.09,89
8859,Toma,1,Private room,50,0,0.02,50
8861,Yasu & Akiko,1,Private room,155,243,3.66,398
8862,Besinfe,1,Private room,75,354,3.13,429
8863,Spanky,2,Private room,98,236,4.85,334
8867,Tyler,2,Entire home/apt,102,277,0.2,379
8868,Mariya,2,Entire home/apt,85,0,0.41,85
8870,Nikima,2,Private room,35,0,0.02,35
8871,Yasu & Akiko,1,Private room,255,305,3.91,560
8872,Yasu & Akiko,1,Private room,245,1,3.29,246
8873,Yasu & Akiko,1,Private room,155,240,4.1,395
8874,Yasu & Akiko,1,Private room,155,240,4.07,395
8875,Linda,2,Private room,148,90,0.24,238
8876,Yasu & Akiko,1,Private room,155,211,4.13,366
8877,Yasu & Akiko,1,Private room,165,271,3.16,436
8878,Yasu & Akiko,1,Private room,155,245,3.86,400
8879,Phyl,2,Entire home/apt,389,0,0.37,389
8880,Maxime,1,Private room,65,180,2.12,245
8881,Phyl,2,Private room,89,0,0.13,89
8882,Matthew,2,Entire home/apt,250,0,0.06,250
8884,Faiven,1,Private room,81,0,0.16,81
8886,Hod,2,Entire home/apt,200,157,0.06,357
8887,Eden,2,Entire home/apt,130,0,0.02,130
8888,Yaniv,1,Entire home/apt,100,0,0.08,100
8889,Laramie,2,Private room,61,102,1.22,163
8890,Shenaz,1,Entire home/apt,95,0,0.09,95
8891,Luis,3,Private room,65,79,1.87,144
8892,Justin,2,Private room,40,0,0.08,40
8893,Murat,2,Entire home/apt,120,0,0.1,120
8894,Laramie,2,Private room,59,218,0.83,277
8896,Elle,3,Entire home/apt,135,89,4.65,224
8898,Tammy,1,Entire home/apt,460,0,0.23,460
8899,Sara,2,Entire home/apt,110,97,0.31,207
8900,Megan,2,Entire home/apt,225,189,0.49,414
8901,Chris,3,Entire home/apt,135,0,0.17,135
8902,New,2,Entire home/apt,125,0,0.02,125
8903,Kevin And Regard,2,Private room,64,0,0.65,64
8904,Laramie,2,Private room,58,147,0.63,205
8905,Zachary,1,Private room,69,0,0.02,69
8907,Nancy,2,Entire home/apt,177,260,3.02,437
8909,Michael,2,Private room,69,0,0.02,69
8910,Isabelle,2,Entire home/apt,275,146,0.02,421
8911,Kimihiro,1,Private room,99,0,0.39,99
8913,Raymond,1,Entire home/apt,135,0,0.09,135
8914,Lauren,1,Entire home/apt,150,0,0.1,150
8915,Manon,1,Entire home/apt,2000,365,0.39,2365
8916,Craig,2,Entire home/apt,90,190,3.65,280
8917,Michael,2,Private room,59,0,0.04,59
8919,Jocelyn,1,Entire home/apt,215,0,0.02,215
8920,Gretchen,2,Entire home/apt,70,222,3.34,292
8921,Ben,1,Private room,135,0,0.12,135
8922,Michael,1,Entire home/apt,200,0,0.16,200
8923,Brett,1,Entire home/apt,120,0,0.12,120
8924,Nash,2,Entire home/apt,85,13,1.9,98
8927,Monica,2,Private room,52,0,0.23,52
8929,Elam,1,Private room,145,3,0.02,148
8931,Josephine,1,Entire home/apt,245,307,0.38,552
8932,Linsy,2,Entire home/apt,120,0,0.05,120
8933,Maria,1,Entire home/apt,150,318,2.29,468
8934,Pete,1,Entire home/apt,250,0,0.04,250
8936,Annie,2,Entire home/apt,125,11,3.01,136
8938,Sam,2,Private room,40,0,0.05,40
8939,Phillip,2,Private room,55,0,0.04,55
8940,Christian,1,Entire home/apt,130,0,0.02,130
8941,Kristy,1,Private room,110,44,1.39,154
8942,Steven,1,Private room,185,155,0.33,340
8943,David,2,Entire home/apt,245,0,0.16,245
8944,Daniel,1,Entire home/apt,700,63,0.1,763
8945,Jonathan,2,Entire home/apt,215,0,0.05,215
8946,Shane & Nicole,2,Entire home/apt,250,300,0.36,550
8947,Mimi,1,Entire home/apt,150,0,0.04,150
8949,Justin,1,Private room,89,252,1.38,341
8950,Anna,1,Entire home/apt,244,1,0.45,245
8951,Barbara,2,Private room,74,18,0.66,92
8952,Masha,2,Entire home/apt,88,0,0.17,88
8953,Ira,1,Entire home/apt,150,0,0.36,150
8954,Laura,2,Entire home/apt,150,320,1.93,470
8955,Miriam,1,Private room,40,345,0.55,385
8957,Idil,3,Private room,55,0,0.02,55
8958,Natalie,1,Entire home/apt,259,0,0.41,259
8959,Nat,1,Private room,100,0,0.38,100
8960,Matthew,2,Entire home/apt,125,0,0.02,125
8961,Rosemary,2,Entire home/apt,85,0,0.05,85
8962,Ryan,1,Private room,75,0,0.02,75
8964,Bobby,1,Entire home/apt,198,0,0.35,198
8965,Gregory,3,Entire home/apt,300,365,0.27,665
8966,Elizabeth,1,Entire home/apt,295,175,0.35,470
8968,Mike,2,Private room,35,0,0.02,35
8969,Simon,2,Private room,80,0,0.17,80
8971,Ethan,2,Private room,110,0,0.02,110
8972,Godfrey,2,Private room,40,82,0.68,122
8974,Frasier,2,Private room,75,0,0.04,75
8975,Rachel,1,Entire home/apt,199,4,0.27,203
8976,Rob,1,Private room,50,0,0.02,50
8977,Allen,2,Entire home/apt,109,73,4.7,182
8978,Mila,2,Entire home/apt,120,334,0.4,454
8979,Devin,2,Private room,50,17,0.06,67
8980,Zyanna,2,Entire home/apt,95,0,0.11,95
8982,Guillerma,2,Private room,100,345,1.07,445
8983,Claire,1,Entire home/apt,350,0,0.13,350
8984,Remigijus,2,Entire home/apt,89,251,0.1,340
8985,Claudio & Rose,1,Private room,80,306,0.82,386
8986,Mustafa,3,Entire home/apt,125,246,5.37,371
8987,Glender,2,Entire home/apt,155,250,2.86,405
8988,Johnathon,2,Private room,62,0,0.05,62
8989,Justin,1,Entire home/apt,93,0,0.14,93
8990,Glender,2,Private room,80,249,1.04,329
8992,Marcel,2,Entire home/apt,120,1,0.39,121
8993,Jessica,2,Entire home/apt,450,0,0.04,450
8994,Host,1,Entire home/apt,155,289,0.13,444
8995,Mrs. T,3,Private room,53,348,3.9,401
8996,Ariel,1,Entire home/apt,150,0,0.26,150
8997,Jakob,1,Private room,45,0,0.02,45
8998,Vienna,3,Private room,85,0,0.02,85
8999,Sebastian,2,Private room,59,0,0.03,59
9000,Jae (Owen's Wife),2,Entire home/apt,122,293,2.08,415
9002,Wenxin,3,Private room,80,0,0.04,80
9003,Juliana,2,Entire home/apt,105,0,0.18,105
9004,Stat,2,Private room,47,144,0.07,191
9005,Dimitrios,3,Entire home/apt,75,0,0.04,75
9006,Stat,2,Private room,47,259,0.06,306
9008,Nora,1,Private room,100,0,0.02,100
9009,Xiangyu,3,Private room,85,0,0.02,85
9010,Vero,1,Entire home/apt,269,11,0.66,280
9011,Brittany Nicole,1,Entire home/apt,70,0,0.03,70
9012,Carlota,2,Private room,90,37,0.4,127
9013,Brian,1,Private room,172,0,0.17,172
9014,Andrew,2,Entire home/apt,160,0,0.02,160
9015,Nick,1,Entire home/apt,198,0,0.07,198
9016,Michael,1,Entire home/apt,154,0,0.81,154
9017,Aude,2,Entire home/apt,230,272,0.13,502
9018,Kat,2,Entire home/apt,285,19,0.36,304
9019,Emilie,2,Entire home/apt,180,0,0.06,180
9020,Selim,1,Private room,90,0,0.24,90
9023,Katherine,1,Entire home/apt,99,0,1.17,99
9024,Chris,1,Entire home/apt,111,0,0.13,111
9025,Sandy,2,Private room,40,0,0.11,40
9026,Erica,2,Private room,35,157,0.06,192
9027,Alexia,1,Private room,95,0,0.02,95
9028,Phyl,2,Private room,89,0,0.04,89
9029,Juliana,1,Entire home/apt,195,304,0.2,499
9030,Paul,2,Entire home/apt,139,281,3.26,420
9031,Svjetlana,1,Private room,75,20,0.29,95
9032,Loren,3,Entire home/apt,100,0,0.04,100
9033,Gael,2,Entire home/apt,149,0,0.15,149
9035,Kim,1,Entire home/apt,900,340,0.58,1240
9036,Rinat,2,Entire home/apt,199,0,0.06,199
9037,Erika,2,Private room,70,0,0.02,70
9039,John,1,Shared room,800,0,0.02,800
9040,Lilia,1,Private room,43,324,0.12,367
9041,Gidon,2,Entire home/apt,229,0,0.46,229
9042,Paloma,1,Entire home/apt,195,0,0.31,195
9043,Ameira,2,Entire home/apt,150,0,0.06,150
9044,Libertad,4,Entire home/apt,100,284,1.17,384
9045,Josh,1,Entire home/apt,700,0,0.16,700
9047,Eric,1,Entire home/apt,300,0,0.21,300
9048,Jack,1,Private room,100,0,0.23,100
9049,Loralee,2,Private room,50,0,0.1,50
9050,Esther,1,Entire home/apt,140,0,1.18,140
9052,Ning,1,Entire home/apt,185,0,0.06,185
9054,Raul,2,Entire home/apt,250,0,0.04,250
9055,Andre,1,Private room,89,0,0.02,89
9057,Andre,1,Private room,89,0,0.02,89
9059,Amy,1,Entire home/apt,220,54,0.12,274
9060,Matthew,1,Private room,135,0,0.02,135
9061,Gabriel,2,Entire home/apt,160,356,1.43,516
9063,Jenna,3,Entire home/apt,110,0,0.29,110
9064,Nate',1,Entire home/apt,76,0,0.06,76
9065,Samir,3,Entire home/apt,105,0,0.1,105
9066,Fabiana,2,Entire home/apt,120,0,0.03,120
9067,Khaled,1,Entire home/apt,110,0,0.06,110
9068,Pamela,1,Entire home/apt,125,0,0.09,125
9070,Emily,2,Entire home/apt,105,74,1.02,179
9071,Rafael,1,Private room,100,0,0.04,100
9072,AFI Apartments,1,Entire home/apt,118,258,0.09,376
9073,Brittany,2,Private room,70,0,0.03,70
9074,Gideon,2,Entire home/apt,220,277,2.51,497
9075,Reinier,1,Entire home/apt,155,0,0.21,155
9076,Daniel,2,Private room,85,0,0.42,85
9077,Sean,2,Private room,40,257,1.12,297
9078,Janice,1,Entire home/apt,85,309,0.75,394
9079,Isiah,1,Entire home/apt,84,0,0.21,84
9080,Ben,1,Entire home/apt,150,1,0.05,151
9081,Jose And Ysaira,4,Private room,50,316,0.47,366
9082,Rebecca & Warren,2,Entire home/apt,250,0,0.49,250
9083,Shirly,1,Private room,70,0,1.57,70
9085,Stephanie,2,Entire home/apt,164,0,0.04,164
9086,Rabie,2,Entire home/apt,120,0,0.02,120
9089,Thomas,2,Entire home/apt,224,0,0.02,224
9090,Grace,2,Private room,47,8,0.19,55
9091,Jennifer,2,Private room,61,5,0.59,66
9092,Nima,1,Entire home/apt,999,0,0.02,999
9093,Charlotte,1,Entire home/apt,230,0,0.02,230
9094,Juliana,1,Entire home/apt,150,298,0.27,448
9095,Juliana,1,Entire home/apt,115,331,0.26,446
9096,Sebastian,3,Private room,70,0,0.16,70
9097,Juliana,1,Entire home/apt,325,191,0.21,516
9098,Juliana,1,Entire home/apt,155,295,0.14,450
9099,Juliana,1,Entire home/apt,165,346,0.22,511
9100,Juliana,1,Entire home/apt,165,280,0.2,445
9101,Juliana,1,Entire home/apt,155,339,0.27,494
9102,Maxwell,1,Private room,150,0,0.14,150
9103,Juliana,1,Entire home/apt,130,303,0.26,433
9104,Juliana,1,Entire home/apt,125,202,0.38,327
9106,Terry,2,Private room,55,0,0.04,55
9107,Drew,1,Entire home/apt,155,0,0.08,155
9108,Rawan,2,Private room,80,0,0.25,80
9110,Gaby,2,Private room,40,0,0.02,40
9111,Ryan,1,Private room,99,0,0.26,99
9112,Lou,3,Private room,59,0,2.23,59
9113,Ryan,1,Entire home/apt,300,0,0.05,300
9114,Felicia,3,Private room,55,0,0.1,55
9115,Robert,2,Entire home/apt,125,0,0.13,125
9116,Zack,1,Private room,139,20,0.5,159
9117,Peter,2,Entire home/apt,165,0,0.02,165
9118,Hana,2,Private room,50,0,0.02,50
9119,Carlotta,2,Entire home/apt,150,0,0.06,150
9120,Sarah,1,Private room,65,93,4.22,158
9122,Juliana,1,Entire home/apt,120,339,0.24,459
9123,Juliana,1,Entire home/apt,115,325,0.19,440
9124,Laramie,2,Private room,51,14,0.41,65
9126,Laura,2,Entire home/apt,90,0,0.25,90
9127,David,3,Private room,75,0,0.02,75
9128,Matt,1,Entire home/apt,190,4,0.51,194
9129,Maritza,1,Entire home/apt,130,0,0.02,130
9130,Ingrid,1,Private room,80,0,3.05,80
9133,Kandee,1,Private room,150,0,0.04,150
9134,Byron,1,Private room,75,332,0.25,407
9135,Ota,2,Private room,50,5,0.04,55
9136,Mel,2,Private room,60,281,3.52,341
9137,Jessica,2,Entire home/apt,140,0,0.02,140
9140,Greg,2,Entire home/apt,110,12,0.31,122
9141,Xristina&Keith,2,Entire home/apt,100,24,0.26,124
9142,Enrica,1,Private room,70,0,0.06,70
9143,Robert,1,Entire home/apt,195,1,0.54,196
9144,Ange,2,Private room,125,310,0.19,435
9145,Allie,1,Entire home/apt,95,4,0.06,99
9146,Keith,2,Private room,30,0,0.02,30
9148,Markus,1,Entire home/apt,99,0,0.1,99
9149,Louise,1,Entire home/apt,165,0,0.04,165
9150,Doug,2,Entire home/apt,95,1,0.1,96
9151,Kathrine,3,Private room,10000,0,0.04,10000
9152,Joo,3,Entire home/apt,149,0,0.09,149
9153,Yann,1,Entire home/apt,190,275,1.27,465
9154,Patricia,1,Entire home/apt,177,0,0.45,177
9156,Donna,2,Private room,65,117,3.17,182
9158,Steve,2,Entire home/apt,110,0,0.04,110
9159,John,2,Private room,35,0,0.02,35
9160,Glender,2,Private room,75,256,0.94,331
9161,Delesia,1,Private room,52,0,0.03,52
9162,Kim,2,Entire home/apt,160,138,0.83,298
9163,Linda,2,Entire home/apt,100,0,0.11,100
9164,Simona,2,Private room,90,280,0.37,370
9167,Sarah,2,Private room,99,189,0.08,288
9168,Frances,2,Entire home/apt,220,0,0.04,220
9169,Katie,1,Private room,45,0,0.09,45
9172,Steve,1,Private room,105,190,0.55,295
9173,Mifan,1,Private room,50,0,0.06,50
9174,Be,1,Entire home/apt,222,281,2.16,503
9175,Sarah,2,Entire home/apt,120,0,0.08,120
9177,Christina,2,Private room,34,192,0.59,226
9178,Laszlo Jakab,2,Entire home/apt,130,0,0.02,130
9179,Rebecca,2,Entire home/apt,205,0,0.06,205
9180,Israel,2,Entire home/apt,150,271,2.6,421
9181,Drew,1,Entire home/apt,149,0,0.1,149
9183,Sarah,3,Shared room,50,0,0.02,50
9186,Elena,1,Entire home/apt,240,0,0.02,240
9187,Jayanthi,2,Private room,48,0,1.12,48
9188,Irving,2,Entire home/apt,90,347,0.53,437
9189,Boris,1,Private room,85,321,1.96,406
9190,Francisco,1,Private room,70,0,0.1,70
9192,Emily And Joel,2,Private room,139,0,3.86,139
9194,Vitaly,1,Entire home/apt,153,305,1.61,458
9196,Annika,2,Entire home/apt,285,0,0.13,285
9198,Michael,2,Private room,50,349,2.95,399
9199,Stonie,2,Private room,35,0,0.06,35
9200,Nikki,2,Entire home/apt,115,0,0.04,115
9201,Guida,1,Private room,73,242,0.08,315
9202,Juan,2,Entire home/apt,180,211,2.53,391
9203,Carmen,3,Private room,60,364,4.38,424
9204,Amber,2,Private room,50,279,0.7,329
9205,Brad,2,Private room,58,81,1.01,139
9207,Vladimir,3,Entire home/apt,250,300,1.82,550
9208,Lou,2,Entire home/apt,499,0,0.08,499
9209,Margaret,1,Entire home/apt,159,0,0.17,159
9210,Taylor,2,Entire home/apt,140,5,1.35,145
9211,Kalin,1,Entire home/apt,850,268,3.78,1118
9214,Lawrence,1,Entire home/apt,245,346,0.35,591
9216,Felipe,1,Private room,130,0,0.16,130
9218,Mifan,1,Private room,50,0,0.02,50
9220,Christopher,3,Entire home/apt,155,0,0.1,155
9222,Jeremy,3,Private room,27,0,0.07,27
9223,Carol,1,Private room,60,0,1.94,60
9224,Miriam,2,Private room,120,0,1.68,120
9225,Jeannie,2,Private room,103,358,2.63,461
9229,David,2,Private room,85,0,0.02,85
9230,Dalton,3,Entire home/apt,150,179,0.19,329
9231,Samriti,1,Entire home/apt,220,6,1.75,226
9232,Jason,1,Entire home/apt,160,180,0.95,340
9235,Laureen,1,Entire home/apt,140,0,0.18,140
9236,Sam,1,Entire home/apt,500,85,0.75,585
9238,Kara,2,Private room,140,0,0.43,140
9239,Hector And Miriam,2,Private room,80,0,0.02,80
9240,Besinfe,1,Private room,70,348,2.99,418
9241,Jen,1,Entire home/apt,150,0,0.31,150
9242,Kalpana,1,Entire home/apt,195,0,0.15,195
9244,Andrew,3,Entire home/apt,125,0,0.14,125
9245,AFI Apartments,1,Entire home/apt,120,209,0.08,329
9246,Chris,1,Entire home/apt,275,59,1.2,334
9248,Travis,2,Private room,60,0,0.02,60
9249,Andy,1,Private room,89,317,0.18,406
9250,Francesco,1,Entire home/apt,243,149,1.1,392
9252,Christopher,2,Private room,50,0,0.06,50
9254,Hui & Jon,2,Entire home/apt,150,8,0.23,158
9255,Consuelo,2,Entire home/apt,250,0,0.06,250
9256,Alejandro,2,Private room,109,14,2.54,123
9258,David,2,Entire home/apt,272,0,0.06,272
9259,Olivia,2,Private room,100,0,0.02,100
9260,Mary,2,Entire home/apt,170,0,0.08,170
9261,Neil,1,Entire home/apt,175,0,0.11,175
9262,Sasha,2,Private room,85,0,0.02,85
9263,Javier,1,Entire home/apt,150,0,0.02,150
9264,Bronson & Sam,1,Shared room,116,42,2.07,158
9265,Danni,1,Private room,100,0,0.02,100
9266,Alexander,1,Entire home/apt,350,0,0.15,350
9267,John And Kelsey,1,Private room,80,144,2.29,224
9268,Bryan,3,Entire home/apt,80,12,0.35,92
9269,Jermaine Antonio,2,Entire home/apt,110,222,2.16,332
9270,Amanda,2,Entire home/apt,267,1,0.42,268
9273,Benjamin,2,Private room,55,0,0.04,55
9274,Madi,3,Entire home/apt,398,82,1.28,480
9275,Ryan,1,Private room,80,0,0.06,80
9276,Christina,2,Entire home/apt,125,308,0.11,433
9277,Gina,2,Private room,38,335,0.87,373
9278,Jacky,2,Private room,80,189,0.52,269
9279,Ryan,1,Entire home/apt,299,315,3.39,614
9280,Nikolas,1,Entire home/apt,125,0,0.04,125
9282,Vida,2,Entire home/apt,129,357,0.08,486
9283,Rachel,1,Entire home/apt,190,358,0.75,548
9284,Dan,1,Private room,90,0,0.02,90
9285,Svetlana,1,Private room,83,255,3.72,338
9288,Naomi,1,Entire home/apt,198,301,0.11,499
9289,Gwendolyn,1,Entire home/apt,149,0,0.3,149
9290,Julianna,2,Entire home/apt,120,0,0.13,120
9291,Adriana,2,Entire home/apt,143,10,0.04,153
9292,Olta,1,Private room,120,0,0.02,120
9294,Kandee,1,Private room,150,0,1.05,150
9296,Kevin,1,Private room,110,0,0.02,110
9297,John,2,Entire home/apt,125,0,0.67,125
9298,Alexis,1,Entire home/apt,270,335,0.92,605
9299,Mckinley,2,Entire home/apt,110,290,0.81,400
9300,Stacey,1,Entire home/apt,145,0,0.16,145
9301,Andrea,2,Entire home/apt,190,0,0.04,190
9302,Kudjo,1,Entire home/apt,250,0,0.1,250
9303,Amber,1,Private room,45,0,0.03,45
9304,Alexandra,2,Entire home/apt,200,357,0.19,557
9305,Anna,1,Entire home/apt,187,0,0.02,187
9307,Amber,2,Shared room,29,288,2.11,317
9308,Shira,2,Entire home/apt,100,0,0.17,100
9309,Shahar,2,Entire home/apt,90,302,0.15,392
9311,Shahar,2,Private room,85,316,0.14,401
9313,Mario,2,Private room,43,0,0.13,43
9314,Moe,2,Entire home/apt,145,287,4.26,432
9315,Jake,2,Private room,65,0,0.78,65
9316,Leila,2,Private room,45,0,0.04,45
9317,Latoya,3,Entire home/apt,130,322,1.65,452
9318,Gill,1,Entire home/apt,99,45,2.08,144
9322,Hila,2,Entire home/apt,149,0,0.02,149
9323,Maya,3,Private room,45,166,9.63,211
9324,Aryeh,1,Entire home/apt,140,0,0.09,140
9328,Thibault,3,Entire home/apt,70,0,0.21,70
9329,Caitlin,2,Private room,70,21,0.11,91
9331,Alyson,2,Private room,95,3,1.01,98
9332,Akash,1,Entire home/apt,169,0,0.17,169
9333,Roberta & Rob,2,Entire home/apt,110,0,0.29,110
9335,Rachid,2,Private room,75,362,0.46,437
9337,Ashraful,3,Private room,85,177,0.67,262
9338,Harry,2,Entire home/apt,97,292,2.75,389
9341,Andrea,1,Private room,120,2,0.32,122
9342,Jenny,3,Private room,109,344,1.78,453
9343,David,1,Entire home/apt,159,0,0.17,159
9344,Christina,1,Private room,75,0,0.02,75
9346,Norman,3,Private room,99,322,0.06,421
9348,Ali,2,Private room,65,0,0.16,65
9350,Hadrien,2,Private room,95,0,0.17,95
9351,Angelle,2,Entire home/apt,120,60,1.83,180
9353,David,2,Entire home/apt,135,5,3.58,140
9354,Dov,2,Entire home/apt,115,0,0.09,115
9355,Steven,2,Private room,100,0,0.37,100
9356,Andreias,1,Private room,99,251,4.56,350
9357,Juju,1,Entire home/apt,148,8,0.19,156
9358,Sonia,2,Entire home/apt,150,0,0.06,150
9360,Bronson & Sam,1,Entire home/apt,349,157,0.65,506
9361,Rebecka,1,Entire home/apt,165,0,0.1,165
9362,Karen,2,Entire home/apt,95,0,0.08,95
9363,Allison,2,Entire home/apt,129,157,0.41,286
9364,Ana,1,Private room,250,130,0.37,380
9365,Dana,1,Entire home/apt,700,0,0.02,700
9367,Maria,1,Entire home/apt,165,0,0.03,165
9368,Cecilia,2,Entire home/apt,450,263,0.17,713
9369,Maria,1,Entire home/apt,120,0,0.15,120
9371,Andrew And Talia,2,Private room,55,0,0.98,55
9373,Brian,2,Private room,35,0,0.16,35
9374,Stephanie,2,Entire home/apt,110,0,0.04,110
9375,Brian,1,Entire home/apt,500,2,0.23,502
9376,Natasha,1,Private room,99,0,0.08,99
9378,Emma,2,Entire home/apt,168,0,0.41,168
9379,Andrew,2,Entire home/apt,200,0,0.59,200
9380,Tina,1,Entire home/apt,355,116,1.03,471
9381,Doug,1,Entire home/apt,190,0,0.19,190
9382,Craig,2,Entire home/apt,99,0,0.04,99
9383,Andrew,1,Entire home/apt,180,0,0.19,180
9384,Carly,1,Entire home/apt,145,0,0.23,145
9385,Rachel,2,Private room,55,0,0.02,55
9386,Caroline,2,Private room,65,158,0.11,223
9387,Elizabeth,2,Entire home/apt,130,36,3.16,166
9388,Brooks,1,Private room,68,0,0.02,68
9391,Aleksandar,1,Entire home/apt,160,1,0.53,161
9392,Jason,2,Entire home/apt,98,217,1.92,315
9393,Wes,2,Private room,90,226,5.41,316
9395,Anna,2,Private room,125,166,3.16,291
9397,Rachel,2,Entire home/apt,95,0,0.11,95
9398,Ayesha,1,Entire home/apt,130,0,0.39,130
9399,Natalie,2,Entire home/apt,130,0,0.06,130
9401,Debbie,2,Entire home/apt,125,80,0.37,205
9402,Ella,1,Entire home/apt,165,0,0.21,165
9403,Brendan,2,Private room,90,89,0.24,179
9405,Ali,1,Private room,65,0,1.97,65
9406,Autumn,2,Private room,66,0,0.13,66
9407,Tracey,2,Entire home/apt,225,242,2.48,467
9409,Nataraj,3,Private room,59,365,0.09,424
9410,Joyce,1,Private room,90,0,0.06,90
9411,Kirsti,1,Private room,125,0,0.08,125
9412,Kate,2,Entire home/apt,450,207,0.1,657
9413,Mark,2,Private room,50,0,0.09,50
9414,Katherine,2,Entire home/apt,124,0,0.1,124
9415,Natalie,2,Private room,29,0,0.65,29
9416,Yasmin,2,Entire home/apt,86,0,0.02,86
9417,Fon,1,Private room,86,0,0.04,86
9418,Tony,2,Entire home/apt,299,0,0.38,299
9419,Eddie,2,Private room,36,0,0.06,36
9420,Fay,2,Private room,100,359,0.33,459
9421,Ariel,1,Entire home/apt,110,263,0.23,373
9422,Tina,1,Entire home/apt,450,1,4.24,451
9424,Adriana,2,Private room,55,306,1.23,361
9425,Adriana,2,Private room,55,281,0.8,336
9427,Adam,1,Private room,71,0,2.99,71
9429,Jessica,2,Private room,63,0,0.08,63
9431,Evan,2,Entire home/apt,250,225,0.24,475
9432,Kim,2,Entire home/apt,159,31,0.3,190
9434,Gabriel,1,Private room,70,0,0.02,70
9435,Talal,1,Entire home/apt,120,0,0.13,120
9436,Justin You,1,Entire home/apt,75,0,0.02,75
9438,Jocelyn,2,Entire home/apt,90,8,0.19,98
9439,Chavi,1,Entire home/apt,233,14,0.21,247
9440,John And Laurie,1,Entire home/apt,115,0,0.04,115
9441,Steph,2,Private room,65,0,0.12,65
9442,Greg,2,Entire home/apt,80,217,1.01,297
9443,Sarah,1,Private room,65,0,0.08,65
9444,Edward,1,Private room,139,0,0.23,139
9446,Nicholas,2,Entire home/apt,66,0,0.06,66
9448,Rosie,1,Entire home/apt,200,188,0.37,388
9449,Marianna,1,Entire home/apt,175,34,0.92,209
9450,Desmond,3,Entire home/apt,96,21,3.14,117
9451,Marcus,1,Private room,100,2,0.27,102
9452,Sarah,2,Private room,44,0,0.02,44
9453,Kim,2,Entire home/apt,175,13,0.1,188
9454,Jenni,2,Entire home/apt,600,174,0.25,774
9455,Addie,2,Private room,32,0,0.15,32
9456,Ana,1,Private room,98,149,3.03,247
9457,Alan,1,Entire home/apt,219,2,0.62,221
9458,Ali,1,Entire home/apt,175,0,0.36,175
9459,Kimberly,1,Entire home/apt,120,0,0.37,120
9460,John,1,Entire home/apt,140,0,0.02,140
9461,Conrad,2,Private room,84,319,4.24,403
9462,Emma,1,Entire home/apt,80,0,0.02,80
9463,Akira,2,Private room,45,258,1.91,303
9468,Ramona,2,Private room,38,0,0.04,38
9469,Jessica,1,Entire home/apt,120,0,0.27,120
9471,Melissa,1,Entire home/apt,140,0,0.04,140
9472,Francesco,2,Private room,70,115,0.04,185
9473,Olivier,1,Entire home/apt,200,25,0.25,225
9474,Ming,2,Private room,89,255,2.17,344
9475,Tim,1,Private room,250,345,0.24,595
9476,Robin,2,Entire home/apt,125,10,0.23,135
9477,Amelia,1,Shared room,47,0,0.04,47
9478,Lina,1,Entire home/apt,160,238,3.21,398
9481,Caroline,2,Private room,65,158,0.13,223
9482,Caroline,2,Private room,63,306,0.07,369
9484,Brooklyn,2,Entire home/apt,178,201,3.4,379
9486,Kristine,1,Entire home/apt,170,0,0.11,170
9487,Laura,3,Private room,50,339,4.37,389
9488,Jada,2,Entire home/apt,295,1,0.04,296
9489,Sabrina,1,Private room,100,0,0.06,100
9490,Lucia,1,Private room,65,0,0.02,65
9492,Hayley,2,Entire home/apt,90,0,0.02,90
9493,Susi,3,Entire home/apt,158,311,2.71,469
9494,Chris,1,Entire home/apt,450,188,1.04,638
9497,Tatiana,2,Private room,130,188,0.28,318
9498,Igor,3,Private room,70,8,2.84,78
9499,Liz,2,Private room,70,0,0.06,70
9501,Carol,1,Entire home/apt,170,4,0.3,174
9503,James,1,Entire home/apt,480,0,0.04,480
9504,Emily,2,Entire home/apt,120,0,0.05,120
9505,Amanda,1,Entire home/apt,299,257,1.52,556
9507,Vasily,2,Private room,45,0,0.1,45
9508,Seth,2,Private room,70,0,0.09,70
9509,Claire,2,Private room,49,0,0.02,49
9510,Ruth,1,Private room,115,0,0.02,115
9511,Nathaniel,1,Private room,55,0,0.22,55
9512,Melody,2,Private room,55,0,0.02,55
9513,Casandra,1,Entire home/apt,250,341,1.83,591
9514,Mark,2,Entire home/apt,399,18,0.31,417
9515,Daniel & Lia,2,Entire home/apt,198,5,0.09,203
9516,Joan,2,Entire home/apt,78,0,0.02,78
9517,Suvi,2,Entire home/apt,200,0,0.02,200
9518,Rushil,1,Entire home/apt,300,0,0.02,300
9519,Carina,2,Entire home/apt,225,0,0.06,225
9520,Yulia,1,Entire home/apt,650,23,0.51,673
9521,Lauren,2,Private room,53,0,0.15,53
9522,Antoine,1,Entire home/apt,159,22,0.46,181
9523,Yohan,1,Private room,65,342,0.08,407
9525,Dor,1,Private room,120,99,1.82,219
9526,Adam,1,Entire home/apt,280,225,0.09,505
9527,Benjamin,2,Private room,60,0,0.87,60
9528,R Demetre,2,Private room,100,365,0.04,465
9529,Chris,1,Private room,160,0,0.13,160
9530,Ashley,3,Private room,45,0,0.02,45
9531,Johnathan Boev,3,Private room,39,0,0.04,39
9533,Zeina,1,Entire home/apt,120,9,1.23,129
9534,Kimberly,2,Private room,99,0,0.17,99
9535,Kenya,1,Private room,129,0,0.1,129
9536,J,2,Entire home/apt,350,81,1.21,431
9537,Clara,1,Entire home/apt,300,0,0.02,300
9538,Tiffany,2,Entire home/apt,140,0,0.08,140
9539,Rachel,1,Entire home/apt,120,0,0.05,120
9540,Ruth,2,Private room,64,184,2.65,248
9541,Julianne,2,Entire home/apt,120,0,0.04,120
9542,Sharlene,1,Private room,40,48,0.27,88
9543,Maria,1,Entire home/apt,120,0,0.15,120
9545,Emma,2,Entire home/apt,150,0,0.21,150
9546,Andrew,1,Entire home/apt,650,90,0.29,740
9547,Clayton,1,Private room,100,0,0.68,100
9548,James,3,Entire home/apt,290,338,1.59,628
9549,Wes,2,Entire home/apt,120,0,0.11,120
9552,Philip,1,Entire home/apt,235,126,2.38,361
9553,Drew,1,Private room,95,0,0.21,95
9555,Ariel,1,Entire home/apt,280,116,0.05,396
9556,Jeff,1,Entire home/apt,195,189,0.62,384
9557,Aly,1,Entire home/apt,100,0,0.29,100
9558,Curtis,2,Entire home/apt,100,0,0.14,100
9559,Andre,3,Entire home/apt,130,0,0.13,130
9560,Cate,1,Entire home/apt,130,0,0.04,130
9561,Leon,2,Private room,125,312,0.57,437
9562,Leon,2,Entire home/apt,130,340,0.73,470
9563,Gregory,4,Entire home/apt,120,345,3.1,465
9564,Tammy,1,Entire home/apt,180,70,0.06,250
9565,Kristy,1,Private room,80,22,2.03,102
9566,Kerry,1,Entire home/apt,250,0,0.04,250
9568,Arnold,2,Entire home/apt,166,0,0.13,166
9569,Clara,1,Private room,64,0,0.02,64
9570,Fiona,2,Private room,35,0,0.03,35
9571,Martina,1,Entire home/apt,120,0,0.03,120
9572,Ian,2,Private room,60,0,0.16,60
9573,Don,2,Entire home/apt,215,0,0.02,215
9574,Karen,2,Private room,58,178,5.13,236
9576,Viviana,2,Private room,40,24,1.47,64
9577,Ricky,1,Private room,78,55,0.09,133
9578,Matt,1,Private room,80,0,0.02,80
9579,Alice,1,Shared room,80,0,0.04,80
9580,JaimeLee & Travis,2,Entire home/apt,159,1,0.19,160
9583,Nick And Julia,1,Private room,145,134,3.16,279
9584,Jennifer,1,Private room,130,0,0.04,130
9586,Quinn,2,Entire home/apt,100,0,0.04,100
9587,Deidrea,2,Private room,63,0,0.04,63
9589,Loreta,1,Entire home/apt,189,239,0.47,428
9590,Ian,2,Entire home/apt,99,0,0.04,99
9592,Chantal,1,Private room,35,0,0.02,35
9593,Yoav,1,Entire home/apt,200,0,0.13,200
9594,Jakob,1,Private room,35,0,0.05,35
9595,Jennifer,1,Private room,60,0,0.02,60
9596,Hanna,2,Private room,80,281,0.17,361
9597,Babita,1,Entire home/apt,199,0,0.42,199
9598,Ari,1,Entire home/apt,174,322,0.43,496
9600,Karen,1,Private room,120,362,1.16,482
9601,Melissa,2,Entire home/apt,98,0,0.02,98
9602,Alexi,1,Private room,119,0,0.08,119
9604,Philip,2,Private room,75,233,2.33,308
9605,Paul,2,Entire home/apt,450,337,0.76,787
9606,Klara,2,Private room,55,342,0.19,397
9607,Randy,2,Private room,64,0,0.5,64
9609,Saga,1,Private room,106,0,0.04,106
9610,Paul,2,Private room,45,0,0.35,45
9611,Andrew,1,Private room,125,0,0.04,125
9612,Stanley,1,Private room,70,0,0.04,70
9613,Zack,1,Private room,40,0,0.04,40
9615,Maria,3,Private room,85,163,0.06,248
9616,Robert,2,Entire home/apt,75,0,0.08,75
9617,Mike,1,Entire home/apt,175,31,0.24,206
9619,Andrew,1,Private room,150,0,0.02,150
9620,Alex,2,Entire home/apt,129,256,0.93,385
9622,Seb,2,Private room,80,210,1.64,290
9625,Noëmi,1,Private room,120,0,0.37,120
9626,Joanne,2,Entire home/apt,100,0,0.04,100
9628,Nathaniel,2,Private room,35,0,0.06,35
9629,Michael,2,Entire home/apt,269,0,0.02,269
9630,Daniel,1,Private room,45,0,0.04,45
9631,Nicholas,1,Entire home/apt,185,0,0.02,185
9632,Sarah,1,Entire home/apt,120,200,0.08,320
9633,Caitlin,1,Private room,97,0,0.04,97
9635,Sean,2,Entire home/apt,150,0,0.12,150
9636,Shaquana,2,Entire home/apt,135,0,0.59,135
9638,Josh,2,Private room,47,0,0.04,47
9639,Dusan,3,Entire home/apt,120,0,0.06,120
9640,William,2,Entire home/apt,100,0,0.23,100
9642,NYC Hostess,1,Entire home/apt,245,198,0.3,443
9643,Alexander,1,Entire home/apt,150,0,0.02,150
9645,Nadine,1,Private room,95,72,0.03,167
9646,EmiLy,1,Entire home/apt,120,0,0.08,120
9647,John,1,Private room,145,0,1.3,145
9648,Louis,2,Entire home/apt,109,170,0.61,279
9649,Andrew,2,Private room,80,0,0.04,80
9650,Samantha,2,Entire home/apt,105,0,0.15,105
9652,Elwanda,2,Entire home/apt,125,217,2.72,342
9653,David,1,Private room,80,0,0.02,80
9654,Sholeh,1,Entire home/apt,140,0,0.04,140
9655,Matt,1,Entire home/apt,250,0,0.44,250
9657,Pippa,1,Entire home/apt,450,0,0.02,450
9658,Nick,2,Entire home/apt,120,43,0.17,163
9660,Rosalia,1,Entire home/apt,150,0,0.02,150
9662,Jess,3,Entire home/apt,110,0,0.19,110
9663,Michal,2,Entire home/apt,165,134,3.7,299
9664,Jana,1,Private room,69,64,0.03,133
9665,Jana,1,Private room,69,32,0.08,101
9666,Jean,2,Private room,180,89,0.5,269
9667,Emmanuel,1,Private room,40,0,0.05,40
9668,Tanya,2,Private room,40,0,0.09,40
9669,Carl,3,Private room,109,365,0.08,474
9670,Crystal,1,Private room,100,0,0.34,100
9671,Stefanie,2,Private room,70,0,0.06,70
9672,Tricia,1,Entire home/apt,198,0,0.02,198
9673,Allon,2,Private room,50,0,0.08,50
9674,Patricia,2,Entire home/apt,130,210,2.2,340
9675,Su,2,Entire home/apt,135,0,0.13,135
9678,J And Lana,2,Private room,108,344,1.24,452
9679,Meredith,1,Entire home/apt,595,332,0.63,927
9680,Maud,2,Entire home/apt,129,0,0.04,129
9681,Jen,1,Private room,88,0,0.43,88
9682,Lance,3,Private room,75,363,0.6,438
9684,Mariza,1,Private room,70,145,0.06,215
9685,Rachael,2,Entire home/apt,185,0,0.06,185
9686,Margo,2,Entire home/apt,145,0,0.1,145
9687,Kestrel,2,Entire home/apt,150,0,0.02,150
9689,Brooklyn&   Breakfast    -Len-,2,Private room,70,320,5.45,390
9690,Emmanuelle,2,Entire home/apt,150,248,0.77,398
9691,Hilary,2,Private room,100,89,0.26,189
9692,Jason,1,Private room,69,0,0.02,69
9693,Casey,2,Entire home/apt,115,127,1.37,242
9694,Arty,1,Entire home/apt,120,28,0.56,148
9695,Gabe,1,Entire home/apt,180,0,0.63,180
9696,Peter,2,Entire home/apt,147,191,2.5,338
9697,Carver,2,Entire home/apt,125,0,0.12,125
9698,Bo,1,Entire home/apt,328,298,3.05,626
9699,James,2,Entire home/apt,85,0,0.13,85
9700,Biruta,2,Entire home/apt,60,0,0.21,60
9701,Paul,2,Private room,60,0,0.15,60
9704,Juan,2,Entire home/apt,150,290,3.97,440
9705,Aude,2,Private room,95,1,2.57,96
9706,Lisa,2,Entire home/apt,185,333,1.25,518
9707,Kimberly,2,Private room,89,38,4.42,127
9708,Natasha,2,Entire home/apt,67,142,4.08,209
9709,Guerline,2,Entire home/apt,125,195,2.67,320
9710,Pierre,1,Private room,80,0,0.08,80
9711,Alexandra,2,Entire home/apt,199,0,0.08,199
9715,Shawn,2,Entire home/apt,360,76,0.72,436
9716,Hannah And Michael,2,Entire home/apt,200,0,0.02,200
9717,Barbara & Andrzej,3,Private room,80,1,0.89,81
9718,Sean,2,Entire home/apt,400,365,0.2,765
9719,Ben,2,Private room,65,11,0.15,76
9720,Ramiro,2,Private room,70,0,0.17,70
9721,Eric,2,Private room,85,0,0.58,85
9723,Cam,2,Entire home/apt,68,0,0.15,68
9725,Lary,2,Entire home/apt,130,0,0.08,130
9726,Benjamin,1,Entire home/apt,215,8,2.02,223
9727,Taylor,1,Entire home/apt,165,0,0.8,165
9728,Jennie,1,Private room,100,0,0.12,100
9729,Gennadiy,2,Entire home/apt,85,0,0.02,85
9731,Heidi,2,Entire home/apt,105,0,0.31,105
9732,Blair,2,Entire home/apt,100,238,1.54,338
9733,Devin,1,Entire home/apt,499,201,3.11,700
9735,Natalie,2,Entire home/apt,150,0,0.09,150
9736,Kaivan,1,Private room,54,0,0.08,54
9737,Miyako,2,Entire home/apt,250,0,0.03,250
9738,William,2,Private room,40,365,0.56,405
9739,Nicole,3,Entire home/apt,95,0,0.03,95
9740,Kara,1,Entire home/apt,169,364,0.09,533
9742,Zachary,1,Entire home/apt,175,343,0.43,518
9743,Michael & Katherine,2,Entire home/apt,145,0,0.09,145
9745,Nanda,1,Entire home/apt,135,0,0.09,135
9746,Stacey,1,Entire home/apt,125,0,0.05,125
9748,Lorrin,1,Private room,100,0,0.2,100
9749,AFI Apartments,1,Entire home/apt,118,315,0.11,433
9750,Hui & Jon,2,Entire home/apt,172,247,2.99,419
9751,Kori,2,Private room,105,0,0.05,105
9752,Kori,2,Private room,55,0,0.04,55
9755,Monte,1,Private room,99,0,0.65,99
9756,Jenny,2,Entire home/apt,88,0,0.37,88
9757,Bobby,1,Private room,125,0,0.06,125
9758,Audra,2,Entire home/apt,102,296,1.38,398
9759,Caitlin,2,Private room,40,0,0.02,40
9760,Caroline,2,Entire home/apt,119,0,0.25,119
9761,Ted,2,Entire home/apt,101,0,1.14,101
9762,Justin,2,Private room,65,0,0.06,65
9763,Ikkyukim,4,Private room,40,333,0.32,373
9764,Alex,1,Entire home/apt,109,0,0.02,109
9765,Ikkyukim,4,Private room,40,343,0.44,383
9767,Mirlande,1,Private room,75,90,2.88,165
9768,Philbert,2,Private room,90,175,1.48,265
9769,Andrew,1,Private room,87,0,0.19,87
9770,Mark,1,Entire home/apt,185,0,0.65,185
9771,Keisher,2,Private room,45,0,0.48,45
9772,Rip,1,Private room,300,156,1.11,456
9773,Ingrid,2,Entire home/apt,140,1,0.4,141
9774,Cole,2,Private room,70,0,0.11,70
9776,Ricky,2,Private room,80,0,0.06,80
9778,Patrick,2,Private room,45,0,0.15,45
9779,Noel,2,Private room,40,0,0.02,40
9780,Chris,1,Entire home/apt,210,6,0.22,216
9781,John,2,Entire home/apt,225,268,0.49,493
9782,Chisom,1,Private room,70,0,0.02,70
9784,Sara,1,Entire home/apt,120,0,0.06,120
9786,Travis,1,Private room,133,263,3.9,396
9787,Julia,1,Private room,60,0,0.02,60
9788,Elizabeth,1,Private room,64,0,0.42,64
9789,Sade,1,Private room,69,261,0.56,330
9790,Mike,2,Private room,40,0,0.04,40
9791,Jen,1,Entire home/apt,190,0,0.06,190
9792,Brian,2,Entire home/apt,275,0,1.26,275
9793,Layka,1,Entire home/apt,200,271,4.27,471
9794,Jen,1,Private room,75,0,0.77,75
9795,Laura,2,Entire home/apt,180,0,0.04,180
9797,Lindsay,2,Private room,59,41,2.07,100
9798,Bettina,2,Entire home/apt,149,0,0.04,149
9799,Lila (Eli),2,Private room,55,46,2.22,101
9800,Eugene,1,Private room,75,0,0.27,75
9801,B,1,Entire home/apt,400,0,0.02,400
9802,Arthur,1,Entire home/apt,169,44,2.54,213
9803,Jasmine,1,Entire home/apt,125,0,0.15,125
9804,Ilean,2,Private room,58,0,1.97,58
9805,Morgan,1,Entire home/apt,151,0,0.41,151
9806,Jennifer,1,Entire home/apt,67,21,0.15,88
9808,Marcello,1,Entire home/apt,185,0,0.08,185
9809,Francesco,2,Entire home/apt,190,0,1.41,190
9810,T.,1,Private room,78,23,0.19,101
9811,Lila (Eli),2,Private room,60,40,4.0,100
9812,Paul,1,Entire home/apt,210,169,4.13,379
9813,Nicole,3,Entire home/apt,139,0,0.13,139
9814,Sara,1,Entire home/apt,200,0,0.26,200
9815,Graham,1,Private room,75,0,3.17,75
9816,Benjamin,2,Entire home/apt,123,342,0.19,465
9818,Benjamin,2,Entire home/apt,120,360,0.15,480
9819,Kyle,2,Private room,85,0,0.1,85
9820,Roula,3,Entire home/apt,122,271,2.34,393
9822,Moran,1,Entire home/apt,99,0,0.34,99
9823,Sarah And Mike,1,Private room,110,59,2.23,169
9826,Samantha,3,Private room,89,0,0.15,89
9827,Peter,2,Private room,48,0,0.17,48
9828,Graham And Ben,2,Private room,90,249,0.42,339
9829,Graham And Ben,2,Private room,90,314,0.66,404
9830,John,4,Entire home/apt,110,0,0.02,110
9831,Sophia,1,Entire home/apt,150,10,0.15,160
9832,Mareike,2,Entire home/apt,120,10,0.09,130
9833,Marlene,2,Entire home/apt,110,315,2.66,425
9834,Izabel,2,Private room,45,228,1.38,273
9835,Jackie,2,Private room,75,0,0.02,75
9836,A,3,Private room,65,355,3.35,420
9837,Mackenzie,1,Entire home/apt,170,0,0.09,170
9838,Ron,1,Entire home/apt,140,0,0.02,140
9840,Avantika,1,Entire home/apt,170,19,0.85,189
9841,Ana,1,Private room,90,164,3.1,254
9842,Andrew,2,Entire home/apt,175,0,0.11,175
9843,Jonathan,2,Entire home/apt,135,0,0.06,135
9845,Sam,1,Entire home/apt,175,0,0.02,175
9846,Melanie,2,Private room,40,0,0.04,40
9848,Quami,2,Private room,69,6,3.89,75
9850,Amanda,1,Private room,85,0,0.61,85
9852,Elle,1,Entire home/apt,155,0,0.02,155
9853,Hester,1,Entire home/apt,160,0,0.54,160
9854,Ronald,2,Private room,50,0,0.34,50
9855,Tal,1,Entire home/apt,125,0,0.03,125
9858,Kyle,2,Private room,65,0,0.04,65
9861,Chris,3,Private room,45,250,1.34,295
9862,Matt & Alex,2,Entire home/apt,139,188,0.45,327
9863,Easton,2,Entire home/apt,85,136,3.6,221
9864,Kenny,3,Entire home/apt,125,321,2.28,446
9865,Sabrina,1,Private room,115,0,0.38,115
9866,Nathalie,2,Entire home/apt,175,282,0.38,457
9869,Barbara & Andrzej,3,Private room,59,364,0.59,423
9870,Joshua,1,Private room,80,0,0.03,80
9871,Davey,2,Private room,50,0,0.21,50
9873,Drew,2,Entire home/apt,90,18,0.15,108
9874,Lee And Kara,2,Entire home/apt,250,0,0.7,250
9876,Marino,1,Entire home/apt,215,331,1.61,546
9877,Kameryn & Rob,1,Entire home/apt,180,0,0.14,180
9878,Clayton,1,Entire home/apt,250,0,0.38,250
9880,Zafrullah,1,Entire home/apt,700,0,0.02,700
9882,James,1,Private room,118,47,5.44,165
9884,Jennifer,2,Private room,70,22,0.39,92
9885,Marie,1,Entire home/apt,110,19,0.19,129
9886,A. Kaylee,1,Entire home/apt,299,304,1.96,603
9887,Marianne,1,Private room,95,0,0.08,95
9888,Kevin,1,Private room,70,0,0.04,70
9889,Rachel,1,Private room,167,188,0.92,355
9890,Bindia,1,Private room,103,221,1.49,324
9891,Aleksey,1,Entire home/apt,145,0,0.27,145
9892,Akini,2,Entire home/apt,100,300,3.93,400
9893,Craig,2,Entire home/apt,275,9,0.23,284
9894,John Conor,2,Private room,60,0,0.02,60
9895,Ashley,2,Private room,70,0,0.09,70
9896,Costas,1,Entire home/apt,300,89,0.09,389
9897,Andrew,2,Entire home/apt,370,257,3.14,627
9898,Grace,1,Private room,50,0,0.04,50
9900,Maxime,2,Private room,68,0,0.02,68
9901,Faigie,2,Private room,92,334,1.29,426
9903,Andraz,3,Entire home/apt,100,0,0.15,100
9904,David,1,Private room,140,204,0.6,344
9905,Jd,1,Private room,150,364,0.37,514
9906,Kelli,2,Private room,45,0,0.04,45
9907,Tijana,2,Private room,70,32,0.17,102
9908,Matthew,1,Entire home/apt,230,347,3.39,577
9910,Finley,3,Private room,80,0,0.56,80
9912,Daphne,2,Private room,40,0,0.07,40
9913,Brandon,1,Private room,90,0,0.43,90
9914,Doug,1,Entire home/apt,600,36,0.06,636
9915,Marisela,2,Private room,50,0,0.04,50
9916,Steven,2,Entire home/apt,195,18,1.77,213
9918,Aaron,1,Entire home/apt,250,0,0.24,250
9919,Sloane,1,Entire home/apt,175,0,0.08,175
9921,Alessandro,3,Entire home/apt,150,9,0.19,159
9922,Max,1,Entire home/apt,175,0,0.02,175
9925,Lauren,1,Private room,99,0,0.04,99
9926,Tuba,3,Private room,70,219,0.28,289
9927,Maksud,3,Private room,48,0,0.92,48
9928,Kazi,2,Entire home/apt,199,130,0.16,329
9929,Dan,1,Private room,90,0,0.13,90
9930,Frances,2,Entire home/apt,130,0,0.06,130
9932,Russ,2,Entire home/apt,175,27,0.17,202
9933,Jenny,2,Private room,48,0,0.06,48
9934,Kooky,2,Private room,70,323,1.89,393
9935,Douglas,2,Entire home/apt,380,0,0.11,380
9936,Regina,2,Private room,45,310,0.99,355
9937,Adam,2,Private room,55,0,0.1,55
9939,Neil,1,Entire home/apt,160,11,0.21,171
9940,James,1,Private room,107,0,0.04,107
9941,Robin & Bob,2,Entire home/apt,155,235,2.93,390
9942,Anatha Angèle,1,Entire home/apt,275,284,2.78,559
9943,Felix,2,Private room,80,0,0.7,80
9944,Manuela,1,Entire home/apt,205,0,0.61,205
9945,Elizabeth,1,Private room,150,0,0.04,150
9946,Abraham,2,Entire home/apt,99,58,0.49,157
9947,Brady,2,Private room,59,70,5.09,129
9948,Christopher,2,Private room,45,0,0.43,45
9949,Vanessa,1,Entire home/apt,270,270,4.26,540
9951,Ehsan,3,Entire home/apt,150,349,0.46,499
9952,Luca,2,Private room,35,0,0.02,35
9953,Gian Maria,1,Entire home/apt,99,0,0.11,99
9954,Thomas,2,Entire home/apt,150,0,0.19,150
9956,Joy,2,Private room,50,0,0.15,50
9957,Max,1,Entire home/apt,79,0,0.49,79
9958,Sharon,2,Entire home/apt,199,283,0.78,482
9960,Daphne,2,Private room,65,0,0.06,65
9962,Tanya,2,Private room,43,0,0.54,43
9963,RaVal,1,Entire home/apt,130,0,0.25,130
9964,Morgane,1,Entire home/apt,180,0,0.04,180
9966,Regina,2,Shared room,33,365,1.53,398
9967,Maryann,3,Private room,45,132,5.2,177
9968,Oates,2,Private room,65,0,0.73,65
9970,Theresa,2,Private room,50,0,0.04,50
9971,Marvin,3,Entire home/apt,150,0,0.04,150
9973,Andrea,2,Entire home/apt,99,216,0.23,315
9974,Gurpreet  Singh,3,Private room,50,0,8.86,50
9975,Kyle,2,Entire home/apt,250,322,0.16,572
9976,Gurpreet  Singh,3,Private room,50,0,8.56,50
9977,Priscilla,1,Private room,50,64,0.13,114
9978,Cj,1,Private room,100,342,0.3,442
9979,Yukee,1,Private room,59,326,0.68,385
9980,Chris,1,Private room,80,0,0.02,80
9981,Ingrid,2,Entire home/apt,95,0,0.09,95
9982,Sam,2,Entire home/apt,110,0,0.06,110
9983,Caitlin,2,Private room,60,0,0.03,60
9984,Blue & Elli,2,Private room,64,76,2.71,140
9985,Ana María,3,Entire home/apt,175,0,0.15,175
9986,Sarina,3,Entire home/apt,350,334,2.88,684
9987,Johanna,1,Private room,80,0,0.04,80
9988,Paul,1,Entire home/apt,200,205,1.06,405
9989,Joyce,2,Entire home/apt,128,3,0.21,131
9990,Miss Carolyn,2,Entire home/apt,150,332,0.29,482
9991,Jullien,2,Entire home/apt,100,220,2.63,320
9993,Jimmy,4,Private room,95,0,3.82,95
9995,Will,2,Entire home/apt,220,0,0.57,220
9996,Lisa,2,Entire home/apt,147,2,0.51,149
9997,Can,1,Private room,95,0,0.02,95
9998,Suzan,2,Entire home/apt,160,0,0.06,160
10001,Cassandra,2,Entire home/apt,225,94,2.28,319
10002,Ikkyukim,4,Private room,40,287,0.4,327
10004,Janet-David,2,Private room,120,349,4.39,469
10006,Ahnastasia,1,Private room,60,0,0.08,60
10007,Ingrid,2,Private room,100,365,0.05,465
10008,Keenan,2,Private room,77,0,0.25,77
10009,Karen,1,Entire home/apt,150,0,0.21,150
10010,Rachel,2,Entire home/apt,160,249,0.8,409
10012,Tarin,1,Private room,70,0,0.11,70
10013,Dolores,2,Entire home/apt,215,0,2.09,215
10015,Matthew,2,Private room,60,0,0.02,60
10017,Antoine,1,Private room,130,0,0.19,130
10018,Miles,2,Private room,99,0,0.02,99
10019,K.,2,Entire home/apt,175,328,2.06,503
10020,Cody,2,Entire home/apt,200,188,0.09,388
10022,Neil,2,Entire home/apt,99,52,2.39,151
10023,Ezra,1,Private room,45,0,0.61,45
10025,Sherry,1,Entire home/apt,112,0,0.02,112
10026,Haïssam,1,Private room,95,0,0.02,95
10028,Gianni,2,Entire home/apt,150,3,2.02,153
10029,Grayson,1,Entire home/apt,77,0,0.02,77
10030,Mahrokh,1,Private room,69,0,0.02,69
10031,Shana,1,Private room,80,0,0.04,80
10032,Anastasia (Tess),1,Entire home/apt,175,0,0.19,175
10035,Dana,1,Private room,90,0,0.06,90
10036,Tyler,2,Entire home/apt,70,34,0.09,104
10038,Miguel,1,Private room,75,0,0.05,75
10039,Asger,1,Private room,61,213,0.13,274
10040,Denise,1,Shared room,42,363,0.3,405
10041,Ira,1,Entire home/apt,350,0,0.22,350
10042,Galina,2,Private room,45,341,1.09,386
10043,Cameron,2,Private room,75,0,0.04,75
10044,Christine,3,Entire home/apt,150,0,0.04,150
10045,Katja,2,Entire home/apt,72,33,2.54,105
10046,Kat,2,Private room,59,288,4.19,347
10047,Mary,1,Entire home/apt,90,0,0.08,90
10048,Jon,2,Entire home/apt,145,0,0.09,145
10051,Juliana,2,Private room,45,0,0.02,45
10052,Johari,2,Entire home/apt,35,0,1.33,35
10053,Sally,1,Entire home/apt,150,358,1.18,508
10054,Gianni,2,Entire home/apt,147,3,2.1,150
10055,Jessica,1,Private room,182,327,4.65,509
10058,Ben,1,Private room,175,194,3.66,369
10059,Leah,2,Entire home/apt,250,0,0.04,250
10061,Eric,3,Private room,70,0,0.1,70
10063,Mala,1,Private room,75,0,0.03,75
10064,Adria,3,Entire home/apt,79,130,0.49,209
10066,Daljit,3,Private room,35,24,4.0,59
10067,Reid,1,Entire home/apt,300,0,0.12,300
10068,Diana,2,Private room,86,20,1.99,106
10069,Nicole,1,Entire home/apt,189,0,0.3,189
10070,Bekah,2,Entire home/apt,70,0,0.04,70
10072,Sol,2,Entire home/apt,150,365,2.22,515
10073,Vida,2,Entire home/apt,159,0,0.05,159
10074,Emily,2,Private room,50,0,0.04,50
10077,David,1,Entire home/apt,140,0,0.11,140
10078,Mindy,1,Entire home/apt,175,0,0.11,175
10080,Charles,2,Private room,72,0,0.11,72
10081,Genevieve & Brett,2,Entire home/apt,198,0,0.08,198
10082,Katie,2,Entire home/apt,180,0,0.36,180
10083,Rachel,2,Entire home/apt,200,5,0.25,205
10084,Blake,2,Private room,220,60,1.84,280
10085,Yin,3,Entire home/apt,125,340,0.2,465
10086,Angela,1,Entire home/apt,300,33,0.26,333
10087,Ikkyukim,4,Private room,37,333,0.28,370
10088,Matt,1,Private room,60,0,0.02,60
10089,Kristian,2,Private room,49,0,0.03,49
10091,Maia,2,Entire home/apt,145,0,0.5,145
10092,Jen,1,Private room,48,0,0.11,48
10095,Graham,1,Entire home/apt,153,4,1.95,157
10097,Taylor,2,Private room,45,0,0.06,45
10099,Graham,1,Entire home/apt,150,0,0.07,150
10100,Noa,1,Entire home/apt,195,262,2.38,457
10101,Graham,1,Private room,90,0,0.02,90
10102,Soojeong,3,Private room,60,0,0.02,60
10103,Katie,2,Entire home/apt,145,0,0.06,145
10104,Joel,2,Entire home/apt,120,346,0.78,466
10105,Aaron,2,Entire home/apt,111,0,0.32,111
10106,Catherine,2,Entire home/apt,140,0,0.02,140
10107,Miriam,1,Private room,60,280,0.19,340
10108,Max,1,Shared room,35,201,0.25,236
10109,John,1,Private room,93,49,2.74,142
10110,Brian,2,Private room,30,0,0.07,30
10111,Teodoro,2,Private room,60,0,0.04,60
10112,Anne,2,Entire home/apt,99,0,0.02,99
10113,Kevin,1,Private room,210,0,0.42,210
10114,Rui,1,Entire home/apt,175,0,0.04,175
10115,Mary,1,Private room,22,0,0.28,22
10116,Scott,1,Entire home/apt,200,0,0.99,200
10117,Elena,3,Entire home/apt,120,178,0.62,298
10118,Paul,1,Entire home/apt,319,358,0.24,677
10119,Chris,2,Private room,45,0,0.04,45
10120,Sebastian,2,Entire home/apt,99,0,0.02,99
10121,David,1,Entire home/apt,450,264,0.77,714
10122,Mary,2,Private room,89,282,0.6,371
10123,Anita,2,Private room,65,170,1.57,235
10124,Andrew,2,Entire home/apt,185,0,0.17,185
10126,Rachel,1,Entire home/apt,238,91,0.31,329
10127,Patricia,2,Private room,63,240,2.18,303
10128,Kevin,2,Entire home/apt,150,53,1.2,203
10130,Esteban,3,Private room,75,339,2.06,414
10131,Kaplan,3,Entire home/apt,500,0,0.21,500
10132,Ray,4,Private room,59,290,2.42,349
10133,Eliza,1,Private room,90,0,0.02,90
10134,Jamal,2,Entire home/apt,150,0,0.02,150
10135,Vanda,3,Entire home/apt,70,336,2.45,406
10136,Beatriz & Will,3,Entire home/apt,289,309,4.07,598
10137,Jules,1,Entire home/apt,245,125,2.43,370
10139,Yuval,1,Entire home/apt,225,0,0.04,225
10140,E.F.,1,Private room,149,53,0.83,202
10141,Abby,1,Entire home/apt,160,0,0.15,160
10142,Kris,2,Entire home/apt,70,0,0.02,70
10143,Danuza,2,Entire home/apt,165,170,2.54,335
10145,Allie,2,Entire home/apt,150,0,0.2,150
10146,Caroline,2,Private room,65,260,0.24,325
10147,Jordana,1,Entire home/apt,175,0,0.28,175
10148,Gerald,2,Entire home/apt,175,334,2.12,509
10149,Mizo,3,Private room,90,286,0.41,376
10150,Jarred,2,Private room,40,0,0.04,40
10151,William,1,Entire home/apt,170,0,1.19,170
10152,Nisa,2,Private room,70,0,0.17,70
10153,Stat,2,Private room,50,203,0.03,253
10154,Mrs. T,3,Private room,52,350,3.79,402
10157,Stat,2,Private room,47,144,0.13,191
10158,Dipak,1,Entire home/apt,175,0,0.77,175
10159,Stat,2,Private room,47,229,0.06,276
10160,Stat,2,Private room,47,291,0.07,338
10161,Stat,2,Private room,47,222,0.11,269
10164,Reuben,2,Private room,80,204,3.47,284
10165,Kelsie,1,Entire home/apt,142,329,1.02,471
10166,Guanshan,2,Private room,69,0,0.06,69
10167,Vie,4,Private room,62,320,0.12,382
10168,Vie,4,Shared room,45,318,0.37,363
10170,Brian,1,Private room,75,0,0.02,75
10171,Tamar,2,Entire home/apt,80,124,1.53,204
10173,Stefan,2,Entire home/apt,90,0,0.06,90
10174,Laila,1,Entire home/apt,173,194,0.28,367
10175,Momo,2,Entire home/apt,100,249,0.24,349
10176,Kristian,2,Entire home/apt,160,149,3.24,309
10177,Alex,2,Private room,116,329,0.37,445
10180,Emma,1,Entire home/apt,150,0,0.25,150
10181,Mei,1,Entire home/apt,104,219,0.89,323
10182,Darren,1,Entire home/apt,200,134,0.13,334
10183,Shan,3,Entire home/apt,80,0,0.02,80
10185,Mandy,1,Entire home/apt,374,363,0.35,737
10186,Rosario,1,Private room,46,0,0.19,46
10187,Emma Leigh,2,Entire home/apt,94,274,0.62,368
10188,Reymon,1,Private room,92,0,0.02,92
10189,Greg,2,Entire home/apt,155,256,1.73,411
10190,Sabrina,1,Private room,70,0,0.11,70
10191,James,2,Entire home/apt,75,0,0.04,75
10192,Jill,2,Entire home/apt,150,0,0.02,150
10194,Charles,2,Private room,75,0,0.02,75
10196,Julia,2,Entire home/apt,145,31,0.76,176
10197,Samantha,3,Entire home/apt,65,0,0.04,65
10198,Jana,2,Entire home/apt,195,326,0.37,521
10199,Kleon,1,Entire home/apt,420,0,0.07,420
10200,John,1,Entire home/apt,500,365,0.94,865
10202,Edixon,2,Entire home/apt,85,0,0.13,85
10203,Anna,2,Entire home/apt,100,326,0.74,426
10204,Stephanie,2,Private room,70,0,0.11,70
10206,Heidi,1,Entire home/apt,425,36,1.45,461
10207,Kevin,1,Entire home/apt,490,0,0.02,490
10209,Eric,2,Private room,135,0,0.04,135
10210,Shichao,1,Private room,80,0,0.08,80
10211,Michael,2,Entire home/apt,90,0,0.06,90
10212,Ola,1,Entire home/apt,800,266,0.48,1066
10213,Ramiro,2,Private room,70,364,0.21,434
10214,Caroline,1,Private room,100,0,0.09,100
10215,C,1,Private room,75,197,4.32,272
10216,Luke,1,Private room,88,82,0.33,170
10218,Darsell,3,Private room,50,0,0.03,50
10219,Faith,2,Private room,63,230,2.19,293
10220,Caitlin,3,Private room,50,0,0.02,50
10221,Lauren,1,Private room,90,0,0.05,90
10222,Catherine,2,Entire home/apt,85,0,0.21,85
10224,Hsiang Wei,2,Private room,90,20,1.24,110
10225,Seema N James,2,Entire home/apt,75,0,0.08,75
10226,Ashley,1,Entire home/apt,150,0,0.02,150
10227,Miles,2,Private room,38,0,0.02,38
10228,Fig,2,Private room,70,0,0.02,70
10230,Melissa,2,Private room,65,0,0.04,65
10231,Romina,2,Private room,75,0,0.26,75
10232,Edgar,2,Private room,60,240,4.83,300
10233,Julia,1,Entire home/apt,221,110,2.26,331
10234,Georgia,2,Entire home/apt,500,330,0.84,830
10236,Host,1,Entire home/apt,250,98,0.04,348
10237,Phong,1,Entire home/apt,239,0,0.09,239
10238,Christine,2,Entire home/apt,105,363,0.11,468
10239,Michael,2,Private room,50,0,0.04,50
10240,Mike,1,Private room,75,0,0.09,75
10242,Alyssa,2,Entire home/apt,108,0,0.87,108
10243,Chris,1,Private room,59,0,0.21,59
10244,Claire,1,Entire home/apt,149,0,0.06,149
10245,Mathew,2,Entire home/apt,150,35,1.44,185
10246,Josh,2,Entire home/apt,119,154,0.58,273
10247,Calatayud Family,1,Entire home/apt,100,213,4.17,313
10249,Stephanie,2,Private room,85,179,0.17,264
10250,Preston,2,Private room,45,0,0.02,45
10251,Haim,1,Entire home/apt,295,214,1.4,509
10253,John,2,Private room,60,69,2.55,129
10255,Logan,2,Private room,60,0,0.02,60
10256,Host,1,Entire home/apt,200,331,0.11,531
10257,Khalid,1,Entire home/apt,80,0,0.02,80
10258,John,2,Private room,60,83,2.07,143
10259,Niki,2,Private room,50,0,0.05,50
10260,Natalie,5,Private room,69,172,0.52,241
10261,Benjamin,2,Entire home/apt,123,319,0.23,442
10263,George,1,Entire home/apt,135,170,4.5,305
10264,Abdirazak,1,Entire home/apt,400,0,0.25,400
10265,Dan,1,Private room,87,0,0.06,87
10266,Jeffrey,1,Private room,99,254,6.61,353
10267,Christine,2,Private room,55,311,0.83,366
10268,Gehad,1,Entire home/apt,225,0,0.33,225
10269,John,2,Private room,60,87,1.94,147
10271,Michelle,1,Entire home/apt,299,0,0.15,299
10272,Sean,2,Private room,40,206,0.49,246
10273,Andy,1,Entire home/apt,120,1,0.84,121
10274,Aldi,1,Private room,89,351,3.18,440
10276,Justine,1,Entire home/apt,150,72,1.11,222
10278,Dins,1,Entire home/apt,240,0,0.04,240
10279,Joey,2,Private room,36,0,0.13,36
10280,Furkan,1,Entire home/apt,67,0,0.02,67
10281,Craig,1,Entire home/apt,140,10,0.23,150
10283,Eileen,4,Entire home/apt,90,299,3.25,389
10284,John,2,Private room,60,77,2.1,137
10285,Sachiko,3,Entire home/apt,138,21,4.83,159
10286,Maya,1,Entire home/apt,96,0,0.05,96
10287,Tom & Nic,2,Private room,109,244,2.25,353
10288,Keisha,2,Entire home/apt,135,282,2.23,417
10289,Lou,3,Entire home/apt,58,134,0.15,192
10290,Emilia,1,Private room,65,0,0.04,65
10291,Natalie,1,Entire home/apt,225,0,0.04,225
10292,Meredith,1,Entire home/apt,130,0,0.02,130
10293,John,2,Private room,60,84,2.26,144
10295,Jennifer,2,Entire home/apt,210,0,0.04,210
10296,Andrew,2,Entire home/apt,275,0,0.68,275
10297,Kelsey,1,Entire home/apt,175,0,0.03,175
10298,Laura,1,Entire home/apt,175,0,0.13,175
10299,Austin,1,Private room,43,0,0.02,43
10300,Nauman,1,Entire home/apt,250,0,0.05,250
10301,Baptiste,2,Private room,79,0,0.06,79
10303,John,2,Private room,60,122,2.13,182
10304,Angele,3,Entire home/apt,100,224,1.39,324
10305,Jacob,2,Private room,79,365,0.22,444
10306,Charlotta,2,Entire home/apt,285,292,1.41,577
10308,D.,3,Private room,200,90,1.48,290
10310,Natasha,1,Entire home/apt,150,0,0.55,150
10312,Adrienne,1,Private room,180,0,0.17,180
10313,Jody,1,Entire home/apt,150,0,0.02,150
10314,Eileen,1,Private room,58,0,0.11,58
10315,(Ari) HENRY LEE,1,Entire home/apt,140,56,0.06,196
10316,Vera,2,Private room,80,0,0.04,80
10317,Annie,1,Entire home/apt,100,0,0.11,100
10318,Beatriz,1,Entire home/apt,200,168,0.2,368
10319,Aya,2,Entire home/apt,175,0,0.24,175
10320,Ben,1,Entire home/apt,250,307,2.26,557
10321,Seun And Marie,2,Private room,74,76,0.63,150
10322,John,2,Private room,60,100,2.1,160
10323,Zhaoyu,1,Private room,60,0,0.04,60
10324,Amanda,3,Private room,60,0,0.04,60
10325,Andrea,1,Entire home/apt,150,157,0.11,307
10326,Doreen,1,Private room,70,0,0.02,70
10327,Richy,1,Private room,98,204,2.58,302
10328,Luke,2,Private room,108,12,2.31,120
10329,Hannes,1,Private room,80,0,0.06,80
10330,Monika,3,Entire home/apt,60,219,1.06,279
10331,Conor,2,Entire home/apt,220,0,0.13,220
10332,Suraj,1,Entire home/apt,140,1,0.72,141
10333,George,1,Entire home/apt,1200,359,0.25,1559
10336,Hannah,1,Private room,42,0,0.08,42
10337,Alex,2,Entire home/apt,120,54,2.02,174
10338,Kyle,1,Private room,69,0,0.28,69
10339,Hadrien,2,Private room,85,0,0.3,85
10340,Arianna & Z,2,Private room,75,128,4.78,203
10341,Leonie,2,Private room,1100,365,0.03,1465
10342,Ehi,2,Private room,60,0,0.07,60
10343,George - Francis,1,Private room,160,0,0.06,160
10344,Miranda,1,Private room,120,0,0.02,120
10345,Amy,1,Entire home/apt,95,240,2.13,335
10346,Nathan,1,Entire home/apt,180,0,0.02,180
10347,Sara,2,Entire home/apt,170,0,0.17,170
10348,Jesse,2,Private room,39,0,0.02,39
10349,Fatou,2,Private room,75,322,1.12,397
10351,Jill,2,Entire home/apt,160,0,0.3,160
10352,James,1,Private room,96,98,2.47,194
10353,Adrian,1,Private room,50,208,3.37,258
10354,Dan,1,Entire home/apt,145,0,0.19,145
10356,Shinsuke,1,Entire home/apt,100,0,0.02,100
10357,Jason,2,Private room,95,296,3.27,391
10360,Anthony,2,Private room,105,64,5.0,169
10363,Michael,2,Private room,35,0,0.28,35
10364,Adrianna,2,Entire home/apt,80,0,0.02,80
10365,Rosie,2,Entire home/apt,120,6,0.93,126
10367,Luz,2,Entire home/apt,130,0,0.43,130
10369,Asif,1,Private room,71,0,0.89,71
10370,Lily,2,Private room,50,0,0.11,50
10371,Jason,2,Private room,72,288,3.23,360
10372,John,2,Private room,99,153,0.5,252
10373,Bailey,2,Entire home/apt,110,0,0.04,110
10374,Priscilla,1,Entire home/apt,118,0,0.04,118
10375,Jesse,1,Private room,75,0,0.11,75
10376,Jeeku,1,Entire home/apt,225,132,3.4,357
10377,Austin,2,Private room,80,188,0.04,268
10378,Linda & Didier,4,Private room,107,173,1.73,280
10379,David,2,Entire home/apt,500,178,0.19,678
10380,Jonathan,2,Entire home/apt,200,287,2.61,487
10381,Andres And Salina,3,Private room,42,283,0.54,325
10382,Sam,1,Entire home/apt,350,0,0.06,350
10383,Julia,1,Private room,160,344,1.16,504
10385,Ryan,2,Private room,89,0,0.05,89
10386,Mercedes,2,Entire home/apt,150,30,0.25,180
10388,Erin,2,Entire home/apt,120,0,0.17,120
10389,Nkatha,1,Private room,73,365,0.29,438
10390,Nkatha,1,Private room,73,340,0.59,413
10392,Lindsay,2,Entire home/apt,140,0,0.06,140
10393,Megan,2,Entire home/apt,125,0,0.09,125
10395,Adam,3,Entire home/apt,140,0,0.19,140
10396,Skye,2,Private room,48,0,0.47,48
10400,Rebecca,1,Entire home/apt,400,6,0.34,406
10401,Paolo,1,Entire home/apt,165,195,1.46,360
10402,Arielle,2,Private room,70,0,0.02,70
10403,Siebren,3,Private room,52,36,0.17,88
10404,Regi,1,Entire home/apt,385,0,0.07,385
10405,Owen,2,Private room,45,0,0.02,45
10406,Donavan,2,Entire home/apt,275,256,1.67,531
10407,Jose,1,Private room,135,111,5.36,246
10410,Ruth,2,Entire home/apt,350,0,0.11,350
10411,Julie,2,Private room,100,324,0.48,424
10412,Brent,3,Entire home/apt,100,0,0.09,100
10413,Alexander,2,Entire home/apt,135,0,0.04,135
10414,Nina,1,Entire home/apt,115,239,0.27,354
10415,Farah,2,Entire home/apt,150,0,0.04,150
10416,Katherine,1,Private room,60,0,0.07,60
10417,Judith,2,Entire home/apt,99,342,1.83,441
10418,Lovelynn,1,Entire home/apt,180,60,2.09,240
10419,Pete,2,Entire home/apt,95,0,0.23,95
10420,Brooklyn&   Breakfast    -Len-,2,Private room,60,324,4.19,384
10421,Marissa,3,Entire home/apt,100,0,0.04,100
10422,Telitha,1,Entire home/apt,250,0,0.58,250
10425,Aria,2,Entire home/apt,145,0,0.06,145
10426,Erica,2,Entire home/apt,250,365,1.15,615
10427,Anna,2,Entire home/apt,150,196,0.17,346
10428,Nick,1,Entire home/apt,400,0,0.39,400
10429,Alicia And Zach,2,Private room,83,0,0.31,83
10430,Zack,2,Entire home/apt,150,0,0.17,150
10431,Ricardo,1,Entire home/apt,1195,264,2.37,1459
10432,Ben,2,Private room,68,10,0.3,78
10434,Tzooli And Ay,2,Private room,70,93,3.8,163
10435,Lindsay,2,Private room,65,0,0.06,65
10436,Jessica,2,Private room,45,0,0.04,45
10437,Kathleen,1,Private room,75,0,1.63,75
10439,Chad & David,1,Private room,65,347,1.71,412
10440,Etienne,2,Entire home/apt,170,1,0.77,171
10442,Jennifer,2,Entire home/apt,100,0,0.24,100
10443,Abby,1,Shared room,65,0,0.15,65
10444,Marianne,2,Entire home/apt,280,151,0.52,431
10446,Nicole,2,Entire home/apt,150,0,0.2,150
10447,Ronnie,1,Entire home/apt,250,0,0.37,250
10448,Host,1,Entire home/apt,250,0,0.08,250
10449,Wilson,2,Entire home/apt,65,308,7.31,373
10450,James,3,Entire home/apt,130,0,0.09,130
10451,Coco,1,Entire home/apt,375,0,0.46,375
10452,Maggie,2,Shared room,48,90,1.26,138
10453,Courtney,2,Entire home/apt,80,0,0.04,80
10454,Christian,1,Entire home/apt,110,267,2.85,377
10455,C-S,1,Private room,72,0,0.25,72
10456,Tessa Marie,2,Private room,49,0,0.34,49
10457,Monica,1,Entire home/apt,250,0,0.07,250
10458,Donna,1,Private room,120,246,2.74,366
10459,Terrie,2,Entire home/apt,240,83,2.96,323
10460,Lyuba,1,Entire home/apt,77,0,0.04,77
10462,Guilherme,1,Entire home/apt,185,0,0.36,185
10463,Gabi,1,Private room,100,0,0.04,100
10464,Matthew,2,Private room,50,0,0.02,50
10465,Cass,2,Private room,50,0,0.02,50
10467,Timothy,2,Entire home/apt,87,0,0.07,87
10468,Mike,2,Private room,30,0,0.14,30
10469,Yi-Chen,1,Private room,65,0,0.24,65
10470,Ethan,1,Entire home/apt,109,0,1.65,109
10472,Rachel,1,Private room,152,157,0.83,309
10473,Gwen,2,Entire home/apt,150,168,0.6,318
10474,Momo,1,Entire home/apt,300,87,0.66,387
10475,Josie,3,Private room,55,365,0.32,420
10477,Danny,2,Private room,70,0,0.02,70
10478,Ayse,2,Private room,60,0,0.1,60
10479,Miriam,2,Entire home/apt,150,0,0.02,150
10480,Alec,2,Private room,119,236,3.82,355
10481,Mallory,1,Entire home/apt,74,0,0.07,74
10482,Jovan & Zaga,1,Entire home/apt,250,0,0.09,250
10483,Orlando,1,Private room,250,365,0.47,615
10484,Jason,1,Entire home/apt,130,0,0.09,130
10486,Rachel,1,Private room,163,188,0.64,351
10487,Glenn,2,Entire home/apt,125,0,0.06,125
10488,Hannah,2,Entire home/apt,149,0,0.15,149
10489,Erin,2,Entire home/apt,135,158,1.17,293
10490,Kara,1,Entire home/apt,129,161,0.07,290
10491,Tony,3,Entire home/apt,87,210,3.32,297
10492,John,2,Private room,55,0,0.04,55
10493,Jarad,2,Shared room,54,0,1.56,54
10494,Peter,1,Entire home/apt,110,0,0.13,110
10495,Emily,2,Entire home/apt,250,0,0.06,250
10496,Devon,1,Entire home/apt,150,0,0.32,150
10498,Erin,2,Private room,40,0,0.02,40
10499,Fma,1,Entire home/apt,295,0,0.7,295
10500,Roman,2,Private room,130,278,0.15,408
10501,Brady,2,Private room,79,59,6.37,138
10502,Brady,2,Private room,69,68,6.23,137
10503,Brady,2,Private room,79,67,6.09,146
10504,Vinny,1,Entire home/apt,147,294,0.78,441
10505,Brady,2,Private room,79,26,6.26,105
10506,Brady,2,Private room,69,41,7.07,110
10507,Seth,2,Private room,70,353,1.45,423
10508,Amelie & Pascal,2,Private room,119,26,2.47,145
10509,Joe,2,Private room,49,340,3.04,389
10510,Brigitte,2,Entire home/apt,132,10,1.94,142
10511,Sue,2,Entire home/apt,155,331,0.17,486
10513,Irene,1,Entire home/apt,179,0,0.22,179
10515,Stephanie,2,Entire home/apt,104,100,0.39,204
10516,Frank,2,Private room,40,0,0.2,40
10518,Matthew,1,Entire home/apt,80,1,0.34,81
10519,Evy,2,Private room,89,307,1.9,396
10520,John,2,Entire home/apt,999,67,3.04,1066
10521,Scott,2,Entire home/apt,85,0,0.04,85
10522,Edward,2,Private room,75,0,0.02,75
10523,Josh,1,Private room,59,200,1.57,259
10524,Louise,2,Private room,45,0,0.04,45
10525,Timur,1,Entire home/apt,350,247,1.6,597
10526,Sarah,2,Entire home/apt,395,17,1.29,412
10528,Henri,1,Entire home/apt,180,13,1.46,193
10529,Rachel,2,Private room,46,0,0.04,46
10531,Kara,1,Entire home/apt,189,365,0.11,554
10532,Alexandra,3,Entire home/apt,195,66,2.59,261
10533,Marie,1,Private room,39,0,0.3,39
10535,Ryan,2,Private room,65,0,0.02,65
10537,Ersellia,2,Entire home/apt,140,30,0.39,170
10538,Natalie,2,Private room,65,4,0.11,69
10539,Chris,1,Entire home/apt,118,0,0.02,118
10540,Yasu & Akiko,1,Shared room,250,306,2.88,556
10541,Phuong,1,Shared room,55,0,0.69,55
10542,Anita,1,Entire home/apt,155,316,0.2,471
10544,Brooklyn&   Breakfast    -Len-,2,Private room,85,290,4.98,375
10545,Jenn,1,Entire home/apt,168,0,0.04,168
10546,Yessenia,2,Entire home/apt,110,0,0.22,110
10547,Natasha,2,Entire home/apt,125,0,0.04,125
10548,Megan,2,Entire home/apt,125,0,0.06,125
10549,Nadalie,1,Private room,115,0,0.04,115
10550,Filippo,1,Entire home/apt,130,365,0.35,495
10551,Vishnu,2,Private room,64,0,0.02,64
10552,Gia,1,Entire home/apt,140,0,0.04,140
10553,Mel,1,Entire home/apt,165,99,1.84,264
10554,Pon,1,Entire home/apt,160,0,0.02,160
10555,Marie,2,Private room,70,125,0.87,195
10556,Irisha,3,Entire home/apt,100,132,1.58,232
10557,Katie,1,Entire home/apt,225,0,0.04,225
10558,Cory,3,Entire home/apt,70,159,0.28,229
10559,Amandine,2,Private room,60,0,0.04,60
10560,Alexandra,2,Entire home/apt,120,0,0.04,120
10561,Sarah,2,Private room,50,0,0.08,50
10562,Esteban,3,Private room,75,328,2.45,403
10563,Esteban,3,Private room,75,362,2.21,437
10564,Petya,3,Private room,37,361,0.26,398
10565,Jennifer,1,Entire home/apt,225,280,0.24,505
10566,Ari,1,Entire home/apt,250,358,0.04,608
10567,Gregory,2,Entire home/apt,125,121,1.97,246
10568,Elaine,1,Entire home/apt,170,0,0.07,170
10569,Dogan,1,Private room,110,360,1.75,470
10571,Jacob,1,Private room,100,25,0.14,125
10572,Chris,2,Private room,50,0,0.09,50
10573,Ilton,1,Entire home/apt,205,262,1.01,467
10575,Alex,2,Entire home/apt,90,77,0.36,167
10576,Tasia,2,Private room,49,0,0.02,49
10578,Stephen,1,Entire home/apt,129,0,0.11,129
10579,John,1,Entire home/apt,165,0,0.04,165
10580,Rebecca,2,Entire home/apt,103,13,0.31,116
10581,George,2,Entire home/apt,97,307,2.15,404
10582,Prashanth,1,Private room,49,0,0.18,49
10583,Vapee,1,Entire home/apt,245,261,1.29,506
10584,Autumn,3,Private room,52,0,0.09,52
10585,Victoria,2,Entire home/apt,280,0,0.02,280
10590,Andres,1,Private room,62,0,0.11,62
10592,Carole,1,Entire home/apt,129,0,0.13,129
10593,Liz,2,Entire home/apt,175,0,0.25,175
10594,Ardis,3,Private room,80,303,0.72,383
10595,Rebeckah,2,Entire home/apt,90,0,0.3,90
10596,James,2,Private room,77,0,0.02,77
10597,Benjamin,2,Entire home/apt,120,202,1.28,322
10598,Maythem,2,Private room,90,0,0.11,90
10599,Kaila,2,Entire home/apt,180,0,0.02,180
10600,Michelle,2,Entire home/apt,100,43,0.94,143
10601,Autumn,1,Entire home/apt,159,37,3.64,196
10602,Angela,1,Entire home/apt,200,247,2.19,447
10603,Kara,1,Private room,89,0,0.11,89
10604,John,1,Entire home/apt,200,0,0.06,200
10605,Shakeh,1,Private room,72,0,0.11,72
10607,Pat,1,Entire home/apt,165,43,0.13,208
10608,Leyla,1,Private room,100,31,0.38,131
10610,Jordan,1,Private room,90,0,0.17,90
10611,Ema,1,Entire home/apt,120,0,0.06,120
10612,Alyshia,1,Entire home/apt,185,6,4.31,191
10615,Jennifer,1,Entire home/apt,159,338,2.7,497
10616,Devon,2,Private room,70,0,0.41,70
10617,Sharan,2,Private room,80,0,0.09,80
10618,Miguel,1,Entire home/apt,220,0,0.06,220
10619,Joe,2,Entire home/apt,89,0,0.07,89
10620,Alessandro,3,Entire home/apt,135,157,0.04,292
10621,Maria,1,Entire home/apt,150,362,0.28,512
10622,Robbin,2,Entire home/apt,165,235,2.8,400
10623,Maya,3,Private room,46,163,11.59,209
10624,Jeff,3,Private room,50,0,0.95,50
10625,Shea,1,Entire home/apt,100,0,0.02,100
10626,Christopher,1,Entire home/apt,200,161,0.02,361
10627,Simon,3,Private room,100,364,0.02,464
10628,Tasia,2,Entire home/apt,81,0,0.02,81
10629,Danielle,1,Entire home/apt,150,99,2.44,249
10630,Julien,1,Private room,60,0,0.07,60
10632,Rebekah,2,Entire home/apt,239,142,3.19,381
10633,Fidelia,2,Private room,70,326,0.28,396
10634,Sophie,2,Private room,45,0,0.15,45
10635,Lenny,1,Entire home/apt,200,197,2.46,397
10636,Jocelyn,1,Shared room,45,0,0.02,45
10637,Michelle,2,Entire home/apt,45,14,0.15,59
10639,Andrew And Talia,2,Entire home/apt,110,0,0.12,110
10641,Dave,1,Entire home/apt,250,211,1.07,461
10642,Keith,1,Private room,120,0,0.04,120
10643,Kara,1,Entire home/apt,249,273,0.1,522
10644,Mez,2,Private room,80,0,0.04,80
10645,Steven,1,Entire home/apt,124,0,0.42,124
10646,Philip,2,Entire home/apt,175,0,0.04,175
10649,Anne,2,Entire home/apt,115,166,0.58,281
10650,Elyse,2,Entire home/apt,99,0,0.24,99
10651,Gina,3,Private room,75,364,0.04,439
10652,Mila,1,Entire home/apt,140,0,0.06,140
10654,John,2,Private room,60,104,2.29,164
10656,Basil And Jacqueline,1,Private room,120,263,0.25,383
10657,Basil And Jacqueline,1,Entire home/apt,150,271,0.42,421
10659,Fabiana,1,Entire home/apt,150,0,0.24,150
10660,Jaimie,2,Private room,49,0,0.2,49
10661,Aaron,2,Entire home/apt,110,0,0.04,110
10662,Jacqueline,1,Private room,65,0,0.03,65
10663,Yonatan,2,Entire home/apt,190,0,0.02,190
10664,Tara,1,Entire home/apt,125,0,0.02,125
10665,Pratik,1,Private room,92,39,0.46,131
10668,Leela,2,Entire home/apt,325,0,0.21,325
10669,Umar,1,Entire home/apt,120,0,0.07,120
10670,Alexandra,2,Private room,60,0,0.02,60
10671,Vicky,1,Entire home/apt,175,0,0.52,175
10672,Damien,2,Entire home/apt,200,103,3.24,303
10673,Amy,1,Entire home/apt,180,270,3.14,450
10676,Brooklyn&   Breakfast    -Len-,2,Private room,60,293,3.99,353
10677,Essam,1,Private room,95,80,2.16,175
10679,Amy,2,Entire home/apt,230,283,4.55,513
10680,Sophie,2,Private room,45,0,0.02,45
10681,Alex,3,Private room,40,0,0.02,40
10682,Monty,2,Shared room,95,238,0.15,333
10684,Gordon M,1,Private room,42,101,0.73,143
10685,Bridgett,2,Private room,70,11,5.46,81
10686,Jessica,2,Private room,199,365,0.45,564
10687,Chester,1,Private room,65,287,3.4,352
10688,Anne,1,Entire home/apt,190,9,0.09,199
10689,Sam And Roxanna,1,Entire home/apt,200,264,3.13,464
10690,David,2,Entire home/apt,75,0,1.06,75
10691,Lia,2,Private room,98,343,0.67,441
10692,Alec & Laura,2,Private room,120,206,1.79,326
10693,Sinaly,2,Private room,130,365,0.2,495
10695,Caroline,1,Entire home/apt,125,204,0.04,329
10698,Valvil,2,Private room,55,89,0.09,144
10699,Cristian,1,Private room,68,160,0.2,228
10701,Lindsay,3,Entire home/apt,140,0,0.05,140
10702,Rebecca,1,Entire home/apt,160,0,0.11,160
10703,Oran,2,Private room,77,0,0.02,77
10704,Dee,2,Private room,90,0,0.02,90
10705,Mostafa,1,Entire home/apt,208,0,0.02,208
10706,Michael,1,Entire home/apt,215,0,1.56,215
10707,Crystal & Allan,1,Private room,100,79,0.45,179
10708,Robert,1,Private room,40,0,0.2,40
10709,Ashley,3,Private room,59,176,1.85,235
10710,Frank And Anna,4,Entire home/apt,325,153,2.23,478
10711,Paul,2,Entire home/apt,98,293,4.37,391
10713,Keith,2,Private room,69,333,0.28,402
10714,Yuxi,3,Private room,80,0,0.02,80
10716,Shahana,2,Private room,39,158,0.97,197
10717,Nazifa,2,Private room,70,37,2.63,107
10718,Catrina,1,Entire home/apt,194,0,2.58,194
10719,Amanda,1,Private room,90,8,2.01,98
10720,Shahana,2,Private room,39,33,1.51,72
10721,Alice,2,Private room,85,151,1.53,236
10722,Miran,5,Entire home/apt,429,0,0.09,429
10723,Glenda,1,Private room,42,259,3.46,301
10724,Alexandra,2,Entire home/apt,200,0,0.02,200
10725,Max,1,Entire home/apt,700,54,1.29,754
10726,Erin,2,Private room,50,0,0.09,50
10727,Christine,2,Entire home/apt,100,0,0.02,100
10728,Danny,2,Entire home/apt,150,365,1.33,515
10729,Luis,2,Entire home/apt,100,269,1.84,369
10730,Andrew,2,Entire home/apt,85,282,0.56,367
10731,Candy,1,Entire home/apt,240,0,1.8,240
10732,Romona,1,Entire home/apt,135,0,0.04,135
10733,Jared,1,Entire home/apt,135,0,0.07,135
10734,Stephanie,4,Private room,79,179,0.16,258
10735,Mickey,1,Private room,150,0,0.31,150
10736,Anthony,2,Private room,139,307,1.83,446
10737,Gabriela,2,Private room,38,0,0.04,38
10738,Grete,2,Private room,100,0,1.43,100
10740,Ian,3,Entire home/apt,170,0,0.13,170
10741,Julie,1,Private room,70,188,1.48,258
10742,Scott,1,Private room,199,276,2.69,475
10743,Shahana,2,Private room,39,159,1.34,198
10744,Shahana,2,Private room,39,33,1.57,72
10745,Anamaria & Ricardo,1,Private room,75,325,0.28,400
10746,Eric And Aoife,2,Entire home/apt,99,65,0.65,164
10747,Verena,3,Private room,100,61,0.32,161
10748,Nadege & Charles,2,Entire home/apt,225,135,0.96,360
10749,Melissa,2,Private room,99,231,1.62,330
10750,Francis & Daniele,2,Entire home/apt,469,48,0.16,517
10751,Daniel,2,Private room,67,266,0.13,333
10752,Ed,1,Private room,180,362,0.39,542
10753,Fernando,1,Private room,100,263,1.88,363
10754,Susan,1,Entire home/apt,125,1,0.17,126
10755,Nika,3,Entire home/apt,85,0,0.55,85
10756,Robin,1,Private room,175,0,0.08,175
10757,Fabiola,4,Private room,65,123,0.4,188
10758,Denise,2,Private room,52,90,2.09,142
10759,Melissa,1,Entire home/apt,85,0,0.07,85
10760,Martha,5,Private room,99,325,1.78,424
10761,Sinaly,2,Private room,130,364,0.07,494
10762,C,1,Entire home/apt,189,37,0.86,226
10763,Keith,2,Entire home/apt,121,0,0.42,121
10764,Jasmine,2,Private room,150,363,0.09,513
10765,Shwetha,1,Entire home/apt,170,0,0.02,170
10766,Brian,1,Private room,70,0,0.24,70
10767,Joshua,1,Private room,80,0,0.02,80
10769,Matin,1,Entire home/apt,174,0,0.24,174
10770,Kara,1,Private room,89,0,0.11,89
10771,Alex,1,Private room,109,0,0.09,109
10772,Camille,2,Entire home/apt,100,0,0.57,100
10773,David,2,Private room,80,0,0.11,80
10774,Sandra And Cary,2,Private room,41,292,0.35,333
10776,Joseph,1,Entire home/apt,230,0,0.5,230
10777,Nora,2,Shared room,45,342,2.94,387
10779,Chris,2,Entire home/apt,125,105,2.83,230
10780,Dylan,1,Entire home/apt,149,0,0.02,149
10781,Yahaira,4,Private room,63,0,0.87,63
10782,Maria,2,Entire home/apt,60,0,0.13,60
10783,Lilia,1,Private room,57,341,0.38,398
10784,Indira,2,Entire home/apt,160,304,1.58,464
10785,Samir,2,Entire home/apt,164,0,0.23,164
10786,R Demetre,2,Entire home/apt,250,365,0.22,615
10787,Mario,1,Entire home/apt,194,102,0.75,296
10789,Rigoberto,2,Entire home/apt,205,172,1.85,377
10790,Sinaly,2,Private room,129,365,0.11,494
10793,Katie,1,Entire home/apt,150,0,0.37,150
10794,Jorge,2,Entire home/apt,75,256,3.44,331
10795,Nora,2,Shared room,45,351,2.91,396
10796,Jose Xavier,2,Private room,65,0,0.2,65
10797,Solange,1,Entire home/apt,250,0,0.28,250
10798,Gabriel,2,Shared room,185,0,0.02,185
10799,Nolan,1,Entire home/apt,400,0,0.25,400
10800,Jennifer,3,Entire home/apt,125,234,4.48,359
10801,G. Angela,3,Private room,175,87,0.11,262
10802,Andrew,2,Entire home/apt,300,338,1.51,638
10803,Kara,1,Entire home/apt,249,273,0.04,522
10804,Kara,1,Entire home/apt,199,365,0.11,564
10805,Stacy,1,Entire home/apt,180,0,0.04,180
10806,Veralyn,2,Private room,60,116,0.73,176
10807,Ignacio,2,Private room,55,0,0.05,55
10808,Mia,2,Entire home/apt,135,242,3.32,377
10809,Everol,2,Entire home/apt,90,93,1.85,183
10810,Brooke,1,Private room,130,0,0.02,130
10813,Edward,1,Private room,85,61,0.81,146
10814,Aly,1,Private room,150,0,0.08,150
10815,Nick,2,Private room,62,334,1.58,396
10816,Jason,2,Entire home/apt,155,262,4.06,417
10817,Lea,2,Private room,40,0,0.27,40
10818,Chara,1,Private room,140,28,0.78,168
10819,Julie,2,Shared room,50,365,0.11,415
10820,David,1,Entire home/apt,250,0,0.02,250
10821,Ronald,2,Private room,70,0,0.02,70
10822,Fedor,2,Entire home/apt,160,0,0.11,160
10823,Sam,2,Entire home/apt,78,217,2.65,295
10824,Baizy,1,Entire home/apt,139,350,0.17,489
10825,Adir,1,Private room,50,0,0.09,50
10826,Rob,1,Entire home/apt,145,0,0.69,145
10827,Gordon M,1,Private room,55,72,1.82,127
10828,Kate,1,Entire home/apt,215,0,0.02,215
10830,Gabriela,3,Private room,120,89,0.2,209
10831,Katarina,1,Entire home/apt,160,0,0.19,160
10834,Mona And Wally,5,Entire home/apt,80,324,3.19,404
10835,Jonathan,1,Entire home/apt,150,0,0.18,150
10836,Genna,2,Private room,110,0,0.04,110
10837,Nancy,2,Entire home/apt,360,0,0.12,360
10838,Kathy,1,Entire home/apt,239,30,0.05,269
10839,Gabriel,2,Private room,40,0,0.07,40
10840,Yawen,1,Private room,60,0,0.05,60
10841,Gabrielle-Renée,1,Entire home/apt,87,0,0.25,87
10844,Greg,1,Entire home/apt,119,0,0.09,119
10845,Julian,2,Entire home/apt,69,0,0.2,69
10846,Catherine,1,Private room,50,0,0.84,50
10847,Evonne,2,Entire home/apt,200,280,0.59,480
10848,Long,4,Private room,65,0,4.35,65
10849,Agnieszka,3,Entire home/apt,78,0,0.03,78
10850,Christopher,2,Entire home/apt,150,0,0.09,150
10851,Ericka,1,Private room,99,105,3.56,204
10853,Sid,1,Entire home/apt,140,256,1.56,396
10854,Lisa,1,Entire home/apt,500,0,0.02,500
10856,Deborah,2,Entire home/apt,123,0,3.09,123
10857,Sinaly,2,Entire home/apt,414,365,0.12,779
10858,Sinaly,2,Private room,125,180,0.29,305
10859,Matthew,1,Entire home/apt,299,221,1.22,520
10860,Barbara,2,Private room,55,286,4.73,341
10861,Griffin,1,Private room,55,0,0.04,55
10862,Malik,2,Private room,65,342,0.07,407
10864,Lisa,1,Entire home/apt,150,0,0.82,150
10865,Scott,1,Private room,79,0,0.14,79
10867,Sheena,1,Entire home/apt,124,247,2.66,371
10868,"Keiko, Harumi & Eric",2,Private room,85,281,0.94,366
10869,El Haj,1,Private room,100,349,0.13,449
10870,Fiorella,2,Entire home/apt,82,0,0.22,82
10871,Brais,4,Private room,59,0,1.11,59
10872,Dylan,1,Private room,75,0,0.11,75
10873,Jordan,2,Private room,65,0,0.04,65
10875,Sacha,2,Private room,65,0,0.26,65
10876,Eunwoo,1,Entire home/apt,109,0,0.33,109
10877,Sloan,2,Private room,59,325,3.37,384
10878,Anthony,1,Entire home/apt,300,188,0.16,488
10879,Lidia,2,Entire home/apt,135,188,0.32,323
10880,Abraham,1,Entire home/apt,110,0,0.02,110
10881,Sam,1,Entire home/apt,300,0,0.02,300
10883,Jackie,1,Private room,185,341,0.15,526
10884,"Isaac, Linda & Noelia",2,Private room,35,160,0.57,195
10886,Allan,1,Private room,90,0,0.05,90
10887,Laura,3,Private room,50,1,4.53,51
10888,AnnMarie,2,Private room,60,0,0.24,60
10889,Nelly,2,Private room,70,0,0.05,70
10890,Martin,1,Private room,130,0,0.06,130
10891,Alicia,4,Private room,28,108,2.12,136
10893,Karen,2,Entire home/apt,110,0,0.22,110
10894,Wes,2,Private room,70,0,0.06,70
10895,Florie,2,Entire home/apt,200,0,0.15,200
10896,Jared,1,Private room,90,0,1.55,90
10897,Randy,3,Entire home/apt,139,0,0.16,139
10898,Ana,1,Entire home/apt,360,188,0.28,548
10899,Amanda,1,Entire home/apt,185,7,0.33,192
10901,David,2,Private room,100,0,0.05,100
10902,Michelle,1,Private room,195,265,1.64,460
10903,Alex,1,Entire home/apt,235,0,0.09,235
10904,Robbin,2,Entire home/apt,150,277,2.38,427
10905,Bruce & Suzanne,1,Private room,70,0,0.16,70
10906,Felipe,1,Private room,95,0,0.04,95
10907,Salvatore,1,Entire home/apt,450,364,0.44,814
10909,Jennifer,1,Private room,100,0,0.19,100
10910,Raphael,2,Entire home/apt,160,0,0.02,160
10911,Matt,2,Private room,65,35,0.19,100
10912,Enzo,3,Entire home/apt,104,195,3.63,299
10913,Rob,1,Private room,60,0,0.26,60
10916,Jp,1,Entire home/apt,190,270,3.2,460
10918,Leticia,2,Private room,55,0,0.39,55
10919,Elissa,2,Entire home/apt,80,161,1.06,241
10920,Mordeana,3,Private room,65,222,0.85,287
10921,Emma,1,Entire home/apt,235,0,0.43,235
10922,Zlatko,1,Entire home/apt,205,0,0.13,205
10923,Kristofer,2,Entire home/apt,109,0,0.02,109
10924,Teddy,2,Private room,85,0,0.26,85
10925,Clifford,2,Private room,80,233,4.11,313
10926,Jonathan,1,Entire home/apt,120,0,0.09,120
10927,Bleik,1,Private room,130,0,0.02,130
10928,Katie,1,Entire home/apt,190,207,1.02,397
10930,Miklos,1,Private room,99,0,0.04,99
10932,Victoria,2,Private room,52,157,0.35,209
10933,Victoria,2,Entire home/apt,110,50,0.11,160
10935,Jack,1,Private room,99,0,0.02,99
10936,Gabi,1,Private room,137,32,3.55,169
10937,Sarah,1,Private room,85,0,0.04,85
10938,George,1,Entire home/apt,149,14,0.13,163
10939,Katarina,2,Entire home/apt,124,0,0.28,124
10940,Jaqui,1,Private room,125,0,0.51,125
10941,Susie,1,Private room,70,41,4.64,111
10942,Carlos,3,Private room,99,323,0.13,422
10943,Carlos,3,Private room,109,138,0.04,247
10944,Pooja,1,Entire home/apt,235,364,0.64,599
10945,Jennifer,2,Entire home/apt,95,0,0.44,95
10946,Apollo,1,Entire home/apt,250,297,0.17,547
10947,Joel,1,Private room,95,9,3.34,104
10948,Millie,1,Private room,85,186,1.55,271
10949,Chloe,1,Entire home/apt,190,0,0.09,190
10950,Chase,1,Private room,125,0,0.04,125
10951,Tracey,1,Entire home/apt,125,164,0.46,289
10952,Rachel,1,Entire home/apt,374,188,0.69,562
10953,Michele,2,Private room,160,364,0.04,524
10955,Tom And Claudia,2,Entire home/apt,70,183,3.74,253
10956,Yvette And Ashley,2,Entire home/apt,55,348,1.03,403
10957,Darren,1,Entire home/apt,100,0,0.2,100
10958,Aldi,1,Private room,95,351,1.31,446
10959,Ira,1,Entire home/apt,250,4,0.2,254
10960,Alisa & Dante,2,Entire home/apt,95,0,0.03,95
10961,Tsepak,3,Entire home/apt,89,331,0.2,420
10962,Faith,1,Entire home/apt,285,302,0.18,587
10963,Wei,1,Private room,127,0,0.04,127
10965,Charlie,1,Entire home/apt,225,0,0.02,225
10966,Emanuele,1,Entire home/apt,150,0,0.02,150
10967,Mathilde,2,Private room,50,0,0.04,50
10968,Ricky,1,Private room,60,363,0.16,423
10969,Lawrence,1,Entire home/apt,275,0,0.14,275
10970,Jessica,1,Shared room,65,0,0.17,65
10971,Josh & Chris,2,Private room,80,232,4.68,312
10972,Noelle,3,Entire home/apt,130,0,0.04,130
10974,Jordan,2,Private room,65,0,0.11,65
10975,Bailey,2,Private room,75,0,0.02,75
10976,Michael,2,Entire home/apt,200,359,1.82,559
10977,Zhehui,1,Private room,40,0,0.05,40
10978,Stephen,1,Entire home/apt,68,0,0.29,68
10979,Eli,2,Entire home/apt,130,356,0.33,486
10980,Leslie,1,Private room,135,20,2.19,155
10981,Leslie,1,Entire home/apt,165,70,0.54,235
10982,Alex,1,Entire home/apt,250,0,0.04,250
10983,Siju,3,Shared room,52,363,0.02,415
10984,Mark,1,Entire home/apt,170,0,0.03,170
10986,Matthieu,2,Private room,65,0,0.04,65
10987,Nikolina,2,Entire home/apt,80,0,0.75,80
10988,Chloé,1,Entire home/apt,130,0,0.11,130
10989,Avik,1,Entire home/apt,140,0,0.05,140
10990,Matthew,1,Entire home/apt,200,0,0.04,200
10991,Kevin,2,Private room,55,0,0.3,55
10993,Zaka,1,Entire home/apt,175,0,0.02,175
10995,Tara,1,Entire home/apt,99,18,0.09,117
10997,Charles,1,Entire home/apt,200,0,0.09,200
10999,Sebastian & Andrea,3,Private room,75,324,1.88,399
11000,Fleur,1,Entire home/apt,90,0,0.23,90
11001,Benjamin,3,Private room,51,0,0.26,51
11002,Ian,2,Private room,62,0,0.02,62
11004,Gina,2,Private room,90,0,0.02,90
11005,Natalie,2,Private room,45,0,0.02,45
11006,Justin,1,Private room,109,0,0.15,109
11007,Betsy,1,Private room,100,0,2.15,100
11008,Danielle,2,Entire home/apt,200,354,1.39,554
11009,Dallas,1,Private room,149,62,1.88,211
11010,Annesha,3,Private room,55,314,0.64,369
11012,Mike,2,Entire home/apt,70,0,0.02,70
11013,Hannah,2,Shared room,29,53,0.89,82
11014,Andrew,2,Entire home/apt,195,26,2.04,221
11015,Johann,1,Entire home/apt,220,0,0.05,220
11016,​ Valéria,3,Private room,80,249,0.66,329
11017,Saket,3,Private room,110,0,0.14,110
11018,Jessica M.,1,Private room,70,345,0.68,415
11019,Illtyd,1,Private room,90,28,1.04,118
11020,Anais,2,Entire home/apt,130,0,0.04,130
11021,David,1,Entire home/apt,2000,0,0.07,2000
11022,Veronica,1,Entire home/apt,149,12,2.84,161
11023,Taft,4,Entire home/apt,100,324,1.26,424
11024,Matt,2,Entire home/apt,100,0,0.13,100
11025,Dorothy,2,Entire home/apt,125,0,0.02,125
11027,Ed,1,Entire home/apt,199,349,4.5,548
11028,Anthony,2,Private room,50,365,0.06,415
11029,Michelle,1,Entire home/apt,300,0,0.04,300
11030,Deepak,1,Entire home/apt,285,0,0.04,285
11031,Jade,1,Entire home/apt,330,58,0.32,388
11032,Garnet,2,Private room,39,117,1.25,156
11034,Yves,2,Entire home/apt,77,265,3.0,342
11035,Mari,2,Entire home/apt,115,0,0.04,115
11036,Russell,1,Entire home/apt,99,0,0.28,99
11037,Rachel,1,Entire home/apt,250,0,0.02,250
11038,Brianna,1,Shared room,62,333,2.26,395
11039,Jacqueline,2,Entire home/apt,105,0,0.58,105
11040,Herman,3,Private room,55,344,0.15,399
11041,Benjamin,2,Entire home/apt,172,362,0.46,534
11044,Stephan,2,Private room,60,354,0.94,414
11045,Hayes,2,Private room,72,5,4.45,77
11047,Omar And Kareema,2,Entire home/apt,229,231,3.54,460
11048,Roland,3,Private room,70,349,1.5,419
11049,Alex,2,Shared room,40,360,0.07,400
11050,Trevor,1,Private room,99,131,1.1,230
11051,Maria,3,Private room,100,318,0.33,418
11052,Michael,1,Private room,78,0,0.11,78
11053,James,1,Entire home/apt,125,320,1.91,445
11054,Mike,1,Entire home/apt,190,249,2.83,439
11056,Shaun,1,Entire home/apt,135,0,0.04,135
11057,Dawn,2,Entire home/apt,250,0,1.04,250
11062,Judy,2,Entire home/apt,99,27,1.83,126
11063,Pedro J,3,Private room,50,0,0.24,50
11064,SidewalksofRIO,2,Private room,54,0,0.2,54
11065,Chris,2,Private room,70,0,0.57,70
11066,Dave,1,Private room,135,42,2.16,177
11067,Nick,1,Entire home/apt,425,0,2.17,425
11068,Fernando,2,Entire home/apt,122,189,0.07,311
11069,Noah,1,Entire home/apt,141,0,0.04,141
11071,Juan,2,Private room,70,159,0.37,229
11073,Anne,1,Entire home/apt,150,0,0.05,150
11074,Alex,1,Entire home/apt,250,0,0.02,250
11075,Eugene,1,Private room,115,29,2.71,144
11076,Mina,1,Entire home/apt,130,0,0.42,130
11077,Hayes,2,Private room,74,4,5.42,78
11078,Shivaul,2,Private room,48,248,1.34,296
11079,Carmen,1,Shared room,85,0,0.17,85
11080,Ayesha,1,Entire home/apt,180,0,0.04,180
11081,Kendra,2,Entire home/apt,97,0,0.04,97
11083,Vincent,1,Private room,100,365,2.52,465
11085,Will & Tash,1,Private room,105,0,1.61,105
11086,Claudia,2,Entire home/apt,100,0,0.07,100
11087,Sherry & Ivan,2,Entire home/apt,145,242,1.37,387
11088,Maurice,1,Entire home/apt,289,88,0.22,377
11089,Pietta,2,Entire home/apt,800,0,0.02,800
11091,Este,1,Private room,29,0,0.59,29
11092,Kathryn,2,Entire home/apt,70,0,0.15,70
11093,Erin,2,Private room,80,0,0.16,80
11095,Erin,2,Private room,60,268,1.75,328
11097,Curtis,2,Private room,70,359,0.48,429
11098,Brooke,1,Entire home/apt,175,0,0.35,175
11099,Danforth,5,Entire home/apt,144,258,2.3,402
11100,Paul,2,Private room,40,0,0.4,40
11102,Zac,1,Private room,180,0,0.59,180
11103,Caroline,1,Private room,75,60,3.55,135
11104,Jovanna,2,Entire home/apt,80,343,1.23,423
11105,Michal And John,2,Entire home/apt,352,0,0.16,352
11106,Nadir,3,Private room,69,67,1.37,136
11107,Elena,1,Entire home/apt,150,36,2.95,186
11109,John,2,Entire home/apt,250,0,0.14,250
11110,Zac,1,Entire home/apt,280,0,0.05,280
11111,Alihan,2,Private room,55,0,0.37,55
11112,M&L,3,Private room,50,65,0.07,115
11113,Christina,2,Private room,49,0,0.02,49
11115,Caitlin,2,Private room,45,0,0.05,45
11116,Devon,2,Entire home/apt,150,74,1.49,224
11117,Christopher,2,Entire home/apt,120,0,0.03,120
11118,Victoria,1,Entire home/apt,150,55,1.94,205
11119,Ajna,2,Entire home/apt,120,221,3.17,341
11120,Nicholas,1,Entire home/apt,80,0,0.07,80
11121,Sheying,1,Private room,60,30,2.32,90
11122,​ Valéria,3,Private room,70,36,0.02,106
11123,Richard,1,Entire home/apt,239,118,4.18,357
11125,Deb,2,Entire home/apt,89,279,1.5,368
11127,Mariana,1,Private room,50,0,0.13,50
11128,Claudia,3,Shared room,37,362,0.76,399
11129,Jenny,1,Entire home/apt,239,305,5.98,544
11131,Veronika,2,Entire home/apt,150,0,0.27,150
11132,Mary,1,Private room,150,0,0.02,150
11133,Althea,2,Entire home/apt,360,261,0.37,621
11134,Christine,1,Private room,115,23,1.97,138
11135,Laure,1,Entire home/apt,150,0,0.04,150
11136,Camila,1,Entire home/apt,207,88,2.16,295
11137,'Cil,3,Private room,120,298,5.22,418
11138,Lucy,1,Entire home/apt,160,0,0.03,160
11139,Patricia,3,Entire home/apt,85,317,1.26,402
11140,Candace,2,Entire home/apt,100,0,0.04,100
11141,Melody,2,Private room,45,249,0.69,294
11142,Stephanie,2,Entire home/apt,160,271,1.72,431
11143,Hiroki,3,Private room,40,30,0.77,70
11144,Karen,2,Private room,49,283,0.94,332
11146,Keith,1,Entire home/apt,495,0,0.09,495
11147,Sidiq,2,Private room,89,76,0.42,165
11148,Paige,1,Entire home/apt,220,4,0.16,224
11149,Tania,1,Private room,99,363,1.71,462
11151,Michele,2,Private room,80,0,0.04,80
11152,Eric,2,Private room,78,0,0.51,78
11153,Dorthy,2,Private room,110,0,0.02,110
11154,Lei,1,Entire home/apt,130,66,0.69,196
11155,Sara,1,Entire home/apt,150,0,0.05,150
11156,Joan,3,Entire home/apt,59,346,2.79,405
11157,Katie,2,Private room,80,0,0.02,80
11158,Alexis,1,Private room,80,0,0.02,80
11159,Richard,1,Entire home/apt,160,0,0.18,160
11160,Samuel,2,Private room,45,0,1.9,45
11161,Jason,1,Private room,94,0,0.02,94
11162,Stella,3,Private room,77,11,5.61,88
11163,Julie,2,Entire home/apt,149,268,2.38,417
11164,Jen,2,Entire home/apt,130,0,0.04,130
11165,Alan,3,Private room,57,5,0.19,62
11166,Eli,2,Entire home/apt,150,0,0.2,150
11167,Paula,3,Private room,55,249,0.13,304
11168,Marisa,1,Entire home/apt,127,0,0.07,127
11169,Moni,2,Private room,60,363,0.44,423
11170,Nguyen,1,Private room,64,249,0.36,313
11171,Rani,2,Private room,40,67,0.5,107
11172,Sean,1,Private room,50,199,2.68,249
11173,Hayes,2,Private room,83,0,4.53,83
11174,Jonathan,2,Entire home/apt,200,0,0.11,200
11175,Rajiv,1,Private room,49,276,0.55,325
11176,Hayes,2,Private room,60,0,4.29,60
11177,Adishwar,3,Private room,45,0,0.03,45
11178,Lauren,1,Entire home/apt,180,0,0.04,180
11179,Florencia,2,Private room,45,34,0.34,79
11180,Luis,2,Entire home/apt,89,291,2.26,380
11181,Thomas,2,Private room,25,0,0.02,25
11182,Kevin,2,Entire home/apt,285,13,1.2,298
11183,Philip,1,Private room,100,279,2.07,379
11184,Amy,3,Private room,90,0,0.02,90
11185,Ayman,5,Entire home/apt,75,310,2.85,385
11186,Justin,3,Entire home/apt,75,0,0.03,75
11187,Evan,1,Private room,200,0,3.32,200
11188,Nora,2,Shared room,35,351,2.55,386
11189,Mattan,1,Entire home/apt,297,0,0.24,297
11191,Rose-Marie,2,Entire home/apt,195,38,2.56,233
11192,John,2,Entire home/apt,80,0,0.15,80
11193,Laura,2,Private room,50,365,0.22,415
11194,Nir,1,Entire home/apt,115,37,0.41,152
11195,Summer,2,Entire home/apt,70,0,0.26,70
11196,Jennifer,2,Entire home/apt,119,0,0.29,119
11197,Michael,5,Entire home/apt,120,333,0.58,453
11199,Regina,1,Entire home/apt,250,1,0.19,251
11201,Sarah,1,Entire home/apt,45,0,0.02,45
11203,Lyndell,1,Entire home/apt,155,0,0.08,155
11204,Obi,1,Shared room,97,0,0.02,97
11205,Burak,3,Private room,75,0,0.12,75
11206,Tny,1,Entire home/apt,155,52,0.19,207
11207,Niki,1,Entire home/apt,237,0,0.15,237
11209,Sophie,1,Entire home/apt,250,0,0.18,250
11210,Amy,3,Private room,60,76,0.59,136
11211,Dlb,3,Private room,42,189,1.22,231
11212,Niki,1,Private room,105,0,0.4,105
11214,Jennifer,2,Private room,120,177,2.75,297
11215,Emily,2,Private room,80,0,0.02,80
11216,Virginia,1,Entire home/apt,125,0,0.13,125
11217,Tyler,3,Entire home/apt,125,0,0.33,125
11218,Freda,3,Private room,50,317,0.06,367
11219,Miles,2,Private room,60,0,0.22,60
11220,Bea Ebony,2,Entire home/apt,90,267,1.78,357
11222,William,1,Entire home/apt,275,216,3.26,491
11223,Lilian,1,Private room,100,44,3.22,144
11224,Nickie,1,Private room,200,0,0.02,200
11225,Jose,1,Private room,99,299,3.75,398
11226,Jen,1,Private room,112,0,0.68,112
11227,Jonas,2,Private room,65,0,0.02,65
11228,Jamaal,1,Entire home/apt,200,0,0.2,200
11229,Anita,2,Entire home/apt,98,102,2.96,200
11230,Tsepak,3,Private room,50,356,1.08,406
11231,Jorge,3,Entire home/apt,135,0,0.24,135
11232,Marjorie,2,Private room,50,188,4.23,238
11233,Carol,1,Entire home/apt,145,0,0.05,145
11235,Karan,1,Private room,141,0,0.04,141
11236,Diana,2,Private room,110,316,1.9,426
11238,Ariel,2,Entire home/apt,110,284,0.19,394
11240,Jen,1,Entire home/apt,299,0,0.05,299
11241,Olivia,1,Entire home/apt,190,42,0.58,232
11243,Mei,1,Private room,70,0,0.29,70
11244,Ambria,1,Entire home/apt,75,0,0.09,75
11245,Sarena,1,Entire home/apt,155,0,0.37,155
11246,Corey,1,Entire home/apt,96,0,0.75,96
11247,Erin,2,Entire home/apt,350,0,0.04,350
11248,Richard,1,Private room,90,2,1.36,92
11249,Jeff & Stephanie,1,Entire home/apt,500,46,1.23,546
11251,Saman,1,Entire home/apt,175,0,0.34,175
11252,Genéa,2,Entire home/apt,50,0,0.02,50
11253,Tom,1,Entire home/apt,130,217,6.46,347
11254,Paolo,2,Private room,90,0,0.02,90
11255,Angie,1,Private room,65,270,0.83,335
11256,Kacy,1,Entire home/apt,200,0,0.03,200
11257,Jean,2,Entire home/apt,63,98,0.78,161
11258,Francia,1,Private room,110,0,0.07,110
11259,Mary Beth,3,Entire home/apt,100,90,0.31,190
11260,Ed,1,Private room,60,188,0.25,248
11261,Andy & Friends,2,Private room,45,0,0.7,45
11262,Lilian,1,Entire home/apt,117,29,2.77,146
11263,Aaron,2,Entire home/apt,175,32,0.23,207
11264,Brian,2,Entire home/apt,2000,365,0.02,2365
11266,Faith,1,Private room,148,16,0.84,164
11269,Cadet,2,Private room,100,89,0.22,189
11270,Elem,1,Entire home/apt,200,336,0.07,536
11271,Trace,1,Entire home/apt,650,0,0.04,650
11272,Raquel,1,Entire home/apt,199,1,1.28,200
11273,Mike,1,Entire home/apt,115,341,0.03,456
11274,John,1,Entire home/apt,245,0,1.12,245
11275,Freda,3,Entire home/apt,187,275,1.33,462
11276,J.,1,Entire home/apt,88,39,0.53,127
11277,Emma,1,Entire home/apt,280,0,0.02,280
11279,Henna,1,Entire home/apt,95,0,0.02,95
11280,Jessica,1,Entire home/apt,260,236,3.85,496
11281,Antonio,1,Entire home/apt,148,0,0.02,148
11282,Mike,1,Entire home/apt,100,365,0.05,465
11283,Ed,1,Private room,100,78,1.27,178
11285,Grisula,1,Private room,64,210,3.12,274
11286,Barbara,2,Private room,125,80,0.67,205
11288,Valjean,1,Entire home/apt,110,0,0.11,110
11290,Tny,1,Entire home/apt,140,0,0.15,140
11291,Rhea,2,Private room,35,0,0.2,35
11292,Fahim,3,Entire home/apt,85,50,2.11,135
11293,Tianyou,1,Private room,111,0,0.09,111
11294,Marcelo,1,Entire home/apt,399,365,0.11,764
11295,Claudia,3,Shared room,40,351,0.87,391
11297,Tzooli And Ay,2,Private room,180,189,0.28,369
11298,Alexandra,1,Private room,100,0,0.02,100
11299,Jason,2,Entire home/apt,150,92,4.48,242
11300,Josh,1,Private room,63,276,1.14,339
11301,Manrique And Ticiani,1,Entire home/apt,175,0,0.02,175
11302,Jaime,2,Private room,84,0,0.38,84
11303,Alba & Genesis,4,Private room,33,282,2.27,315
11304,Michael,2,Private room,50,35,0.02,85
11305,La,2,Private room,75,0,0.02,75
11306,Michael,1,Private room,125,256,0.22,381
11307,Adam,2,Entire home/apt,140,1,0.49,141
11309,Sol,2,Entire home/apt,250,365,1.46,615
11310,Andrew,2,Private room,60,0,0.02,60
11313,David,1,Entire home/apt,140,16,1.23,156
11314,Brady,1,Entire home/apt,190,0,0.35,190
11315,Cathy,2,Entire home/apt,91,38,3.66,129
11316,Mungyu,2,Private room,40,105,0.75,145
11319,Katia,3,Entire home/apt,72,0,0.15,72
11320,Eli And Maggie,2,Entire home/apt,130,49,2.83,179
11321,Laurent,2,Private room,90,0,0.13,90
11322,Pierre,1,Private room,100,313,0.06,413
11323,Sofia,1,Private room,150,0,4.95,150
11324,William,1,Private room,62,144,0.74,206
11325,Christina,1,Entire home/apt,100,0,0.11,100
11326,Sofia,1,Private room,150,0,4.55,150
11327,Tina,1,Entire home/apt,95,6,0.11,101
11328,Sinat,2,Entire home/apt,170,0,0.19,170
11329,Sandra And Cary,2,Private room,40,130,0.39,170
11330,Laramie,2,Private room,54,135,0.53,189
11331,Aj,2,Private room,30,0,0.12,30
11332,Keith,1,Entire home/apt,150,66,1.13,216
11333,Quili (Sounds Keelee),1,Entire home/apt,250,7,0.73,257
11334,Rebecca,2,Private room,50,0,0.02,50
11335,Razan,2,Entire home/apt,120,0,0.02,120
11336,Julia,1,Entire home/apt,410,346,0.15,756
11337,Ashley,2,Entire home/apt,73,21,0.07,94
11338,Cihan,1,Entire home/apt,250,0,0.02,250
11340,John,1,Entire home/apt,250,0,0.04,250
11341,Mattan,1,Private room,139,0,0.13,139
11342,Sergio,1,Entire home/apt,149,0,0.28,149
11343,Mike,1,Entire home/apt,185,22,5.65,207
11344,Natasha,1,Private room,230,0,0.23,230
11345,Peter,1,Entire home/apt,175,4,1.11,179
11346,Karina,1,Entire home/apt,150,0,0.02,150
11347,Paulina,2,Entire home/apt,325,47,5.85,372
11350,Priscilla,1,Entire home/apt,80,88,0.67,168
11351,Beverly,2,Entire home/apt,135,268,0.65,403
11352,Martha,3,Private room,32,0,0.08,32
11353,Jessy & Grant,1,Entire home/apt,261,125,4.3,386
11355,Reuben,2,Private room,57,228,2.06,285
11356,Angela,1,Entire home/apt,225,231,1.62,456
11357,Brandon,2,Entire home/apt,200,0,0.02,200
11359,Alex,1,Entire home/apt,200,0,0.11,200
11361,Anita,2,Private room,65,131,1.79,196
11362,Daphne,2,Entire home/apt,150,0,0.02,150
11363,George - Francis,1,Entire home/apt,375,0,0.07,375
11365,Gretchen,2,Private room,45,0,0.27,45
11366,Jerry,1,Entire home/apt,225,0,0.04,225
11367,Lauren,1,Entire home/apt,165,55,0.71,220
11369,Maory,2,Entire home/apt,1150,0,0.04,1150
11370,Lizzie,2,Entire home/apt,85,0,0.03,85
11372,John,1,Entire home/apt,125,0,0.04,125
11375,Matt,2,Entire home/apt,100,0,0.05,100
11376,Kevin,1,Entire home/apt,179,6,0.58,185
11377,David,2,Private room,50,0,0.09,50
11378,Irving,2,Entire home/apt,115,347,0.7,462
11379,Jake And Catharine,2,Entire home/apt,100,105,3.32,205
11380,Nadir,3,Private room,75,35,2.08,110
11381,Rae,2,Private room,60,0,0.09,60
11382,Ellie,1,Entire home/apt,240,0,0.02,240
11383,Yve,1,Entire home/apt,290,188,1.33,478
11384,Dan,2,Private room,56,68,1.74,124
11385,Tia,1,Private room,95,170,0.72,265
11386,T.,1,Private room,70,293,1.78,363
11387,Jean-Noël,1,Entire home/apt,125,0,0.18,125
11388,Jordanna,1,Entire home/apt,195,0,0.09,195
11389,Michion,3,Private room,45,335,0.65,380
11391,Mia,2,Private room,50,0,0.2,50
11393,Emmanuelle,2,Private room,55,21,4.46,76
11394,Odette,2,Entire home/apt,1000,0,0.02,1000
11395,Liana,3,Private room,42,0,0.02,42
11397,Mikael,2,Entire home/apt,105,365,1.19,470
11398,Jason,2,Private room,45,66,0.24,111
11399,Josefine,1,Entire home/apt,125,0,0.06,125
11400,Dlb,3,Private room,45,333,1.99,378
11401,Bahar,2,Private room,95,22,0.22,117
11402,Kate,2,Entire home/apt,200,0,0.16,200
11403,Elizabeth,1,Entire home/apt,190,12,1.68,202
11404,Darryl,1,Entire home/apt,170,364,0.82,534
11406,Kenneth,2,Private room,54,0,0.05,54
11407,Heather,1,Entire home/apt,150,0,0.07,150
11408,Sean,1,Entire home/apt,300,0,0.02,300
11409,Nia & David,2,Private room,115,362,0.92,477
11410,Anne Marie,1,Entire home/apt,225,344,1.9,569
11412,Tny,1,Entire home/apt,125,0,0.27,125
11413,Brenda,1,Entire home/apt,250,0,0.02,250
11414,Armando Rafael,2,Entire home/apt,129,0,2.1,129
11415,Gypsy,1,Entire home/apt,135,19,2.56,154
11417,Arielle,2,Entire home/apt,175,0,0.77,175
11418,Giovana,3,Private room,55,0,0.13,55
11420,Stanley,1,Private room,125,0,0.05,125
11421,Emilie,2,Entire home/apt,200,0,0.06,200
11422,Stacy,2,Private room,40,343,0.28,383
11423,Amy,3,Private room,50,83,1.57,133
11424,Matt,2,Private room,166,0,0.36,166
11425,Darin,1,Private room,124,278,2.7,402
11426,Emma,2,Private room,65,204,0.7,269
11427,Angela,1,Private room,57,1,0.13,58
11428,Bobby,1,Private room,100,0,0.02,100
11429,Marcos,2,Private room,60,0,0.2,60
11430,Jasmin,2,Private room,90,222,5.59,312
11431,Quentin,1,Private room,130,289,1.75,419
11432,Odile,2,Entire home/apt,350,0,0.42,350
11433,Eric,2,Private room,60,0,0.02,60
11434,Oliver,1,Private room,80,0,0.15,80
11437,Djamal,3,Entire home/apt,100,321,1.63,421
11439,Holly/Rick,2,Entire home/apt,200,243,2.61,443
11440,Bryan,1,Private room,120,0,0.38,120
11441,M&L,3,Private room,170,90,0.03,260
11442,Charlotte,2,Private room,42,0,0.07,42
11443,Tracey,1,Private room,50,344,0.85,394
11444,Michael,1,Entire home/apt,170,0,0.16,170
11445,Mike,1,Entire home/apt,189,347,3.71,536
11446,Yulia,1,Entire home/apt,150,0,0.24,150
11447,Jibran,1,Private room,77,0,0.21,77
11449,Dan,2,Private room,60,261,3.63,321
11450,Philipp,1,Entire home/apt,150,0,0.03,150
11451,Kim,1,Entire home/apt,120,0,0.05,120
11452,Brianna,1,Entire home/apt,85,0,0.05,85
11453,Jasmin,2,Private room,85,227,5.94,312
11454,Jazil,1,Entire home/apt,450,0,0.05,450
11455,Paisha,4,Private room,60,363,0.19,423
11456,Christine,1,Entire home/apt,95,0,0.11,95
11457,Enrique,4,Private room,38,267,1.1,305
11459,Sean,3,Entire home/apt,125,0,0.05,125
11460,Irene,1,Private room,125,0,0.02,125
11462,Nadav,2,Private room,59,119,1.3,178
11463,Che,1,Entire home/apt,65,16,0.73,81
11464,Cyrus,2,Entire home/apt,259,250,4.9,509
11466,Andrea,1,Private room,60,0,0.51,60
11467,Liam,2,Private room,95,191,0.45,286
11468,Alexis,2,Shared room,45,0,0.02,45
11469,Shannon,1,Entire home/apt,133,2,0.89,135
11470,J,1,Entire home/apt,259,34,2.29,293
11471,Patrick,2,Entire home/apt,150,279,0.89,429
11473,Camille,1,Entire home/apt,139,0,0.13,139
11474,Ibrahim,1,Private room,39,0,0.13,39
11476,Carole,1,Entire home/apt,434,0,0.05,434
11478,Emily,2,Entire home/apt,100,0,0.05,100
11479,Alex,3,Entire home/apt,99,128,0.91,227
11480,Unue,2,Private room,70,333,1.44,403
11482,Michael,2,Private room,88,68,1.44,156
11485,Melissa,2,Entire home/apt,140,126,1.31,266
11486,D,1,Private room,80,345,1.15,425
11487,Ashley,2,Private room,44,0,0.02,44
11490,Kirk,1,Entire home/apt,299,0,0.09,299
11491,Tom,2,Entire home/apt,195,63,1.93,258
11492,Sabine,2,Entire home/apt,140,0,0.18,140
11493,Elle,1,Entire home/apt,180,0,0.02,180
11495,Manchang,3,Private room,70,54,3.1,124
11496,Anthony,2,Private room,55,365,0.19,420
11497,Malav,2,Private room,65,0,0.02,65
11498,Anthony,2,Private room,45,250,0.41,295
11499,Vitaly And Lena,2,Entire home/apt,96,73,2.06,169
11500,Elle,1,Private room,82,28,5.11,110
11501,Katie,1,Entire home/apt,150,0,0.14,150
11502,Zoe,2,Private room,125,0,0.02,125
11503,Veronica,2,Entire home/apt,115,0,0.02,115
11504,Graham,1,Entire home/apt,145,15,1.38,160
11505,Mel,2,Entire home/apt,169,39,2.59,208
11506,Janet & Vincent,2,Private room,75,355,0.33,430
11507,C,1,Entire home/apt,100,0,0.05,100
11508,Tine,2,Entire home/apt,69,0,0.03,69
11509,Lolita,3,Private room,45,283,3.06,328
11511,Lolita,3,Private room,55,276,3.19,331
11512,Lolita,3,Private room,55,311,1.78,366
11513,Lolita,3,Private room,48,323,3.39,371
11514,Lolita,3,Private room,50,341,2.21,391
11515,Grace,2,Private room,56,0,0.02,56
11516,Liz And Cesar,2,Private room,65,319,0.3,384
11517,Kristen,2,Entire home/apt,140,2,1.65,142
11518,Emmanoele,2,Private room,95,209,1.27,304
11519,Tamara,1,Private room,73,177,2.08,250
11521,Frahydel,1,Entire home/apt,180,0,0.05,180
11522,Madelyn,2,Private room,47,0,0.18,47
11523,Phuong,1,Shared room,55,0,0.12,55
11524,Alexis,2,Entire home/apt,125,0,0.22,125
11525,Jessica,3,Private room,60,0,0.21,60
11527,Piero,2,Entire home/apt,225,0,0.03,225
11528,Elizabeth,2,Entire home/apt,169,345,0.87,514
11529,Alex,2,Private room,45,124,0.15,169
11530,Ausra,1,Entire home/apt,130,0,0.09,130
11531,Amélie,2,Private room,53,0,0.02,53
11532,Jasmine,2,Entire home/apt,150,287,2.69,437
11533,Adrien,1,Private room,140,0,0.29,140
11535,Ian,1,Private room,98,0,0.02,98
11536,Robin,2,Entire home/apt,120,49,2.04,169
11537,Tide,1,Entire home/apt,170,0,0.02,170
11538,Rajiv,1,Private room,47,210,0.54,257
11539,Sandy,2,Entire home/apt,129,133,3.55,262
11540,Sandy,2,Entire home/apt,119,65,3.88,184
11543,Benjamin,2,Private room,50,0,0.54,50
11544,Maria,1,Entire home/apt,100,49,0.6,149
11545,Leigha,2,Private room,55,0,0.09,55
11547,Danielle,2,Entire home/apt,275,0,1.14,275
11548,Natalie,2,Private room,65,156,0.13,221
11549,Joel,2,Entire home/apt,170,0,0.62,170
11550,Lauren,4,Private room,95,173,0.14,268
11552,Maribel,1,Entire home/apt,175,187,4.12,362
11555,Jelena,2,Entire home/apt,150,0,0.42,150
11556,Amelia,2,Entire home/apt,75,0,0.15,75
11559,Henry,2,Private room,51,0,0.05,51
11560,Lorena,1,Entire home/apt,899,287,1.16,1186
11562,Alex,2,Shared room,25,343,0.18,368
11563,Maya,3,Private room,65,333,2.76,398
11564,Michael,2,Private room,42,340,2.84,382
11565,Stefan,2,Private room,40,0,0.28,40
11566,Lawanne,2,Private room,60,361,0.21,421
11567,Dan,1,Entire home/apt,157,0,0.1,157
11568,Maria,1,Entire home/apt,170,0,0.02,170
11569,Carlos,2,Private room,50,217,0.33,267
11570,Maria,3,Private room,55,293,2.1,348
11571,Mark,2,Private room,45,0,0.07,45
11572,Kara,1,Entire home/apt,109,184,0.03,293
11573,Heather,2,Entire home/apt,105,55,2.92,160
11574,Jillian,1,Entire home/apt,150,326,1.07,476
11575,Nathan,1,Private room,45,0,0.02,45
11576,Alex,2,Shared room,40,365,0.11,405
11577,Philip,2,Private room,105,312,0.71,417
11578,Tny,1,Entire home/apt,135,282,0.19,417
11580,Miranda,2,Entire home/apt,150,0,0.02,150
11581,Joel,2,Entire home/apt,70,274,1.77,344
11582,Deniz,2,Entire home/apt,120,294,0.64,414
11584,Nieve,1,Private room,100,0,0.12,100
11585,Edlira,1,Private room,125,80,2.87,205
11586,Patrick,1,Entire home/apt,170,260,4.36,430
11587,Sean,1,Private room,80,0,0.02,80
11588,Sebastian,2,Private room,249,360,0.45,609
11589,Harry,2,Entire home/apt,350,0,0.09,350
11594,Jayden,1,Entire home/apt,139,0,0.25,139
11595,Isabel,2,Entire home/apt,89,2,0.12,91
11596,Vida,2,Entire home/apt,159,343,0.15,502
11598,Alex & Alena,2,Private room,70,40,1.53,110
11600,Rachel,1,Entire home/apt,200,0,0.26,200
11601,Kara,1,Entire home/apt,169,364,0.05,533
11604,Alisa,2,Private room,90,76,3.17,166
11606,Michelle,1,Entire home/apt,305,132,3.89,437
11608,Paul,1,Entire home/apt,88,95,1.62,183
11609,Claude,1,Entire home/apt,110,5,1.78,115
11611,Kya & Evan,2,Entire home/apt,150,0,0.24,150
11612,Zhenya,2,Private room,50,0,0.14,50
11613,Heather,2,Entire home/apt,125,0,0.08,125
11614,Patrick,1,Entire home/apt,125,0,0.1,125
11615,Ricky,1,Private room,80,0,0.02,80
11617,Alice,1,Entire home/apt,120,0,0.1,120
11618,Angela,2,Private room,79,0,0.02,79
11620,Phil,1,Entire home/apt,190,41,0.97,231
11621,Kara,1,Entire home/apt,239,186,0.09,425
11622,Amy,1,Entire home/apt,200,0,0.65,200
11623,Diana,5,Entire home/apt,200,0,0.02,200
11624,Mel,1,Entire home/apt,175,193,0.99,368
11625,Robyn,1,Entire home/apt,200,0,0.02,200
11626,Alister,2,Entire home/apt,130,163,2.93,293
11627,Vadim,1,Entire home/apt,95,0,0.04,95
11628,Talia,1,Entire home/apt,140,0,0.07,140
11629,Allan (& Max),3,Private room,100,284,1.18,384
11630,Mary,1,Private room,75,89,0.03,164
11632,Cal,1,Shared room,80,0,0.38,80
11633,Simone,2,Private room,60,0,0.52,60
11634,Babajide,2,Entire home/apt,125,229,2.79,354
11635,Kay,2,Private room,80,0,0.05,80
11636,Tatiana,2,Entire home/apt,97,2,0.54,99
11638,Hannah,1,Private room,110,0,0.05,110
11639,Elizabeth,2,Entire home/apt,140,37,1.34,177
11640,Mark,2,Private room,57,216,0.37,273
11643,Christine,2,Private room,50,0,0.03,50
11644,Dario,1,Entire home/apt,180,0,0.02,180
11646,Michael Francis,1,Entire home/apt,180,29,0.42,209
11647,Yasmin,2,Entire home/apt,100,0,0.31,100
11648,Brinn,2,Entire home/apt,175,38,1.4,213
11650,Chris,1,Private room,100,0,0.07,100
11651,Eric,2,Entire home/apt,250,0,0.02,250
11655,Laura,2,Entire home/apt,150,0,0.02,150
11656,Sheila,3,Private room,90,3,1.02,93
11657,Polly,1,Entire home/apt,150,37,0.14,187
11658,Kara,1,Entire home/apt,190,0,0.05,190
11660,Aura,1,Private room,75,0,2.07,75
11661,Mariana,2,Entire home/apt,150,0,0.28,150
11663,Allison,2,Private room,65,18,0.18,83
11664,Alex,2,Shared room,27,342,0.16,369
11665,Babajide,2,Entire home/apt,150,263,2.74,413
11666,Joanne,1,Private room,75,0,1.18,75
11667,Anthony,2,Private room,80,0,0.89,80
11668,Anne-Laure,1,Entire home/apt,185,0,0.09,185
11669,Eyal,2,Private room,55,0,0.05,55
11670,Regina,2,Entire home/apt,98,320,0.27,418
11671,Jason,2,Entire home/apt,165,231,5.18,396
11672,Marcelo,2,Private room,75,0,0.89,75
11673,Sean,1,Entire home/apt,145,0,0.07,145
11674,Jordan,1,Entire home/apt,135,0,0.23,135
11675,Alexander,3,Private room,50,0,0.02,50
11676,Dan,1,Private room,100,0,0.72,100
11678,Kathleen,1,Entire home/apt,130,0,0.13,130
11679,Jacqueline,1,Private room,145,0,0.02,145
11681,Miriam,2,Entire home/apt,120,0,0.21,120
11682,Marie,1,Private room,90,211,1.54,301
11684,Annie,1,Entire home/apt,250,0,0.07,250
11685,Homero,2,Entire home/apt,90,0,0.02,90
11686,Jason,1,Entire home/apt,165,139,0.22,304
11687,Saara,1,Entire home/apt,175,0,0.2,175
11688,Marisa & Tom,2,Entire home/apt,120,333,1.65,453
11689,Shawn,1,Private room,85,0,0.07,85
11690,Chikezie,1,Private room,90,0,0.02,90
11691,Amy,2,Private room,70,0,0.21,70
11692,Miranda,1,Entire home/apt,110,0,0.02,110
11694,Nir,1,Entire home/apt,125,56,0.3,181
11697,Isabella,1,Entire home/apt,195,0,0.14,195
11699,Ryan,1,Private room,104,0,1.46,104
11701,Geoffrey,2,Private room,45,0,0.04,45
11704,Kai,2,Private room,40,0,0.02,40
11705,Sara,1,Entire home/apt,100,0,0.39,100
11706,Andres,1,Entire home/apt,295,0,0.05,295
11707,Lila,1,Entire home/apt,75,80,2.89,155
11708,Dlb,3,Private room,34,282,1.72,316
11710,Mireia,2,Private room,75,0,0.16,75
11711,Allie,1,Entire home/apt,110,304,1.9,414
11713,Jessica,1,Entire home/apt,185,0,0.06,185
11714,Jaclyn,1,Entire home/apt,145,76,2.38,221
11715,Lizzy And Ryan,1,Entire home/apt,250,147,0.78,397
11717,Missy & Julien,2,Entire home/apt,145,88,2.26,233
11720,Anya,1,Entire home/apt,195,0,0.09,195
11721,Dasha,1,Private room,86,0,0.07,86
11724,Sonskeshana,1,Private room,65,280,0.39,345
11725,Dan,1,Entire home/apt,199,114,0.63,313
11726,Laura,2,Private room,55,110,1.72,165
11727,Rachel,2,Entire home/apt,150,0,0.9,150
11729,Cathy,1,Entire home/apt,100,0,0.07,100
11730,Sha,2,Entire home/apt,149,360,0.67,509
11731,Jac,1,Private room,36,0,0.02,36
11732,Herman,3,Private room,50,346,0.08,396
11733,Maxime,1,Private room,50,180,1.51,230
11735,Sofia,1,Private room,73,0,0.09,73
11736,Annie,2,Entire home/apt,100,211,0.07,311
11737,Andrea,1,Entire home/apt,193,0,0.23,193
11738,June,3,Private room,79,180,0.31,259
11739,Lena,2,Private room,60,0,0.05,60
11740,Marco,2,Private room,60,0,0.02,60
11741,Kira,1,Entire home/apt,159,157,4.19,316
11742,Sebastian,2,Private room,75,0,0.04,75
11743,Evelyn,2,Entire home/apt,750,365,0.17,1115
11744,Jake,1,Private room,235,0,0.04,235
11746,Christine,1,Private room,41,37,2.78,78
11747,Ross,1,Entire home/apt,220,293,2.48,513
11749,Jonathan,1,Entire home/apt,180,0,0.11,180
11750,Jay,1,Entire home/apt,185,0,0.23,185
11751,Matt,1,Entire home/apt,225,0,0.02,225
11753,Zachary,2,Entire home/apt,150,6,0.21,156
11754,Iris,3,Private room,74,5,0.13,79
11755,Rhemy,2,Private room,49,200,3.05,249
11756,Denise,1,Private room,140,0,0.02,140
11757,David,1,Entire home/apt,180,0,0.98,180
11758,Emily,2,Private room,50,0,0.05,50
11759,Dona,3,Private room,47,333,14.58,380
11760,Ruchi,1,Entire home/apt,245,331,0.03,576
11761,Charlotte,2,Entire home/apt,115,241,2.92,356
11762,Colin,2,Private room,50,0,0.02,50
11763,Diane,4,Entire home/apt,110,162,2.6,272
11764,Philip,2,Private room,125,292,0.59,417
11765,Diego,1,Entire home/apt,150,37,2.11,187
11766,Rob,1,Entire home/apt,139,0,0.02,139
11768,Host,1,Entire home/apt,150,241,0.39,391
11769,Jared,2,Private room,79,58,1.91,137
11770,Maria,2,Entire home/apt,240,0,0.05,240
11771,Soph,2,Entire home/apt,115,0,0.02,115
11772,Luciana,2,Entire home/apt,120,262,4.1,382
11773,Andy,2,Entire home/apt,200,0,0.02,200
11774,Andy,2,Entire home/apt,200,0,0.02,200
11775,Rebecca,1,Entire home/apt,150,0,0.04,150
11776,Sha,2,Entire home/apt,165,289,1.24,454
11777,Lydia,1,Private room,85,36,0.23,121
11778,Jonathan,1,Entire home/apt,130,0,0.1,130
11779,Anshu,1,Private room,85,0,0.02,85
11780,Masud,2,Entire home/apt,90,351,1.83,441
11782,Lior,1,Entire home/apt,70,341,0.06,411
11783,Hayet,2,Private room,40,289,0.23,329
11784,Catherine,1,Private room,55,0,0.54,55
11785,Michael,1,Entire home/apt,130,237,4.73,367
11786,Ye,1,Private room,60,0,0.03,60
11787,Steven And John,2,Private room,65,0,1.61,65
11788,Lorena,1,Entire home/apt,249,249,2.4,498
11789,Grayson,2,Private room,75,0,0.02,75
11790,Gerard,1,Entire home/apt,500,0,0.05,500
11791,Katherine,1,Entire home/apt,169,231,1.51,400
11793,Katie,1,Entire home/apt,95,0,0.14,95
11796,Agnieszka,1,Entire home/apt,120,0,0.02,120
11797,Shawn,1,Entire home/apt,180,4,0.35,184
11798,D. Christopher,1,Private room,80,58,4.51,138
11799,Jhovana,1,Private room,90,63,1.62,153
11800,Amal,3,Entire home/apt,140,38,0.25,178
11801,Jacob,1,Entire home/apt,200,0,0.02,200
11802,Adam,1,Private room,139,0,0.07,139
11804,Sean,1,Private room,47,0,0.04,47
11805,Merrily,2,Entire home/apt,108,21,0.43,129
11807,Harman,3,Entire home/apt,75,332,1.9,407
11808,Jane,2,Private room,60,0,0.05,60
11809,Krzysztof,2,Private room,80,0,0.05,80
11811,John,3,Private room,50,0,0.42,50
11814,Jonathan,1,Entire home/apt,275,253,0.09,528
11816,Ragan,1,Private room,65,0,0.54,65
11817,Ibrahima,1,Private room,65,159,0.05,224
11819,Nima,2,Entire home/apt,132,0,0.02,132
11820,Priscilla,1,Shared room,35,55,0.63,90
11822,Jackie,1,Private room,75,0,0.02,75
11823,Todd,1,Private room,100,0,0.05,100
11824,Sara,2,Entire home/apt,89,0,0.07,89
11825,Megan,2,Private room,50,0,0.02,50
11832,Brian,1,Entire home/apt,450,0,0.23,450
11833,Christina,1,Entire home/apt,80,0,0.05,80
11834,Scott,2,Private room,90,16,1.04,106
11835,Shervin,2,Private room,100,0,0.03,100
11836,Debra,1,Entire home/apt,90,0,0.03,90
11837,Camillia,2,Entire home/apt,145,0,0.07,145
11838,Marina,3,Entire home/apt,125,157,0.16,282
11839,Rebecca,2,Private room,50,0,0.04,50
11840,Aaron,2,Entire home/apt,150,0,0.77,150
11841,Chase,1,Private room,95,0,0.04,95
11842,Danielle,2,Entire home/apt,125,0,0.21,125
11843,Tegan,3,Entire home/apt,120,0,0.02,120
11844,Ys,1,Entire home/apt,400,245,2.82,645
11845,Sean,1,Entire home/apt,201,73,4.46,274
11846,Violette,2,Private room,50,98,1.06,148
11847,Sam,1,Entire home/apt,199,0,0.11,199
11849,Romain,1,Entire home/apt,185,4,0.38,189
11850,Cheryl,2,Private room,85,364,0.19,449
11853,Hannah,2,Private room,60,0,0.07,60
11854,Tny,1,Entire home/apt,132,220,0.13,352
11856,Sethu,2,Entire home/apt,100,0,0.23,100
11860,Guy,2,Entire home/apt,100,0,0.11,100
11861,Fritz,1,Entire home/apt,300,181,0.18,481
11863,Ravi,1,Entire home/apt,300,0,0.07,300
11864,Nelson,3,Private room,39,0,0.21,39
11865,Slavka,1,Entire home/apt,179,189,0.21,368
11866,Gonzalo,3,Shared room,20,0,0.07,20
11867,Egor,1,Entire home/apt,120,0,0.05,120
11869,Elena,1,Entire home/apt,170,289,3.06,459
11870,Carol,1,Entire home/apt,120,278,4.64,398
11871,Andy,2,Private room,75,0,0.96,75
11872,Latane,2,Entire home/apt,110,0,1.15,110
11873,Millie,1,Entire home/apt,177,261,2.81,438
11874,Sworupa,1,Private room,180,175,0.3,355
11875,Vincent,3,Private room,70,364,0.02,434
11876,Anne,1,Entire home/apt,325,0,0.21,325
11877,Nina,1,Private room,165,213,4.37,378
11878,Diana,2,Private room,75,0,0.05,75
11880,Alexandre,1,Entire home/apt,150,0,0.02,150
11883,Wolcott,1,Private room,159,365,0.07,524
11884,Tabitha,2,Entire home/apt,250,0,0.09,250
11885,Chrissy And Scott,2,Entire home/apt,119,0,0.16,119
11887,Helga,2,Entire home/apt,80,0,0.38,80
11889,Katja,1,Entire home/apt,250,20,0.27,270
11890,Mathew,2,Entire home/apt,125,23,2.69,148
11891,Jessica,2,Entire home/apt,150,284,0.76,434
11892,Elene,2,Private room,50,2,1.85,52
11894,Julia,4,Private room,47,353,3.22,400
11895,Kristine,2,Entire home/apt,150,0,0.02,150
11896,Em,1,Entire home/apt,299,91,4.05,390
11899,K,3,Private room,88,14,3.23,102
11902,Fabiola,1,Private room,169,89,0.21,258
11903,Ben,2,Entire home/apt,110,155,2.38,265
11904,Ricardo,2,Private room,60,0,0.02,60
11905,Ben,2,Entire home/apt,110,159,2.76,269
11906,Kate,1,Entire home/apt,78,0,0.08,78
11909,Michael,3,Private room,80,0,0.05,80
11910,Jeff,1,Entire home/apt,150,1,0.27,151
11911,Mario,1,Entire home/apt,199,0,0.02,199
11912,Jorge,1,Entire home/apt,125,0,0.34,125
11913,Jonathan & Nancy,1,Entire home/apt,650,235,3.11,885
11914,Carlos,3,Private room,58,279,1.75,337
11915,Whitney,1,Entire home/apt,200,0,0.05,200
11917,Hanson,2,Entire home/apt,98,6,0.2,104
11918,Onome,2,Private room,40,130,0.57,170
11919,Joey,1,Private room,135,124,2.81,259
11921,Anna,1,Entire home/apt,250,44,0.21,294
11922,Nani,2,Entire home/apt,130,0,0.09,130
11923,Sergey,2,Private room,60,0,1.22,60
11925,Tanya,1,Entire home/apt,465,325,1.22,790
11926,Janice,1,Entire home/apt,126,0,0.07,126
11928,Casey,1,Entire home/apt,139,0,0.44,139
11929,Marine,1,Entire home/apt,200,0,0.2,200
11931,Roberta,1,Entire home/apt,40,0,0.03,40
11933,Carolina,2,Entire home/apt,99,0,0.16,99
11935,Kim  And  Jordan,2,Entire home/apt,185,0,0.07,185
11936,Sabra,1,Private room,60,0,0.18,60
11939,Miss Carolyn,2,Entire home/apt,94,355,0.08,449
11940,Amy,2,Entire home/apt,134,0,0.05,134
11942,Christina,1,Private room,70,233,0.28,303
11943,Rj,1,Entire home/apt,200,0,0.02,200
11944,Olivia,1,Private room,90,0,1.5,90
11945,Jonathan,2,Entire home/apt,115,0,0.02,115
11946,Kevin,1,Entire home/apt,245,0,0.14,245
11947,Ben,1,Entire home/apt,375,134,2.47,509
11948,Ashley,2,Entire home/apt,75,183,3.65,258
11949,Tim,1,Private room,150,0,0.05,150
11952,Jonathan,2,Private room,57,0,0.22,57
11953,Dino,1,Entire home/apt,425,0,0.02,425
11955,Kandisann,1,Private room,65,0,0.25,65
11956,Tomas,2,Private room,65,0,0.03,65
11957,Tomas,2,Private room,75,0,0.13,75
11960,James,1,Entire home/apt,100,0,0.19,100
11961,Magdalena,3,Private room,77,364,0.07,441
11962,Danny,2,Entire home/apt,165,0,0.23,165
11964,Mo,1,Entire home/apt,190,78,2.72,268
11965,Jason,2,Private room,45,0,0.16,45
11966,Janice,2,Entire home/apt,72,251,0.26,323
11967,Tanya,1,Entire home/apt,230,325,1.33,555
11968,Faruk,1,Entire home/apt,250,28,0.76,278
11969,Christina,1,Entire home/apt,140,223,0.02,363
11973,Nika,2,Private room,99,0,0.07,99
11974,Jeff,2,Entire home/apt,140,209,0.72,349
11975,Efrat,2,Entire home/apt,181,188,0.09,369
11976,Autumn,2,Entire home/apt,165,8,3.76,173
11977,Kevin,1,Entire home/apt,175,51,1.86,226
11978,Jacopo,2,Entire home/apt,100,0,0.02,100
11979,David  & Nancy,2,Entire home/apt,209,228,4.47,437
11980,Filip,1,Private room,110,0,0.02,110
11981,Carlos,2,Private room,50,0,0.09,50
11982,Khaleed,1,Entire home/apt,80,0,0.07,80
11983,Marisol,4,Private room,75,354,1.45,429
11984,Olivera,1,Entire home/apt,70,0,0.02,70
11985,Julia,1,Entire home/apt,125,0,0.02,125
11986,Nick,3,Entire home/apt,70,0,0.02,70
11988,Kimberly,2,Private room,100,310,0.19,410
11989,Sarah,2,Entire home/apt,200,0,0.05,200
11990,Sandra,1,Entire home/apt,100,0,0.16,100
11993,Benjamin,3,Entire home/apt,144,288,0.3,432
11995,Rachel,1,Private room,95,0,0.32,95
11996,Rachel,1,Entire home/apt,220,0,0.07,220
11997,Benjamin,1,Private room,209,317,0.22,526
11998,Efrat,2,Private room,118,0,0.16,118
11999,Martina,2,Private room,50,0,1.36,50
12001,XiWei,1,Private room,85,0,0.02,85
12002,Peter,1,Entire home/apt,200,0,0.12,200
12003,Scott,2,Entire home/apt,161,2,0.48,163
12004,Chris,2,Entire home/apt,110,0,0.56,110
12006,Ofer,1,Entire home/apt,104,156,0.13,260
12007,Ian,2,Entire home/apt,200,0,0.02,200
12008,Erin,2,Private room,99,0,0.12,99
12009,Taylor,2,Entire home/apt,80,0,0.28,80
12010,Sandy,1,Entire home/apt,400,0,0.08,400
12011,Madeline,2,Entire home/apt,98,0,0.07,98
12012,Soria,2,Private room,63,0,0.05,63
12013,Yemi,2,Private room,69,249,1.73,318
12014,Alexander,3,Entire home/apt,89,36,0.45,125
12015,Despina,3,Entire home/apt,99,0,0.09,99
12016,Vikram,1,Entire home/apt,140,0,0.05,140
12017,Richelle And Pela,2,Entire home/apt,150,274,1.78,424
12018,Elyssa,2,Entire home/apt,199,73,1.4,272
12021,Dor,1,Entire home/apt,300,0,0.58,300
12022,Nathan,2,Private room,40,0,0.07,40
12023,Charis,2,Private room,100,0,0.5,100
12024,Ayanna,2,Entire home/apt,170,236,2.9,406
12025,Ben,1,Entire home/apt,120,0,0.14,120
12026,Liubov,2,Private room,60,313,3.26,373
12027,Mo,1,Entire home/apt,90,269,0.16,359
12028,Kyron,1,Private room,60,0,0.02,60
12031,Clark,1,Entire home/apt,170,0,0.31,170
12035,George,2,Entire home/apt,139,0,0.7,139
12036,Alex,1,Entire home/apt,250,0,0.23,250
12037,Chanel,1,Entire home/apt,150,0,0.02,150
12038,Stephanie,2,Private room,90,0,0.32,90
12039,Mona,1,Private room,55,8,0.33,63
12040,Marc,1,Entire home/apt,296,0,1.69,296
12041,Ava,1,Entire home/apt,150,89,1.41,239
12042,Katherine,4,Entire home/apt,139,357,0.69,496
12045,Jenny,1,Entire home/apt,205,0,0.05,205
12046,Talia,2,Entire home/apt,90,0,0.07,90
12047,Alex,2,Shared room,25,365,0.12,390
12048,Yvonne,3,Entire home/apt,65,67,0.72,132
12049,Juliana,1,Entire home/apt,250,0,0.02,250
12050,Geert,2,Entire home/apt,140,339,0.31,479
12051,Vanessa K,1,Entire home/apt,110,0,0.09,110
12053,Tida,1,Entire home/apt,120,307,1.82,427
12055,Campbell,1,Private room,110,188,0.06,298
12056,Aston,3,Entire home/apt,200,365,1.66,565
12057,Manny,2,Private room,60,0,0.03,60
12058,Connor,1,Entire home/apt,205,0,0.02,205
12059,Chris,2,Private room,50,0,0.11,50
12060,Anhad,1,Entire home/apt,183,0,0.02,183
12062,Sarah,2,Private room,70,54,1.1,124
12063,Jessica,2,Entire home/apt,90,0,0.16,90
12064,Akash,2,Entire home/apt,375,364,0.52,739
12065,Lincoln,2,Private room,50,10,0.14,60
12066,Mike,1,Private room,199,230,1.11,429
12068,Zachary Robert,1,Entire home/apt,285,365,0.12,650
12069,Amaya,2,Private room,72,113,2.34,185
12070,Rachel,2,Private room,36,15,0.49,51
12071,Tom & Nic,2,Private room,84,263,1.11,347
12072,Anne,1,Private room,100,0,0.02,100
12073,Rhonda,2,Private room,130,262,0.41,392
12074,Austin,1,Entire home/apt,285,0,0.02,285
12076,Elisabeth,1,Entire home/apt,465,62,1.67,527
12077,Eli,1,Entire home/apt,175,0,0.14,175
12078,Eka,2,Entire home/apt,165,212,4.7,377
12079,Jeremy & Laura,1,Entire home/apt,156,252,0.1,408
12081,Lucy,2,Entire home/apt,160,0,0.03,160
12083,Katherine,1,Entire home/apt,200,74,1.2,274
12084,Bjorn,2,Entire home/apt,260,0,0.11,260
12087,Alexandra,1,Entire home/apt,100,0,0.05,100
12089,Michael,1,Private room,120,177,2.83,297
12091,Maria,4,Private room,65,356,0.05,421
12092,Antonia,1,Private room,100,0,3.46,100
12093,Moira,2,Entire home/apt,127,0,0.16,127
12094,Nan,3,Private room,49,311,0.48,360
12095,Mahesh,1,Private room,108,0,0.25,108
12097,Montana,1,Entire home/apt,180,0,0.02,180
12098,Eva,2,Private room,34,7,0.77,41
12100,Jt,1,Entire home/apt,250,365,0.05,615
12101,Adam,2,Entire home/apt,100,78,0.25,178
12103,Jeremy & Laura,1,Entire home/apt,175,280,0.18,455
12104,Ashley,1,Entire home/apt,190,0,0.23,190
12105,Spyridon,2,Entire home/apt,90,0,0.17,90
12106,Leo,1,Entire home/apt,160,215,3.29,375
12107,Andrew,1,Private room,51,0,0.02,51
12108,Thomas,1,Entire home/apt,150,0,0.02,150
12109,Mathieu,2,Entire home/apt,325,103,0.42,428
12110,William,2,Entire home/apt,99,42,0.23,141
12112,Brenda,2,Entire home/apt,280,363,0.3,643
12113,Olga,1,Entire home/apt,110,229,3.78,339
12115,Violet,2,Entire home/apt,125,126,2.92,251
12116,Alex,1,Entire home/apt,275,85,1.9,360
12117,Leslie,2,Entire home/apt,308,109,0.55,417
12118,Karoline,2,Entire home/apt,200,0,0.07,200
12119,Mama,1,Private room,60,48,3.07,108
12120,Fer,1,Private room,65,0,0.05,65
12122,Marisol,4,Entire home/apt,189,354,0.22,543
12123,Yuhao,1,Private room,60,0,0.03,60
12125,Erik,2,Private room,65,0,0.02,65
12126,Melanie,2,Entire home/apt,128,0,0.84,128
12127,Jenny,2,Entire home/apt,200,0,0.45,200
12129,Kelly,2,Private room,75,296,1.52,371
12130,Shannon,1,Entire home/apt,69,0,0.02,69
12131,Fabiana,1,Entire home/apt,120,0,0.07,120
12132,Sierra,1,Private room,95,0,0.02,95
12133,Wesley,2,Entire home/apt,142,0,0.44,142
12135,M&L,3,Private room,155,90,0.33,245
12136,Kristina,1,Entire home/apt,300,0,0.08,300
12137,Alex & Alena,2,Private room,70,92,1.05,162
12138,Fred,1,Entire home/apt,180,22,3.58,202
12139,Marcella,1,Private room,70,0,0.4,70
12140,Cindy,1,Private room,95,0,0.03,95
12141,Leecia,2,Entire home/apt,100,224,1.9,324
12142,Yuna,2,Entire home/apt,129,72,2.02,201
12144,Kalyani,1,Private room,40,0,0.05,40
12145,Adrian,2,Private room,90,6,0.48,96
12146,Rindon,2,Private room,42,0,0.03,42
12149,Nissim,1,Entire home/apt,70,365,0.13,435
12150,Brad,2,Entire home/apt,108,0,0.09,108
12151,Ann,3,Entire home/apt,500,243,0.85,743
12153,Whitney,1,Entire home/apt,275,0,0.09,275
12155,Sonia,2,Entire home/apt,289,92,2.89,381
12156,Stan,2,Private room,130,288,2.48,418
12157,Luiz & Daniel,1,Private room,55,1,2.87,56
12159,Justin,1,Entire home/apt,130,27,2.2,157
12160,Beth,2,Private room,60,107,1.45,167
12161,Lindsay,2,Entire home/apt,99,363,3.2,462
12162,Sharif,2,Private room,50,0,0.27,50
12164,Hasan,1,Entire home/apt,150,0,0.02,150
12165,MaElena,1,Private room,90,320,1.73,410
12166,Mariana,2,Entire home/apt,275,6,1.89,281
12167,Nissim,1,Entire home/apt,70,339,0.07,409
12169,Al,1,Entire home/apt,185,216,4.16,401
12171,Michaela,2,Private room,69,0,0.8,69
12172,Aaron,2,Entire home/apt,330,327,2.03,657
12175,Tolley,1,Private room,150,0,0.05,150
12176,Nissim,1,Entire home/apt,80,357,0.24,437
12177,Nissim,1,Entire home/apt,80,365,0.12,445
12178,Jocelyn,1,Entire home/apt,310,57,2.88,367
12179,Nissim,1,Entire home/apt,70,341,0.12,411
12180,Jeff,1,Entire home/apt,325,0,0.05,325
12181,Esin,3,Private room,65,167,0.58,232
12182,Margarita,2,Entire home/apt,155,0,2.89,155
12183,Ana,2,Private room,45,0,0.05,45
12184,Dan,1,Entire home/apt,125,129,3.69,254
12185,Emmanuelle,2,Private room,49,30,4.9,79
12187,Caroline,2,Private room,80,0,0.09,80
12188,Ben,1,Entire home/apt,145,200,3.43,345
12189,Edward,3,Entire home/apt,125,330,0.87,455
12190,Lily,3,Private room,60,80,2.22,140
12191,Robin Laverne,2,Private room,50,25,1.59,75
12193,Luigi,2,Entire home/apt,531,353,2.71,884
12194,Michael,1,Entire home/apt,199,318,1.91,517
12195,Emel,1,Entire home/apt,214,219,3.58,433
12197,Veronica,2,Entire home/apt,105,0,0.03,105
12198,Iradj,1,Entire home/apt,240,262,1.68,502
12199,John,3,Entire home/apt,114,350,1.69,464
12200,Lorien,1,Private room,45,0,0.02,45
12203,Monika,2,Entire home/apt,145,157,0.43,302
12205,Jennifer,2,Private room,75,352,0.33,427
12206,Ronnie,1,Private room,225,322,1.44,547
12207,Quentin,1,Entire home/apt,150,0,1.21,150
12208,Sam,2,Entire home/apt,150,0,0.02,150
12209,Dimitrios,1,Entire home/apt,182,32,0.17,214
12211,Damian,2,Private room,65,0,0.07,65
12212,Naomi,1,Entire home/apt,175,0,0.35,175
12213,Ruth,2,Entire home/apt,525,159,0.28,684
12214,Philipp,1,Private room,98,0,0.02,98
12215,Lily,1,Private room,61,16,0.47,77
12216,Kristina,1,Entire home/apt,159,141,0.48,300
12218,Masha,2,Entire home/apt,69,226,0.27,295
12220,Yuna,2,Entire home/apt,115,71,3.0,186
12221,Robert,1,Private room,85,21,2.32,106
12222,Joe,1,Entire home/apt,209,168,2.63,377
12223,Jack,1,Entire home/apt,225,0,0.02,225
12224,Olai,1,Entire home/apt,100,0,0.02,100
12225,Charles,2,Private room,55,0,0.02,55
12226,Sarah,2,Private room,80,0,0.27,80
12227,Isabelle,2,Private room,80,0,0.02,80
12228,Nicholas,2,Entire home/apt,85,216,0.21,301
12230,Manne,2,Entire home/apt,125,116,4.09,241
12232,Kevin,1,Entire home/apt,175,0,0.02,175
12234,Kin,1,Entire home/apt,180,6,4.77,186
12236,Hebert,3,Private room,60,0,1.13,60
12237,Julien,2,Entire home/apt,200,0,0.05,200
12238,Izi,1,Entire home/apt,295,332,0.06,627
12239,Raphael,1,Private room,40,0,0.02,40
12240,Michelle,1,Entire home/apt,150,0,0.89,150
12241,Sarah,1,Private room,40,0,0.02,40
12242,Jennifer,1,Entire home/apt,180,0,0.02,180
12243,Kyriaki,1,Entire home/apt,145,249,2.48,394
12244,Lili And Antoine,2,Entire home/apt,175,0,0.25,175
12245,Abby,1,Entire home/apt,275,0,0.11,275
12246,María Cristina,3,Entire home/apt,115,0,0.18,115
12247,Bella,1,Entire home/apt,175,0,0.08,175
12249,Michael,1,Entire home/apt,345,206,0.37,551
12250,Sarah,1,Entire home/apt,150,0,0.07,150
12251,Brian,1,Private room,75,0,0.05,75
12252,Paulo,1,Entire home/apt,219,329,3.04,548
12254,Dmitriy,1,Entire home/apt,225,360,1.78,585
12255,Janelle,1,Entire home/apt,275,248,2.51,523
12256,Carine,1,Entire home/apt,350,283,1.06,633
12258,Nina,2,Private room,60,0,0.07,60
12260,Robyn,2,Entire home/apt,119,85,0.87,204
12261,Alo,1,Entire home/apt,175,0,0.05,175
12262,Mrs .D,2,Entire home/apt,335,304,0.53,639
12263,Charlie,2,Private room,70,0,0.05,70
12265,Marie-Louise,1,Entire home/apt,299,282,2.62,581
12266,Grace,1,Entire home/apt,99,127,0.3,226
12269,Stephen Dayo,2,Entire home/apt,150,19,1.38,169
12270,G,1,Private room,655,0,0.02,655
12271,Karla,1,Private room,99,0,0.12,99
12274,Aaron,1,Entire home/apt,190,281,2.33,471
12277,Jake,2,Private room,41,0,0.02,41
12278,Michelle,1,Entire home/apt,325,358,0.12,683
12280,Trevor,1,Entire home/apt,95,0,0.05,95
12282,Netanya,1,Entire home/apt,160,0,0.05,160
12284,Michael,1,Entire home/apt,400,78,0.35,478
12285,Solange,2,Private room,46,0,0.05,46
12286,Scott,1,Entire home/apt,132,0,0.02,132
12290,Amal & Alex,1,Entire home/apt,165,281,0.97,446
12293,Sol,2,Private room,80,0,0.25,80
12294,Dimitri,1,Entire home/apt,150,0,0.02,150
12295,Shanika,2,Private room,62,0,0.11,62
12296,Fernanda,2,Entire home/apt,68,0,0.03,68
12297,Ana,1,Entire home/apt,300,82,0.16,382
12298,Julie,3,Entire home/apt,149,0,0.14,149
12299,Ira,1,Entire home/apt,200,0,0.19,200
12300,James,2,Entire home/apt,275,0,0.05,275
12303,Kalana,2,Entire home/apt,150,165,2.74,315
12304,Chelsea,1,Entire home/apt,166,0,1.24,166
12305,Danielle,2,Entire home/apt,79,0,0.09,79
12306,Quentin,1,Entire home/apt,220,251,1.15,471
12307,Yone,3,Private room,70,128,0.75,198
12308,Roberto,2,Private room,60,188,0.14,248
12309,Tairan,1,Private room,80,0,0.02,80
12310,Golden&Mavy,1,Private room,50,359,0.23,409
12312,威,1,Private room,50,0,0.02,50
12313,Aleksandra,1,Entire home/apt,185,0,0.05,185
12316,Gloria,4,Private room,85,364,0.25,449
12317,Elise,1,Entire home/apt,300,263,0.12,563
12318,Raquel,1,Entire home/apt,199,164,0.84,363
12320,Sunim,2,Private room,50,0,0.05,50
12325,Amber,2,Entire home/apt,200,0,0.35,200
12326,Al,2,Entire home/apt,149,151,1.99,300
12328,Hayley Lynn,1,Entire home/apt,150,0,0.07,150
12329,Damian,1,Entire home/apt,1200,290,0.16,1490
12332,Maxime,1,Entire home/apt,200,0,0.07,200
12333,Camila,2,Entire home/apt,140,345,1.08,485
12334,Sabrina,2,Entire home/apt,110,0,0.11,110
12335,Yujie,1,Private room,80,0,0.05,80
12336,Kristin,1,Private room,60,0,0.14,60
12337,Nate,1,Entire home/apt,126,0,0.18,126
12338,Matthew,1,Private room,55,0,0.05,55
12339,Benjamin,1,Entire home/apt,325,0,0.05,325
12340,Kat,2,Entire home/apt,140,126,1.83,266
12341,Christina,2,Private room,50,0,0.68,50
12342,Amy,1,Private room,9999,83,0.14,10082
12343,Michou,2,Entire home/apt,186,249,2.52,435
12344,Adam,2,Entire home/apt,245,128,0.46,373
12345,Jp,1,Private room,150,178,0.9,328
12346,Mama,1,Private room,99,158,1.83,257
12348,Cory,1,Private room,43,0,1.61,43
12349,Mama,1,Private room,85,141,3.55,226
12350,Mama,1,Private room,95,166,3.87,261
12351,Jeremy & Laura,1,Entire home/apt,180,280,0.02,460
12352,Pierre,1,Private room,100,330,0.25,430
12355,Warren,2,Entire home/apt,130,0,0.04,130
12358,Sandy,2,Entire home/apt,100,0,0.13,100
12360,Laiona,1,Entire home/apt,85,27,0.65,112
12361,Kat And Chris,2,Entire home/apt,160,254,1.06,414
12364,Ben,2,Entire home/apt,63,0,0.05,63
12365,Nick,2,Entire home/apt,60,0,0.03,60
12366,Bridget,1,Private room,95,0,0.03,95
12367,Cinthia,1,Private room,50,315,2.19,365
12368,Mike,2,Private room,59,0,0.05,59
12370,Sonja,1,Entire home/apt,83,0,0.73,83
12371,Sotira,2,Entire home/apt,80,269,0.1,349
12372,Elizabeth,1,Entire home/apt,200,19,1.14,219
12373,Iradj,1,Entire home/apt,265,278,2.01,543
12375,Abraham,2,Private room,36,0,2.28,36
12376,Isabelle,2,Private room,78,0,0.02,78
12377,Chris,1,Private room,80,0,0.02,80
12378,Jason,2,Entire home/apt,218,171,2.46,389
12380,Tny,1,Entire home/apt,130,13,0.41,143
12381,Tny,1,Entire home/apt,130,28,0.3,158
12382,Vince,2,Private room,51,0,0.02,51
12383,Una,2,Private room,45,281,0.05,326
12385,Sean,1,Entire home/apt,350,0,0.05,350
12386,Lauren,1,Entire home/apt,265,0,0.03,265
12387,Jonatan,1,Entire home/apt,228,0,0.41,228
12388,Noah,1,Private room,90,0,0.05,90
12389,Lily,3,Private room,60,81,1.68,141
12390,Lakan,2,Entire home/apt,120,0,0.03,120
12391,Yi-Chen,1,Private room,65,0,0.02,65
12392,Katie,2,Private room,90,290,0.09,380
12393,Onur,1,Entire home/apt,225,160,0.7,385
12394,Tina,3,Entire home/apt,103,245,3.2,348
12395,Ken,1,Entire home/apt,500,0,0.22,500
12396,Spencer,2,Private room,62,4,0.51,66
12397,Henry,2,Private room,45,0,0.02,45
12398,Helen,1,Entire home/apt,300,0,0.02,300
12399,Rand,1,Entire home/apt,299,297,4.02,596
12400,Joel,1,Private room,85,0,0.03,85
12402,Alisa,1,Private room,250,0,0.02,250
12404,Jim,2,Entire home/apt,220,0,0.23,220
12405,Abhilasha Ashiv,3,Entire home/apt,109,357,2.49,466
12406,Alex,1,Entire home/apt,300,118,1.36,418
12407,Ohad,1,Entire home/apt,300,0,0.09,300
12409,Jaclyn,1,Entire home/apt,289,253,4.13,542
12410,Steve,3,Private room,37,228,0.98,265
12411,Sandy,2,Private room,50,244,1.33,294
12412,Danielle,2,Private room,75,355,0.49,430
12413,Gordon M,1,Private room,44,45,0.28,89
12414,Bianca,2,Private room,45,0,0.02,45
12416,Weijia,1,Entire home/apt,110,0,0.02,110
12417,Eric,2,Entire home/apt,195,54,0.94,249
12418,Timur,1,Shared room,100,365,0.41,465
12419,Eduardo,2,Entire home/apt,200,216,0.08,416
12420,Grace,2,Entire home/apt,160,8,0.9,168
12421,Amanda,2,Entire home/apt,115,0,1.03,115
12422,Zhenya,2,Private room,55,21,0.24,76
12425,Stephan,2,Entire home/apt,130,8,0.14,138
12426,Karina,1,Private room,100,0,0.39,100
12428,Max,2,Private room,49,0,0.02,49
12429,Caroline,2,Private room,49,288,2.89,337
12430,Vitaliy,1,Entire home/apt,245,226,1.61,471
12431,Florence,1,Entire home/apt,250,224,1.32,474
12432,Claudia,3,Private room,55,280,0.75,335
12433,J.J.,1,Entire home/apt,225,250,4.24,475
12434,Eli,1,Private room,68,0,0.02,68
12435,Crystal,1,Entire home/apt,220,81,1.9,301
12436,Tal,2,Private room,75,96,2.82,171
12437,Ding,1,Entire home/apt,120,0,0.05,120
12438,Ute,2,Entire home/apt,129,275,2.73,404
12439,Rom,1,Entire home/apt,199,0,0.26,199
12440,Alex,1,Private room,92,0,2.74,92
12442,Misha,1,Entire home/apt,179,8,0.63,187
12444,Nickie,1,Private room,80,0,0.05,80
12445,Annie,1,Entire home/apt,100,0,0.12,100
12447,Shane,2,Private room,60,0,0.05,60
12448,Jim,1,Entire home/apt,166,3,0.39,169
12451,Kaitlyn,1,Entire home/apt,115,0,0.02,115
12453,Wipawe,2,Private room,55,0,0.14,55
12454,Babak,2,Private room,76,0,0.09,76
12455,Kevin,1,Entire home/apt,140,0,0.02,140
12456,Christian,1,Entire home/apt,150,58,3.52,208
12458,Karen,1,Entire home/apt,450,3,0.28,453
12459,Chrystelle,2,Entire home/apt,105,285,0.21,390
12461,Kate,2,Entire home/apt,110,0,0.44,110
12463,Jeanne,1,Entire home/apt,450,0,0.05,450
12464,Alex And Tom,1,Entire home/apt,150,198,6.57,348
12467,Manon,2,Entire home/apt,80,0,0.02,80
12468,Andrew,1,Entire home/apt,260,0,0.02,260
12469,Rob,1,Entire home/apt,85,0,0.55,85
12470,Katherine,1,Private room,199,232,2.14,431
12471,Tiffany,2,Entire home/apt,135,15,0.56,150
12472,Kujtim,3,Entire home/apt,100,107,0.63,207
12473,Katherine,1,Private room,99,252,0.11,351
12474,Fabiola,4,Private room,34,313,0.4,347
12475,Cindy & Jeremy,3,Entire home/apt,89,331,1.26,420
12476,Olivia,2,Private room,77,216,2.74,293
12478,Neev,2,Entire home/apt,190,159,1.54,349
12479,Emilie,2,Entire home/apt,115,1,0.27,116
12480,Paris,2,Private room,40,87,0.12,127
12482,Marguerite,1,Entire home/apt,135,0,0.02,135
12484,Eman,1,Entire home/apt,99,0,0.16,99
12485,Karoliina,1,Entire home/apt,145,0,1.4,145
12486,C,1,Entire home/apt,349,0,0.13,349
12487,Will & Tash,1,Private room,75,0,0.09,75
12488,Anne-Laure,2,Entire home/apt,200,6,0.58,206
12489,Sarah,1,Private room,119,0,0.02,119
12490,Samantha,1,Private room,65,0,0.21,65
12491,Adam,1,Private room,50,5,0.05,55
12492,Harrison,1,Entire home/apt,199,0,0.38,199
12493,Henriette,1,Private room,80,0,0.02,80
12494,Aanchal,1,Private room,55,0,0.09,55
12496,Jessica,2,Entire home/apt,125,0,0.12,125
12497,Adam,1,Entire home/apt,235,27,2.98,262
12498,Houston,2,Entire home/apt,110,0,0.03,110
12499,George,1,Entire home/apt,120,244,0.7,364
12500,Jacqueline,1,Entire home/apt,195,0,0.02,195
12501,Lugao,1,Private room,109,197,2.58,306
12503,Alisha,2,Private room,55,0,0.05,55
12504,Lumduan,1,Entire home/apt,150,299,1.79,449
12505,Archie,2,Entire home/apt,100,0,0.09,100
12507,Dan,2,Entire home/apt,155,225,3.14,380
12509,Vanessa,1,Private room,60,0,0.23,60
12510,Elva,3,Entire home/apt,85,0,0.03,85
12512,Peggy,1,Private room,70,0,0.14,70
12513,Brett,2,Private room,50,66,0.02,116
12514,Andrea,1,Entire home/apt,120,0,0.04,120
12515,Juan Luis,1,Private room,75,0,0.02,75
12516,Ornella,2,Private room,31,0,0.02,31
12517,Yemi,2,Private room,79,253,1.6,332
12518,Ruth,1,Entire home/apt,160,363,0.05,523
12519,Danielle,2,Entire home/apt,99,357,2.5,456
12520,Leandro,1,Entire home/apt,199,177,0.12,376
12521,Amal,1,Entire home/apt,260,296,0.94,556
12524,Lina,2,Private room,65,0,0.02,65
12526,Kilandra,1,Private room,60,0,0.19,60
12527,Simone,2,Private room,45,19,0.05,64
12528,Eric,2,Private room,60,189,0.79,249
12529,Ryan,1,Entire home/apt,107,72,0.44,179
12530,Jeremy & Laura,1,Entire home/apt,230,281,0.12,511
12533,Vera,3,Entire home/apt,130,331,0.89,461
12534,Austin,1,Shared room,85,0,0.05,85
12535,Amy,2,Entire home/apt,80,0,0.42,80
12536,Harrison,1,Private room,84,0,0.07,84
12537,Iris,2,Private room,63,0,0.35,63
12538,Rebecca,2,Private room,45,0,0.02,45
12539,Robert,2,Entire home/apt,125,155,4.01,280
12540,Angela,2,Private room,160,0,0.12,160
12541,Ella,2,Private room,63,48,0.51,111
12542,Brian,1,Private room,125,335,2.23,460
12543,Arno,2,Private room,45,0,0.02,45
12544,Nour,2,Private room,115,0,0.07,115
12545,Alexandra,1,Entire home/apt,269,110,3.31,379
12546,Kyra,2,Private room,55,0,0.12,55
12548,Beto,3,Entire home/apt,100,15,0.31,115
12552,Imad,2,Private room,59,365,0.05,424
12553,Ayanna,2,Entire home/apt,173,228,4.18,401
12555,Sophia,2,Private room,115,179,0.56,294
12556,Chelsea,1,Entire home/apt,89,0,0.02,89
12557,Kristina,2,Private room,70,0,0.14,70
12558,Lauren + Reggie,3,Private room,89,39,1.33,128
12559,Maryann,3,Private room,60,179,3.75,239
12561,Ashley,1,Entire home/apt,400,0,0.05,400
12562,Natasha,2,Entire home/apt,90,0,0.19,90
12563,Derrick,1,Entire home/apt,200,188,0.19,388
12564,Erin,2,Private room,65,0,0.06,65
12565,Petya,3,Private room,43,310,0.08,353
12566,Oliver,2,Private room,55,0,0.14,55
12568,Mariella,1,Private room,110,264,3.07,374
12570,Joao,1,Entire home/apt,145,0,0.07,145
12571,Enzo,1,Entire home/apt,550,302,3.29,852
12572,Raul,3,Private room,59,208,3.59,267
12573,Raul,3,Entire home/apt,239,274,0.19,513
12574,Raul,3,Private room,49,89,0.32,138
12577,Petrona,2,Entire home/apt,90,82,4.89,172
12578,Mia,2,Private room,80,0,0.41,80
12579,Gene,2,Entire home/apt,125,226,0.98,351
12580,Felicia,2,Private room,65,0,0.03,65
12581,David,1,Entire home/apt,77,0,1.56,77
12582,Halona,2,Entire home/apt,220,8,0.61,228
12583,Jonathan,2,Entire home/apt,150,0,0.16,150
12584,Sofia,2,Private room,200,0,0.19,200
12585,Michael,1,Entire home/apt,200,0,0.12,200
12587,Sofia,2,Private room,90,0,0.65,90
12588,Josh And Amanda,2,Entire home/apt,230,0,0.02,230
12589,William,2,Private room,55,0,0.02,55
12590,Alex,1,Private room,160,0,0.02,160
12591,Emmanuel,2,Private room,46,0,0.26,46
12593,Anne,1,Entire home/apt,300,0,0.3,300
12594,Becky,1,Private room,100,0,0.03,100
12595,Cillian,2,Private room,95,0,0.03,95
12599,Emily,3,Private room,68,0,0.14,68
12601,Masa,1,Entire home/apt,112,0,0.3,112
12602,Frahydel,1,Private room,85,0,0.9,85
12606,Raj,2,Private room,55,304,1.09,359
12607,Wayne And Yesim,1,Private room,85,188,0.16,273
12608,Joann,2,Entire home/apt,160,291,1.2,451
12609,Thomas,1,Entire home/apt,155,0,0.14,155
12610,Padraic,2,Entire home/apt,70,0,0.33,70
12611,Carina,2,Entire home/apt,185,0,0.02,185
12613,Tripp,1,Private room,200,0,0.02,200
12615,Jenn,1,Private room,70,0,0.05,70
12616,Abby,1,Private room,50,0,0.05,50
12617,Luis,3,Entire home/apt,85,0,0.05,85
12620,David,3,Private room,45,0,0.12,45
12621,Mike,2,Entire home/apt,109,0,0.09,109
12622,Alex,5,Private room,48,316,2.6,364
12623,Eva,1,Entire home/apt,150,0,0.09,150
12624,Anika,2,Entire home/apt,350,130,0.27,480
12625,Magdalena,1,Entire home/apt,100,0,0.02,100
12626,D,1,Entire home/apt,177,258,3.12,435
12627,Qiyao,1,Entire home/apt,108,0,2.57,108
12628,Ali,2,Private room,28,0,0.02,28
12630,Asijah,3,Private room,35,0,0.05,35
12631,Andrew,3,Entire home/apt,105,0,0.05,105
12632,Shabari,2,Private room,95,0,0.06,95
12633,Gordon M,1,Private room,62,97,0.55,159
12635,Stephen,1,Entire home/apt,150,0,0.05,150
12636,Stephanie,2,Entire home/apt,113,355,0.94,468
12637,Kerry,2,Entire home/apt,300,0,0.56,300
12638,Veleda And Orion,2,Entire home/apt,65,0,0.09,65
12639,Liam,2,Private room,55,0,0.12,55
12641,Viviana,2,Entire home/apt,120,180,3.6,300
12642,Erin,1,Entire home/apt,160,0,0.05,160
12643,Will,1,Private room,135,339,0.23,474
12644,Lin,2,Entire home/apt,175,37,0.36,212
12645,Miriam,2,Entire home/apt,300,297,2.06,597
12646,Daniela,2,Private room,80,0,0.05,80
12648,Jeremy & Laura,1,Entire home/apt,170,332,0.04,502
12649,Elena,1,Entire home/apt,85,0,0.03,85
12651,Matthew,2,Entire home/apt,84,0,0.05,84
12652,Michael,2,Entire home/apt,399,237,3.2,636
12654,Jessica,1,Entire home/apt,140,270,2.46,410
12655,Amadou,2,Entire home/apt,210,247,2.66,457
12657,Michael,2,Entire home/apt,200,0,0.42,200
12658,Cedrick,1,Entire home/apt,200,0,3.47,200
12659,Christian,2,Private room,47,0,0.05,47
12660,Bailey,2,Entire home/apt,50,0,0.03,50
12661,Alejandro,2,Private room,95,342,0.21,437
12662,Ali,1,Entire home/apt,280,0,0.14,280
12663,Richard,2,Private room,50,0,0.13,50
12664,John,1,Private room,200,365,0.83,565
12665,Anna,1,Private room,197,0,0.46,197
12666,Joy & Jesse,2,Entire home/apt,120,0,0.12,120
12671,Ada,1,Entire home/apt,150,0,0.02,150
12672,Nora,2,Shared room,35,352,2.45,387
12673,Justin,1,Entire home/apt,195,34,0.43,229
12676,Troy,1,Private room,125,226,3.29,351
12677,Troy,1,Private room,100,248,2.0,348
12679,Claudia,2,Entire home/apt,125,155,3.54,280
12680,Benjamin,2,Entire home/apt,123,246,0.27,369
12681,Liliana,2,Entire home/apt,95,59,0.12,154
12682,Adrienne,1,Entire home/apt,199,0,0.02,199
12684,Meaghan,2,Private room,45,0,0.02,45
12685,Anna,1,Entire home/apt,189,0,0.09,189
12686,Stephanie,2,Private room,50,0,0.02,50
12688,Paula,2,Entire home/apt,250,365,0.32,615
12689,Cyrille,2,Entire home/apt,95,251,1.72,346
12690,Kim,1,Private room,140,0,0.12,140
12692,Saadia,1,Entire home/apt,120,247,0.81,367
12693,John,2,Private room,35,0,0.05,35
12694,Meredith,1,Entire home/apt,195,0,0.68,195
12695,Gabriel,2,Private room,35,0,0.02,35
12696,Joshua,1,Entire home/apt,250,0,0.02,250
12697,Rodin,2,Private room,70,0,0.05,70
12699,Nicolo,2,Entire home/apt,159,0,0.1,159
12700,Ashley,1,Entire home/apt,149,0,0.33,149
12701,Maky,1,Entire home/apt,180,328,2.98,508
12702,"Manny , Job",1,Entire home/apt,110,250,4.58,360
12703,Matt & Virginia,3,Entire home/apt,100,0,0.05,100
12704,Gaia,2,Private room,50,0,0.26,50
12705,Lindsee And Peter,1,Entire home/apt,425,54,0.64,479
12707,Thales,1,Entire home/apt,260,34,0.35,294
12708,Alex,1,Entire home/apt,499,0,0.09,499
12710,Joakim,1,Entire home/apt,250,16,0.08,266
12711,Beatriz,2,Entire home/apt,350,0,0.12,350
12712,Andrew,1,Entire home/apt,275,0,0.08,275
12714,Alex G,1,Entire home/apt,300,261,6.12,561
12715,Ellen,2,Private room,75,365,0.12,440
12718,Maria,2,Entire home/apt,146,200,4.8,346
12719,Sonia,1,Private room,89,0,0.44,89
12720,Ijeoma,1,Entire home/apt,75,0,0.44,75
12722,Jack,1,Private room,75,0,0.02,75
12723,Megan,1,Entire home/apt,102,18,0.52,120
12725,Gilad,1,Entire home/apt,190,237,2.74,427
12727,Fernando,2,Private room,70,0,0.02,70
12728,Lorraine,2,Private room,63,60,2.77,123
12729,Julian,2,Entire home/apt,100,0,0.02,100
12730,Kristy,1,Private room,130,76,1.52,206
12733,Haydee,2,Entire home/apt,90,364,1.84,454
12734,Zoey,2,Private room,46,0,0.42,46
12736,Bobby,2,Entire home/apt,115,89,3.38,204
12737,Pedro,1,Private room,90,239,2.4,329
12739,Ilya,2,Entire home/apt,250,0,0.19,250
12740,Andrew,1,Entire home/apt,1000,326,0.23,1326
12741,Will,2,Entire home/apt,159,0,0.1,159
12742,Apollo,1,Private room,99,333,0.56,432
12743,Rajesh,3,Entire home/apt,100,0,0.09,100
12744,Lola,1,Entire home/apt,250,35,0.32,285
12745,Luke,2,Entire home/apt,120,0,0.12,120
12746,Danielle,1,Private room,80,0,0.02,80
12748,Yingyuan,1,Private room,45,0,0.02,45
12750,Jessica,1,Private room,65,0,0.05,65
12754,Seyi,1,Private room,50,0,0.05,50
12755,Crystal,1,Private room,100,0,0.03,100
12756,Anne,1,Entire home/apt,200,0,0.03,200
12758,Iris,3,Private room,65,320,0.18,385
12759,Angie,2,Entire home/apt,130,321,1.2,451
12761,John,2,Entire home/apt,250,319,0.34,569
12763,Carola,2,Entire home/apt,100,0,0.14,100
12764,Sarah,1,Entire home/apt,90,0,0.08,90
12765,Marilee & Gene,3,Private room,90,180,1.26,270
12766,Robyn,2,Private room,31,0,0.05,31
12767,Lorraine,1,Private room,45,0,0.05,45
12769,Nichole,2,Private room,39,278,0.17,317
12770,Nichole,2,Private room,39,346,0.3,385
12771,Albert,2,Private room,85,0,0.02,85
12772,Lea,2,Private room,40,0,0.06,40
12774,Joe,2,Entire home/apt,200,0,0.02,200
12776,Cathy,2,Entire home/apt,130,252,1.57,382
12777,Alex,5,Private room,40,324,3.67,364
12779,Blake,1,Entire home/apt,129,0,0.14,129
12782,Hattie,2,Entire home/apt,100,0,0.16,100
12783,Jorge,2,Entire home/apt,100,0,0.05,100
12784,Benjamin,2,Private room,24,0,0.02,24
12785,Carlo Fabricio,2,Entire home/apt,160,342,1.63,502
12786,Elana,2,Entire home/apt,125,0,0.31,125
12787,Michelle,2,Entire home/apt,205,0,0.19,205
12788,John,1,Entire home/apt,750,47,2.22,797
12789,Aliza,2,Private room,75,189,0.5,264
12790,Jeremy & Laura,1,Entire home/apt,150,282,0.04,432
12791,Jc,1,Entire home/apt,195,280,1.19,475
12792,Bradley,2,Private room,477,358,0.03,835
12793,Jeremy & Laura,1,Entire home/apt,275,332,0.02,607
12796,Brandy,2,Private room,60,0,0.02,60
12797,Anu -Nicole,2,Entire home/apt,128,256,0.31,384
12798,Michelle,1,Entire home/apt,140,0,0.16,140
12799,Alex,2,Entire home/apt,98,0,0.12,98
12801,Alfred,2,Entire home/apt,800,178,0.76,978
12802,Cloe,1,Private room,130,23,3.08,153
12803,Anna,2,Entire home/apt,325,179,1.73,504
12807,Alinka,1,Entire home/apt,144,0,0.8,144
12809,Sophia,1,Private room,45,0,0.05,45
12810,Rebekah,2,Private room,75,0,0.02,75
12811,Andrew,2,Private room,85,0,0.57,85
12812,Piner,1,Entire home/apt,50,0,0.03,50
12813,Stephanie,2,Private room,50,0,0.02,50
12815,Sap,2,Private room,60,205,0.4,265
12816,Anat,1,Entire home/apt,372,17,0.54,389
12817,Tyler,2,Private room,75,0,0.02,75
12818,Beatriz,2,Private room,60,0,0.02,60
12819,Mike,1,Private room,29,16,1.0,45
12820,Chelsea,2,Private room,85,345,2.08,430
12821,Aliza,2,Private room,60,251,0.38,311
12823,Kristy,1,Private room,90,0,0.45,90
12825,Maxim,1,Entire home/apt,70,0,0.07,70
12826,Eric,4,Entire home/apt,87,211,3.11,298
12827,Miguel,1,Private room,100,0,0.02,100
12828,Jared,2,Private room,55,173,0.19,228
12829,Timea,1,Entire home/apt,139,0,0.6,139
12832,Ariela,2,Private room,50,0,0.05,50
12833,Jeremy & Laura,1,Entire home/apt,260,336,0.3,596
12834,Yiling,1,Private room,120,0,0.08,120
12837,Aaron,1,Private room,90,86,4.31,176
12839,Mike,1,Entire home/apt,83,331,0.09,414
12840,Gerard,2,Private room,30,0,0.1,30
12841,Matt,1,Shared room,65,0,0.02,65
12843,Rachel,1,Entire home/apt,140,0,0.03,140
12844,Allegra,1,Entire home/apt,799,365,0.4,1164
12849,Jonathan,1,Private room,100,0,1.02,100
12850,Pierre,3,Entire home/apt,100,0,0.02,100
12852,Valentine,1,Private room,75,0,0.02,75
12855,Conor,1,Private room,70,0,0.05,70
12858,Min,1,Private room,145,139,1.19,284
12861,Thomas,2,Private room,60,0,0.13,60
12862,Raffi,2,Private room,70,0,0.02,70
12863,Leo,1,Entire home/apt,365,257,2.37,622
12864,Josephine,1,Entire home/apt,180,0,0.08,180
12867,Jeremy,2,Private room,49,0,0.05,49
12868,Michael,1,Private room,165,0,0.12,165
12869,Grace,2,Entire home/apt,140,273,3.06,413
12870,Haffro,1,Private room,72,201,0.08,273
12873,Jeremy & Laura,1,Entire home/apt,165,321,0.05,486
12874,Deniz,1,Entire home/apt,112,0,0.03,112
12875,Daniel,2,Entire home/apt,119,0,0.07,119
12876,Jeremy & Laura,1,Entire home/apt,160,365,0.03,525
12877,Jeff,2,Entire home/apt,170,0,0.32,170
12878,Sidra,2,Entire home/apt,995,89,0.02,1084
12879,Howard,2,Entire home/apt,185,365,0.56,550
12881,Brian,1,Private room,48,183,2.31,231
12883,Jesus,1,Entire home/apt,199,317,3.14,516
12884,Analá,2,Private room,80,0,0.05,80
12886,Michael E.,1,Entire home/apt,125,1,0.16,126
12887,Emily,1,Private room,62,0,0.05,62
12890,Sinat,2,Private room,75,0,0.21,75
12891,Jack,2,Entire home/apt,80,0,0.17,80
12892,David,1,Entire home/apt,195,0,0.02,195
12893,Samkit,1,Private room,68,0,0.02,68
12895,V,2,Entire home/apt,90,0,0.12,90
12896,Alexis,1,Entire home/apt,200,0,0.02,200
12898,Alizé,1,Private room,80,364,0.72,444
12899,Carol,1,Entire home/apt,125,1,0.17,126
12902,Yari,2,Private room,110,0,0.14,110
12903,Laura,1,Entire home/apt,199,0,0.02,199
12904,Shimrit,2,Private room,40,0,0.02,40
12905,Jose,2,Private room,65,3,0.49,68
12906,Andrea,1,Private room,85,0,0.02,85
12908,Greg,1,Private room,69,0,2.5,69
12909,Joyell,2,Private room,42,61,5.0,103
12910,Xinyan,1,Entire home/apt,120,0,0.11,120
12912,Grace,1,Entire home/apt,130,0,0.42,130
12915,Tom,1,Entire home/apt,210,248,1.54,458
12916,Ingrid Harvold,2,Private room,28,0,0.07,28
12917,Haley,2,Private room,60,0,0.03,60
12918,Liubov,2,Private room,60,332,2.66,392
12919,Taylor Jo,2,Entire home/apt,140,0,0.12,140
12921,Faigie,2,Private room,73,354,2.04,427
12922,Faigie,2,Private room,67,338,1.65,405
12924,Nany,1,Entire home/apt,110,310,1.81,420
12926,Alicia,1,Entire home/apt,80,0,0.16,80
12927,Peter,1,Entire home/apt,325,0,0.46,325
12929,Kristy,2,Private room,44,0,0.16,44
12932,Ben,2,Entire home/apt,165,274,4.37,439
12933,Son,2,Private room,30,0,0.11,30
12934,Gina,2,Private room,120,365,0.23,485
12935,Ellery,2,Entire home/apt,119,3,0.3,122
12936,Ena,2,Private room,39,0,0.28,39
12939,Jacquelyn,1,Private room,100,0,0.49,100
12940,Amanda,1,Private room,28,0,0.02,28
12941,Joe,1,Entire home/apt,149,149,0.58,298
12943,Jenny,1,Entire home/apt,225,0,0.19,225
12945,Laura,2,Private room,45,0,0.22,45
12946,Ther,1,Entire home/apt,120,0,0.03,120
12947,Abigail,1,Entire home/apt,99,0,0.12,99
12948,Don,2,Entire home/apt,206,365,0.81,571
12949,Nany,1,Entire home/apt,120,323,1.29,443
12951,Joe,1,Entire home/apt,290,0,1.37,290
12954,Eleanore,2,Entire home/apt,80,0,0.06,80
12955,Nadine,2,Entire home/apt,150,365,0.37,515
12956,Kristin,1,Private room,80,362,0.54,442
12957,Jenna,2,Entire home/apt,70,0,0.09,70
12958,Ken,2,Entire home/apt,130,0,0.02,130
12960,Andre,2,Entire home/apt,125,0,0.24,125
12961,Michael,2,Entire home/apt,150,0,0.02,150
12962,Marc,2,Entire home/apt,290,95,0.04,385
12964,Amelia,1,Entire home/apt,150,0,0.03,150
12965,Isaac,2,Entire home/apt,129,0,0.12,129
12966,Bj,4,Private room,64,1,0.84,65
12967,Shirley,1,Private room,100,0,0.02,100
12968,Nika,1,Private room,60,0,0.02,60
12969,Chris,2,Entire home/apt,120,0,0.21,120
12970,Jeremy & Laura,1,Entire home/apt,180,255,0.16,435
12972,Ericka,1,Private room,90,0,0.94,90
12973,Gautier,1,Entire home/apt,200,0,0.48,200
12978,Daniel,1,Private room,70,0,0.07,70
12979,Margarita,1,Entire home/apt,90,0,0.09,90
12980,Miho,2,Private room,70,322,1.46,392
12981,Julia,2,Entire home/apt,94,0,0.16,94
12982,Natalie,1,Entire home/apt,250,0,0.07,250
12984,Evy,2,Private room,85,334,0.95,419
12985,Bianca,3,Entire home/apt,65,12,2.19,77
12986,Kara,1,Entire home/apt,369,345,0.02,714
12988,Livia,3,Entire home/apt,88,192,2.88,280
12989,Ryan,1,Entire home/apt,65,0,0.07,65
12991,Charles Jnr,2,Private room,79,0,0.3,79
12994,Kara,1,Entire home/apt,239,363,0.07,602
12995,Kyla,2,Entire home/apt,120,200,2.12,320
12996,Daniel,1,Private room,175,26,2.95,201
12997,Francis,1,Entire home/apt,200,0,0.05,200
12998,Heather,1,Entire home/apt,103,0,0.02,103
13000,Aditya,2,Private room,80,0,0.02,80
13001,Jennifer,2,Private room,60,0,0.02,60
13003,Milen,2,Private room,50,0,0.1,50
13005,Wendy,2,Entire home/apt,425,205,0.09,630
13009,Diana,1,Entire home/apt,200,335,0.03,535
13010,Megan,1,Entire home/apt,300,0,0.02,300
13011,Ross,2,Private room,47,0,0.05,47
13013,Kendall,1,Entire home/apt,200,0,0.05,200
13014,Anna,1,Entire home/apt,180,0,0.19,180
13015,Charline,1,Entire home/apt,270,0,0.19,270
13016,Sierra,1,Private room,30,0,0.02,30
13017,Michole,2,Entire home/apt,170,270,0.44,440
13018,Daniel,1,Private room,55,0,0.02,55
13020,Ricardo,2,Private room,30,0,0.02,30
13021,Kara,1,Entire home/apt,139,306,0.04,445
13022,Will,1,Private room,101,345,0.15,446
13024,Leah,2,Private room,50,362,0.74,412
13025,Anna,2,Private room,38,0,0.07,38
13026,Elli,2,Entire home/apt,219,36,0.09,255
13030,Humberto,1,Entire home/apt,275,0,0.15,275
13031,Kara,1,Entire home/apt,249,273,0.06,522
13034,Anya & Marco,1,Entire home/apt,100,0,0.35,100
13035,Ana,2,Private room,49,0,0.05,49
13037,Erica,2,Entire home/apt,150,364,0.06,514
13040,John-Paul,3,Entire home/apt,150,0,0.02,150
13043,Kara,1,Entire home/apt,190,286,0.04,476
13046,Alex,5,Private room,52,340,3.17,392
13047,Daniel,2,Entire home/apt,89,0,0.07,89
13048,Kara,1,Entire home/apt,369,345,0.07,714
13050,Ryan,2,Private room,90,331,0.16,421
13051,Brandon,1,Entire home/apt,115,0,0.18,115
13054,Jamie,3,Private room,66,0,0.02,66
13057,Evan,1,Private room,89,0,0.56,89
13061,James,1,Private room,94,0,0.07,94
13063,Hannah,1,Private room,70,0,0.05,70
13065,Nia,3,Private room,90,33,1.37,123
13066,Mehrnoush,2,Entire home/apt,155,0,0.02,155
13067,Taylor,3,Private room,65,0,0.05,65
13069,Aidan,1,Entire home/apt,149,0,0.02,149
13070,Nia,3,Private room,70,63,2.6,133
13071,Miguel,1,Private room,100,0,0.02,100
13073,CRNY Monthly Rentals,1,Entire home/apt,150,125,0.02,275
13076,Jim,3,Entire home/apt,200,86,2.17,286
13077,Laurance,2,Private room,50,0,0.02,50
13078,Audrey,1,Entire home/apt,225,176,0.68,401
13079,Karen,2,Private room,35,326,0.39,361
13080,Kyle,1,Private room,45,0,0.02,45
13081,Aidan,1,Private room,140,0,0.47,140
13082,David,1,Entire home/apt,160,0,0.88,160
13083,Karen,2,Private room,35,272,0.47,307
13084,Diana,2,Entire home/apt,125,0,0.19,125
13085,David,1,Entire home/apt,160,0,0.02,160
13087,Alex,1,Entire home/apt,179,0,0.12,179
13089,Steph,2,Private room,70,0,0.05,70
13092,Doug,1,Entire home/apt,300,58,2.46,358
13093,Patrice,1,Entire home/apt,152,0,0.37,152
13094,Caroline,1,Private room,100,0,0.09,100
13095,Rui,1,Entire home/apt,200,0,0.07,200
13096,Bernie,1,Entire home/apt,250,13,0.47,263
13098,Madison,1,Entire home/apt,200,0,0.05,200
13099,Selin,1,Entire home/apt,245,0,0.03,245
13100,Jessica,1,Private room,79,0,0.07,79
13101,Lincoln,1,Entire home/apt,175,0,0.02,175
13104,Xenia,1,Entire home/apt,139,0,0.02,139
13105,Robin,2,Entire home/apt,220,5,0.65,225
13106,Danielle,2,Private room,70,0,0.14,70
13107,Felix,2,Private room,99,232,4.73,331
13108,Liat,2,Entire home/apt,120,0,0.08,120
13109,Ashley,2,Entire home/apt,178,0,0.56,178
13111,Clay,2,Entire home/apt,124,0,0.49,124
13114,Mark,3,Entire home/apt,250,363,0.13,613
13116,Mark,3,Entire home/apt,375,364,0.13,739
13119,Liz And Cesar,2,Private room,65,320,0.26,385
13121,Emory,2,Private room,60,296,0.58,356
13122,Hanson,1,Private room,60,0,0.02,60
13123,Lilly,2,Private room,45,0,0.02,45
13125,Stephanie,2,Entire home/apt,74,27,0.02,101
13126,Donald,2,Private room,50,0,0.63,50
13127,Anthony,2,Private room,60,0,0.07,60
13128,Hoda,1,Entire home/apt,150,0,0.02,150
13130,Bee,2,Entire home/apt,40,7,2.24,47
13131,Brian,1,Private room,120,0,0.02,120
13132,Anusheh,2,Private room,35,0,0.02,35
13134,Taylor,2,Entire home/apt,85,0,0.14,85
13136,John,1,Private room,146,30,0.6,176
13137,Hamid,2,Private room,99,342,0.12,441
13138,Rachel,2,Private room,69,0,0.02,69
13139,Frank,2,Private room,70,0,0.02,70
13140,Derrick,2,Entire home/apt,159,0,0.15,159
13142,Michael H.Y.,2,Private room,65,155,5.62,220
13143,Angelina,2,Private room,45,0,0.14,45
13144,Marlon,1,Private room,42,24,0.16,66
13145,Emily,2,Entire home/apt,100,0,0.35,100
13147,Medina,2,Entire home/apt,175,364,0.37,539
13149,Tania,1,Private room,90,0,0.12,90
13151,Robert,2,Entire home/apt,130,58,1.05,188
13152,Jennifer,1,Shared room,70,0,0.09,70
13153,Casey,2,Private room,48,0,0.05,48
13154,Kara,1,Entire home/apt,169,364,0.06,533
13155,Cyntia,1,Entire home/apt,200,0,0.03,200
13157,Jet,2,Private room,50,0,0.19,50
13158,Minka,2,Entire home/apt,80,0,0.16,80
13159,Paul,1,Entire home/apt,200,0,0.26,200
13161,CRNY Monthly Rentals,1,Entire home/apt,215,146,0.11,361
13162,CRNY Monthly Rentals,1,Entire home/apt,249,125,0.12,374
13163,CRNY Monthly Rentals,1,Entire home/apt,110,179,0.17,289
13164,CRNY Monthly Rentals,1,Entire home/apt,110,145,0.02,255
13167,Tamara,2,Entire home/apt,86,0,0.02,86
13168,卷妮,1,Private room,79,0,0.07,79
13169,Josh,2,Entire home/apt,150,11,0.82,161
13170,John,1,Entire home/apt,199,1,1.25,200
13171,Jason,2,Entire home/apt,85,34,3.25,119
13175,Jamie,1,Entire home/apt,330,258,2.78,588
13176,Nicholas,2,Entire home/apt,175,0,0.08,175
13177,Daniel,1,Private room,91,0,0.02,91
13179,Serik,2,Entire home/apt,75,0,0.05,75
13180,Dax,1,Entire home/apt,225,362,0.02,587
13182,Paris,2,Private room,40,365,0.12,405
13183,D,1,Entire home/apt,174,198,3.31,372
13184,Koen,2,Entire home/apt,200,0,0.05,200
13185,Leroy,1,Entire home/apt,150,186,1.56,336
13186,J,2,Private room,102,10,0.7,112
13188,Liubov,2,Private room,76,141,0.58,217
13189,Marc,2,Shared room,75,318,0.19,393
13191,Jessie,1,Entire home/apt,175,0,0.02,175
13192,Brittany,2,Entire home/apt,100,0,0.07,100
13193,Audra,1,Entire home/apt,145,230,1.64,375
13194,Angelina,2,Private room,49,244,0.1,293
13195,Karla,1,Private room,50,0,0.03,50
13196,Guirlaine,1,Entire home/apt,120,32,2.39,152
13198,Erica,2,Private room,50,0,0.13,50
13199,Sidika,3,Private room,60,0,0.23,60
13200,Nia,3,Private room,55,46,2.47,101
13202,Siyi,1,Private room,90,23,0.28,113
13204,Pieter,1,Private room,49,0,0.03,49
13205,Tanya,1,Private room,65,0,0.14,65
13206,Liis,2,Private room,90,0,0.02,90
13207,Natalie,2,Private room,49,0,0.05,49
13208,Christopher,2,Entire home/apt,75,0,0.09,75
13209,Michele,1,Private room,100,0,0.05,100
13210,Derrick,2,Private room,59,0,1.92,59
13212,Yuan,1,Entire home/apt,225,0,0.53,225
13215,Gabi,1,Entire home/apt,150,0,0.07,150
13216,Gregoire,2,Private room,63,0,0.02,63
13217,Trish,1,Entire home/apt,200,0,0.25,200
13220,Gabriel,1,Entire home/apt,140,0,0.05,140
13221,Tommy,1,Private room,95,0,0.03,95
13222,Fionn,2,Private room,55,0,0.02,55
13223,Tobias,2,Private room,32,0,0.07,32
13224,Jade,1,Entire home/apt,110,0,0.22,110
13227,Sandra,2,Private room,100,284,2.75,384
13229,Elena,1,Private room,90,0,0.09,90
13230,Tanny,1,Entire home/apt,139,49,0.27,188
13231,Adrien,1,Private room,150,0,0.05,150
13232,Franck,1,Private room,170,6,0.56,176
13234,Katherine,1,Private room,120,0,0.02,120
13235,Katherine,1,Private room,80,0,0.05,80
13238,Grace,3,Private room,36,110,1.43,146
13240,Marcela,1,Private room,129,261,0.52,390
13242,Emily,2,Private room,60,0,0.03,60
13243,Monica,1,Private room,60,0,0.05,60
13244,Aurelie,2,Private room,60,0,0.05,60
13245,Romina,3,Entire home/apt,99,0,0.43,99
13246,R,2,Entire home/apt,101,0,0.05,101
13248,Negar,1,Entire home/apt,219,0,0.03,219
13250,Jessie,2,Private room,25,8,0.19,33
13251,Jose,3,Shared room,26,365,0.68,391
13252,Michole,2,Private room,90,245,1.15,335
13255,Jan,1,Private room,59,0,0.02,59
13256,Jessica,1,Private room,70,0,0.23,70
13258,Morgan,2,Entire home/apt,115,0,0.89,115
13259,Jillian,1,Entire home/apt,150,321,1.26,471
13260,Ollya,2,Private room,105,212,0.16,317
13262,Brian,2,Entire home/apt,113,63,4.02,176
13263,Lauren,1,Private room,70,0,0.02,70
13264,Kevin,1,Entire home/apt,199,0,0.33,199
13265,Carlos,2,Entire home/apt,125,0,0.05,125
13266,Alden,2,Entire home/apt,140,0,0.29,140
13267,Christophe,2,Private room,85,230,3.23,315
13268,Helene,2,Private room,70,249,0.08,319
13269,Andres,1,Entire home/apt,89,0,0.07,89
13270,Elle,3,Private room,95,244,1.28,339
13273,Arthur,1,Entire home/apt,220,0,0.19,220
13274,Ian,2,Private room,45,0,0.09,45
13275,Anthony,1,Private room,59,0,0.15,59
13276,Simon,1,Private room,95,0,0.02,95
13278,Samantha,2,Entire home/apt,115,0,0.03,115
13279,Michael,1,Private room,105,0,0.09,105
13280,Ashley,2,Entire home/apt,93,0,0.12,93
13281,Lingzi,1,Private room,40,0,0.12,40
13283,Stephanie,2,Entire home/apt,85,0,0.02,85
13284,Paula,1,Entire home/apt,170,0,0.82,170
13285,Minoo,1,Private room,75,0,0.05,75
13286,Ninell,2,Private room,55,213,0.12,268
13287,Daniel,2,Private room,57,38,4.08,95
13288,Mido,1,Entire home/apt,199,0,0.25,199
13290,Micheal,1,Entire home/apt,485,54,0.36,539
13291,Christina,1,Entire home/apt,125,14,0.72,139
13293,Salman,1,Private room,95,96,0.52,191
13294,Mark,1,Entire home/apt,200,0,0.03,200
13295,Lily,1,Entire home/apt,90,53,3.98,143
13297,Andrea,1,Entire home/apt,100,0,0.03,100
13298,Lara,2,Private room,70,0,0.5,70
13299,CRNY Monthly Rentals,1,Entire home/apt,110,157,0.16,267
13300,Kensey,2,Entire home/apt,96,0,0.4,96
13302,Rebeka,2,Entire home/apt,175,0,0.07,175
13303,Natalie,1,Private room,70,0,0.02,70
13304,Olya,1,Private room,75,128,0.46,203
13305,Jan,4,Private room,51,364,0.96,415
13306,Meghan,2,Entire home/apt,80,0,0.02,80
13307,CRNY Monthly Rentals,1,Entire home/apt,110,133,0.03,243
13308,Edna,1,Private room,80,0,0.03,80
13310,CRNY Monthly Rentals,1,Entire home/apt,170,142,0.03,312
13312,D,1,Private room,65,79,4.16,144
13313,CRNY Monthly Rentals,1,Entire home/apt,165,134,0.09,299
13314,CRNY Monthly Rentals,1,Entire home/apt,115,179,0.14,294
13315,CRNY Monthly Rentals,1,Entire home/apt,150,125,0.07,275
13316,Maria,3,Private room,700,97,0.02,797
13317,CRNY Monthly Rentals,1,Entire home/apt,125,111,0.11,236
13319,CRNY Monthly Rentals,1,Entire home/apt,150,107,0.1,257
13320,Chelsea,1,Private room,170,0,2.63,170
13321,CRNY Monthly Rentals,1,Entire home/apt,150,156,0.11,306
13322,CRNY Monthly Rentals,1,Entire home/apt,150,128,0.12,278
13323,Joule,1,Private room,45,64,0.5,109
13325,Peter,2,Private room,89,237,2.24,326
13327,Kazuhiro,2,Private room,35,27,2.7,62
13328,Jorge,2,Entire home/apt,70,88,0.05,158
13329,Maria,1,Private room,100,268,2.67,368
13331,Tamu,2,Private room,59,301,0.96,360
13334,Jen,2,Entire home/apt,155,0,0.57,155
13335,Alexandra,2,Private room,61,0,0.02,61
13336,Guillaume,1,Private room,100,0,0.02,100
13337,Frankie,3,Private room,55,118,1.04,173
13338,Josh,2,Private room,40,0,0.02,40
13340,Tim,1,Entire home/apt,101,0,0.02,101
13341,Brian,1,Private room,50,190,3.26,240
13343,Eleni,1,Private room,102,134,1.7,236
13349,Fabrizio,1,Entire home/apt,120,0,0.61,120
13350,Jeniffer,1,Entire home/apt,150,210,0.08,360
13353,Hans,1,Entire home/apt,115,77,0.31,192
13354,Joshua,1,Private room,49,0,0.02,49
13355,Mercy,1,Entire home/apt,200,3,0.65,203
13356,Jeniffer,1,Entire home/apt,166,195,0.18,361
13357,Dawn,2,Private room,40,0,0.02,40
13358,Henry Norman,2,Private room,137,53,0.91,190
13359,Erica,2,Private room,58,0,0.02,58
13361,Morgan,2,Private room,35,0,0.02,35
13362,Jeniffer,1,Entire home/apt,150,339,0.03,489
13364,Doug,1,Entire home/apt,175,0,0.02,175
13365,Henry Norman,2,Entire home/apt,189,69,0.61,258
13367,Sasha,2,Entire home/apt,175,54,1.8,229
13368,Jessica,1,Private room,150,0,0.02,150
13369,Carrie,1,Entire home/apt,425,39,1.38,464
13371,Jeannette,1,Private room,75,0,0.09,75
13372,Jason,1,Entire home/apt,170,0,0.02,170
13373,Whitney,1,Entire home/apt,120,0,0.02,120
13374,Nikki,2,Private room,65,0,0.06,65
13375,Henry Norman,2,Entire home/apt,350,74,0.05,424
13376,Henry Norman,2,Entire home/apt,199,74,0.61,273
13377,Willem,1,Private room,67,0,0.02,67
13378,Henry Norman,2,Entire home/apt,189,74,0.21,263
13380,Angela,3,Private room,50,302,2.1,352
13381,Celia,1,Entire home/apt,220,264,2.89,484
13383,Nan,3,Private room,49,83,0.02,132
13384,Toby Steven,1,Entire home/apt,226,276,2.57,502
13385,Charles,2,Private room,79,0,0.07,79
13386,Dymphna,2,Private room,80,0,0.02,80
13388,Whitney,2,Entire home/apt,100,0,0.16,100
13389,Jessica,1,Entire home/apt,98,0,0.14,98
13391,Nic,3,Private room,70,25,0.1,95
13392,Shelby,1,Entire home/apt,150,0,0.05,150
13393,David,1,Private room,125,81,4.89,206
13394,Edmund,3,Entire home/apt,155,307,1.54,462
13395,Moti,1,Entire home/apt,179,0,0.11,179
13396,Melissa,2,Private room,60,0,0.05,60
13399,Henry Norman,2,Entire home/apt,179,53,0.84,232
13400,Andrew,2,Private room,50,0,0.07,50
13402,Henry Norman,2,Private room,189,74,0.79,263
13403,Adam,2,Entire home/apt,67,332,0.59,399
13404,Glenn H.,1,Entire home/apt,99,42,0.07,141
13405,Jenna,1,Entire home/apt,140,0,0.15,140
13407,Kt,1,Private room,55,0,1.76,55
13409,Rick,2,Entire home/apt,170,0,0.02,170
13411,Angel,1,Entire home/apt,175,307,1.44,482
13414,Henry Norman,2,Private room,189,0,0.49,189
13415,Nick,2,Private room,35,49,4.1,84
13416,Yehua,2,Entire home/apt,61,0,0.57,61
13417,Henry Norman,2,Entire home/apt,205,72,0.12,277
13418,Justyna,3,Private room,35,0,0.02,35
13419,Rong,1,Private room,39,0,0.07,39
13422,Charlie,1,Entire home/apt,159,0,0.03,159
13424,Sesenu,2,Private room,37,0,0.05,37
13425,CRNY Monthly Rentals,1,Entire home/apt,299,160,0.04,459
13426,Gabriela,1,Entire home/apt,175,0,0.28,175
13428,Ayten,2,Entire home/apt,110,0,0.02,110
13431,Toyosi,2,Private room,130,0,0.02,130
13432,Ying Ying,2,Entire home/apt,140,9,2.11,149
13433,Marianna,2,Entire home/apt,168,0,0.02,168
13434,Rachel,2,Entire home/apt,128,0,0.07,128
13435,Matthew,2,Private room,64,0,0.14,64
13436,Ella,2,Private room,35,0,0.03,35
13439,Anthony,2,Entire home/apt,199,0,0.08,199
13440,Ali,2,Entire home/apt,175,104,2.45,279
13442,Lukre,2,Private room,55,65,0.49,120
13445,Sayaka,1,Entire home/apt,95,0,0.2,95
13446,Daniella,2,Entire home/apt,153,9,2.45,162
13447,Isidora,2,Private room,39,0,0.02,39
13449,Robert,1,Private room,85,0,0.05,85
13450,Brian,1,Entire home/apt,315,177,1.31,492
13451,Michael,2,Entire home/apt,89,64,0.23,153
13453,Taran & Najla,3,Entire home/apt,179,324,2.67,503
13456,Yina,1,Entire home/apt,150,0,0.13,150
13457,Harvin,2,Entire home/apt,225,273,1.69,498
13458,Joseph,1,Entire home/apt,140,0,0.02,140
13459,Laura,2,Private room,115,358,0.13,473
13460,Julian,2,Private room,58,0,0.05,58
13461,Miri,2,Entire home/apt,190,257,1.58,447
13462,Oliver,1,Entire home/apt,100,0,0.02,100
13463,Sawyer,2,Private room,119,0,2.06,119
13466,Henry Norman,2,Entire home/apt,129,71,0.37,200
13468,Gregory,1,Private room,110,281,1.78,391
13469,Brandon,1,Entire home/apt,90,0,0.05,90
13470,Karen,2,Private room,61,0,0.1,61
13471,Rachel,1,Private room,65,0,0.09,65
13472,Victor,1,Private room,60,310,6.25,370
13473,Victor,1,Private room,60,280,5.95,340
13474,Fred & Liz,1,Entire home/apt,150,0,0.66,150
13475,Mark,1,Private room,587,365,0.16,952
13476,Andrew,1,Entire home/apt,175,288,3.18,463
13478,Raanan,1,Entire home/apt,166,332,0.13,498
13479,Raanan,1,Entire home/apt,120,338,0.11,458
13480,Yoav,2,Entire home/apt,135,0,0.42,135
13481,Scott,1,Entire home/apt,145,0,0.02,145
13482,Genny & Gina,2,Entire home/apt,185,25,1.8,210
13484,Don,2,Private room,206,365,0.05,571
13486,Han,1,Private room,80,0,0.02,80
13488,Alex,1,Entire home/apt,239,161,1.29,400
13489,Erica & David,2,Entire home/apt,399,29,0.91,428
13492,Amy,2,Entire home/apt,125,0,0.2,125
13494,Julia,2,Entire home/apt,500,88,2.92,588
13495,Dona,3,Private room,47,173,13.4,220
13498,Lucia,1,Private room,99,77,2.95,176
13499,Ashley,1,Private room,75,0,0.02,75
13502,Roxanne,2,Entire home/apt,80,0,0.03,80
13503,Joe,1,Private room,100,4,1.19,104
13504,Ugi,2,Private room,60,0,0.09,60
13506,Yue,1,Entire home/apt,118,0,0.02,118
13507,Michael,1,Private room,97,0,0.84,97
13508,Sam,1,Entire home/apt,210,11,1.19,221
13509,J,2,Entire home/apt,55,0,0.14,55
13510,Ksenia & Masha,2,Private room,62,27,1.7,89
13511,Ben,1,Entire home/apt,185,0,0.02,185
13513,Jason,2,Entire home/apt,165,194,5.49,359
13515,Casey,1,Entire home/apt,102,0,0.07,102
13516,Zhamal,2,Private room,80,0,0.05,80
13519,The Bowery House,1,Private room,84,0,0.3,84
13520,Christina,1,Entire home/apt,95,0,0.12,95
13521,Taylor,2,Private room,65,0,0.05,65
13522,Rachel,1,Entire home/apt,152,357,1.06,509
13523,Kimberly,2,Private room,50,0,0.06,50
13525,Eric,2,Private room,149,0,0.35,149
13526,The Bowery House,1,Private room,124,0,0.46,124
13527,Molly,1,Private room,58,275,1.28,333
13528,The Bowery House,1,Private room,159,0,0.22,159
13529,Alex,1,Entire home/apt,250,0,0.02,250
13531,Lyla,1,Entire home/apt,250,0,0.35,250
13532,Yvonne,1,Entire home/apt,500,88,0.13,588
13533,Kc,2,Private room,58,38,5.96,96
13534,Denise,2,Entire home/apt,199,231,1.84,430
13536,Yonathan,2,Private room,95,10,0.46,105
13537,常春,1,Shared room,36,324,0.47,360
13538,Jun,1,Entire home/apt,165,0,0.1,165
13539,Kc,2,Private room,72,0,5.95,72
13540,Jennifer,1,Private room,179,309,0.05,488
13541,Jennifer,1,Private room,209,244,0.27,453
13543,Paul,1,Entire home/apt,150,22,1.2,172
13544,Joel,2,Private room,375,0,0.05,375
13545,Kelly,3,Private room,65,0,0.02,65
13546,Chelsea,1,Entire home/apt,275,0,0.24,275
13547,Louise,1,Shared room,110,0,0.11,110
13548,Markus,1,Private room,99,0,0.98,99
13549,Fataah,1,Private room,85,0,0.06,85
13550,Jennifer,1,Private room,189,291,0.16,480
13552,Cristina,1,Private room,75,224,2.01,299
13553,Diana,3,Private room,45,16,0.75,61
13555,Jack,1,Entire home/apt,125,0,0.14,125
13557,Rachel,2,Private room,71,98,0.42,169
13558,Cheer,3,Private room,46,286,3.21,332
13559,Hanna,1,Private room,105,35,1.03,140
13560,Edward,2,Private room,41,0,0.02,41
13561,Elem,1,Entire home/apt,99,327,0.18,426
13562,Lady,3,Private room,37,135,1.73,172
13563,Janine,1,Entire home/apt,60,0,0.05,60
13564,David,2,Entire home/apt,218,335,1.67,553
13565,Cloe,1,Private room,150,43,0.4,193
13566,Charlotte,1,Private room,52,0,0.06,52
13567,Chris,2,Entire home/apt,210,0,0.07,210
13568,Ginji,1,Entire home/apt,115,0,0.02,115
13569,Raanan,1,Entire home/apt,105,327,0.06,432
13570,Brent,1,Private room,80,0,0.07,80
13571,Diana,1,Entire home/apt,225,0,0.02,225
13572,Helena,2,Entire home/apt,175,0,0.05,175
13573,John,1,Private room,120,0,0.09,120
13574,Lugao,1,Shared room,65,0,1.34,65
13575,Henry Norman,2,Entire home/apt,99,50,0.7,149
13576,Kim,1,Entire home/apt,160,0,0.21,160
13577,Beto,1,Private room,60,0,0.03,60
13579,Guy,1,Entire home/apt,230,208,0.15,438
13580,Javier,1,Entire home/apt,250,89,2.15,339
13581,Alex,1,Entire home/apt,299,332,1.71,631
13583,John,2,Private room,79,174,0.4,253
13585,Max,2,Entire home/apt,110,0,0.07,110
13586,Amber,1,Private room,70,0,0.02,70
13587,Julia,2,Entire home/apt,150,0,0.03,150
13588,Kenny,2,Private room,59,0,0.28,59
13589,Marty,1,Entire home/apt,165,328,4.42,493
13590,Henry Norman,2,Private room,149,74,0.75,223
13591,Henry Norman,2,Entire home/apt,129,74,0.08,203
13592,Isik,2,Private room,42,0,0.07,42
13593,Michael & Bethany,2,Entire home/apt,120,215,3.35,335
13594,Christopher,2,Private room,63,73,0.44,136
13595,Victor,1,Entire home/apt,180,3,0.56,183
13596,Mohammed,2,Entire home/apt,220,0,0.02,220
13597,J,2,Private room,68,0,0.77,68
13598,Edward,1,Private room,119,0,3.15,119
13599,Jazzy,1,Private room,37,0,0.28,37
13603,Gary,1,Entire home/apt,199,65,3.93,264
13605,Caroline,2,Private room,60,0,0.17,60
13606,Andrea,3,Entire home/apt,135,0,1.03,135
13607,Ana Bess,2,Private room,64,0,0.02,64
13608,Jeerathinan,3,Private room,80,49,0.88,129
13610,Jake,3,Private room,48,365,4.64,413
13611,Peter,2,Entire home/apt,115,0,0.21,115
13612,Maya,3,Private room,45,175,10.72,220
13613,Anthony,2,Private room,38,0,0.02,38
13614,Chloe,1,Private room,85,0,0.02,85
13615,Kashif,1,Entire home/apt,275,0,1.84,275
13616,Larry & Deb,3,Entire home/apt,125,0,0.64,125
13617,Lori,1,Entire home/apt,250,190,0.47,440
13618,Alosha,3,Private room,79,259,0.26,338
13620,Dan,1,Entire home/apt,100,0,0.14,100
13621,Han,1,Private room,70,0,0.19,70
13623,Jason,2,Entire home/apt,60,0,0.28,60
13624,Annie,2,Private room,50,316,0.09,366
13625,Evan,2,Private room,35,0,0.78,35
13626,Millie,1,Entire home/apt,180,273,0.83,453
13627,Naudia,2,Entire home/apt,70,27,0.81,97
13628,Shosh,1,Entire home/apt,220,185,1.47,405
13629,Jeremy & Laura,1,Entire home/apt,135,311,0.16,446
13630,Jeremy & Laura,1,Entire home/apt,140,244,0.06,384
13631,Susan,2,Private room,175,178,0.22,353
13632,Jeremy & Laura,1,Entire home/apt,180,319,0.12,499
13634,Christopher,3,Private room,55,0,0.46,55
13636,Alexandra,1,Private room,91,0,0.19,91
13639,Hilal & Maryam,2,Entire home/apt,143,263,4.2,406
13640,Olga,2,Private room,55,0,0.06,55
13641,Amy,1,Entire home/apt,110,0,0.02,110
13643,Vivian,3,Private room,90,87,0.3,177
13644,Jennifer,1,Private room,199,267,0.02,466
13647,Shawna,1,Entire home/apt,235,0,0.05,235
13648,Ruveyda,3,Private room,62,358,0.24,420
13649,Terri,3,Private room,85,87,0.23,172
13650,Rhonda,3,Entire home/apt,60,297,4.95,357
13651,Mark,3,Private room,45,212,0.85,257
13654,Maria,2,Entire home/apt,165,287,1.36,452
13656,Francois & Keith,1,Private room,77,228,2.29,305
13657,Rishe,2,Private room,43,38,0.4,81
13659,Sophia,2,Entire home/apt,70,7,1.56,77
13660,Rosa,2,Entire home/apt,105,365,0.02,470
13661,Matthew,2,Private room,54,0,0.14,54
13663,Martin,2,Entire home/apt,145,37,1.6,182
13665,Aaron,2,Private room,55,1,0.68,56
13666,Amy,1,Entire home/apt,285,153,2.09,438
13670,Mo,2,Entire home/apt,255,230,2.37,485
13671,Estee,2,Entire home/apt,500,339,2.38,839
13672,Carrie,2,Private room,75,0,0.08,75
13674,Abe,2,Private room,64,0,0.06,64
13676,Ken,1,Private room,135,365,2.36,500
13677,Adrian,2,Private room,70,0,0.03,70
13678,Polina,2,Entire home/apt,295,226,4.33,521
13679,Siobhan,1,Entire home/apt,135,0,0.11,135
13680,Jeff,1,Shared room,50,0,0.05,50
13681,Harish,3,Entire home/apt,69,308,2.13,377
13682,Jonathan,5,Entire home/apt,299,350,1.91,649
13683,Lasata,3,Entire home/apt,204,0,4.49,204
13685,Kimberly,1,Private room,125,322,1.13,447
13686,Helen,2,Entire home/apt,69,0,0.88,69
13687,Dana,1,Entire home/apt,139,0,0.08,139
13688,John,2,Private room,149,180,0.64,329
13689,J.C.,3,Entire home/apt,100,0,0.22,100
13690,Jeremy & Laura,1,Entire home/apt,360,213,0.11,573
13691,Hayley,2,Private room,99,0,0.82,99
13692,Leo,3,Private room,60,0,0.12,60
13693,Shamroz,1,Private room,60,0,0.05,60
13694,Beatriz & Will,3,Entire home/apt,275,325,3.43,600
13695,Gade,2,Private room,65,361,1.8,426
13696,Gade,2,Entire home/apt,149,361,2.81,510
13697,Ariel,1,Private room,60,0,0.02,60
13698,Angelica,2,Entire home/apt,120,1,1.92,121
13700,(Email hidden by Airbnb),2,Entire home/apt,261,0,0.14,261
13701,The Mahogany Suite(Studio Apartment,2,Entire home/apt,99,271,2.81,370
13703,Laura,2,Private room,65,111,2.54,176
13706,Laura,2,Private room,60,122,3.36,182
13707,Chris,2,Private room,69,0,1.26,69
13708,Przemek,2,Entire home/apt,150,142,2.56,292
13709,Chaydha,2,Private room,37,0,0.28,37
13710,Suhel,3,Entire home/apt,100,304,5.25,404
13711,Neil,2,Entire home/apt,99,47,2.19,146
13712,Jeremy & Laura,1,Entire home/apt,160,365,0.12,525
13713,Gal,1,Entire home/apt,225,173,0.45,398
13714,Victoria Maria,2,Private room,51,89,0.33,140
13717,Rosaly,1,Private room,65,209,4.16,274
13718,Ishwarjot,2,Entire home/apt,120,0,0.83,120
13719,Norman,1,Shared room,125,365,0.15,490
13720,John,1,Entire home/apt,260,12,2.05,272
13721,Ozzy,2,Entire home/apt,94,0,0.88,94
13722,Mutaz,1,Private room,79,17,0.1,96
13724,Jack,1,Entire home/apt,1731,97,2.8,1828
13725,Alec,2,Private room,99,365,4.14,464
13726,Madeline,2,Private room,41,0,0.02,41
13727,Paul,1,Private room,90,0,0.08,90
13728,Dani,1,Entire home/apt,69,0,0.34,69
13730,Grant,2,Entire home/apt,113,44,1.99,157
13731,Ehssan,4,Private room,35,0,0.06,35
13734,Nathan & Ximena,2,Entire home/apt,200,363,0.54,563
13735,Mor,1,Entire home/apt,100,331,0.21,431
13736,Reed,4,Entire home/apt,37,0,0.25,37
13737,Wayde,3,Entire home/apt,180,361,0.54,541
13739,Angella,1,Entire home/apt,200,73,0.11,273
13741,Jason,1,Private room,80,302,0.79,382
13744,Madonna,2,Private room,55,0,0.02,55
13746,Elem,1,Entire home/apt,110,331,0.22,441
13747,Kodchakorn,1,Entire home/apt,135,0,0.09,135
13748,Sheldon,1,Private room,45,0,0.08,45
13749,Kristen,1,Entire home/apt,145,0,0.48,145
13750,Ron,2,Private room,37,0,0.14,37
13751,Jesse & Rotem,2,Entire home/apt,90,25,3.94,115
13752,Jessica,1,Entire home/apt,305,177,0.54,482
13754,Sandra,1,Entire home/apt,180,261,4.04,441
13755,Edgar,1,Private room,90,22,5.34,112
13756,Alex,1,Entire home/apt,135,0,0.13,135
13757,Steven,2,Private room,49,0,0.05,49
13758,Peter,2,Entire home/apt,95,0,0.3,95
13759,Maurice,2,Entire home/apt,155,302,1.81,457
13760,Steph,2,Private room,47,0,0.03,47
13762,Missy,3,Private room,38,24,1.4,62
13763,Ken,2,Entire home/apt,199,90,0.61,289
13764,Aj,1,Private room,87,12,0.71,99
13766,Missy,3,Private room,40,229,0.2,269
13767,Robert,2,Entire home/apt,155,20,4.89,175
13769,Krysta,2,Private room,81,0,2.81,81
13770,Meredith,2,Entire home/apt,129,235,2.75,364
13771,Zal,1,Entire home/apt,83,0,0.05,83
13773,Lindy,2,Entire home/apt,130,0,0.4,130
13774,Alex,2,Entire home/apt,325,0,0.05,325
13775,Martha,1,Private room,30,3,3.19,33
13776,Amy,3,Private room,50,84,2.78,134
13777,Amy,3,Private room,50,79,2.32,129
13779,Jesper,1,Entire home/apt,200,0,0.12,200
13781,Jacob,2,Private room,80,0,0.37,80
13782,Robert,2,Private room,35,0,0.02,35
13783,Caroline,2,Private room,75,158,0.08,233
13785,Harry,1,Entire home/apt,135,30,1.0,165
13786,Jeremy,2,Entire home/apt,125,276,4.76,401
13787,Amy,2,Private room,62,0,0.02,62
13788,Mark,2,Private room,1002,365,0.25,1367
13789,Elena,2,Entire home/apt,100,0,0.12,100
13790,Gurpreet  Singh,3,Private room,50,0,3.77,50
13793,Kyla,2,Entire home/apt,60,0,0.05,60
13794,Blake,2,Private room,75,0,0.02,75
13795,Rosa,2,Entire home/apt,65,0,0.19,65
13796,Danielle,1,Private room,80,0,0.02,80
13797,Yuchen,2,Private room,130,0,0.23,130
13801,Alec,2,Private room,149,365,2.48,514
13802,Liz,2,Entire home/apt,150,129,1.1,279
13803,Indiana,2,Shared room,60,0,0.03,60
13805,Jayson,2,Entire home/apt,100,1,0.33,101
13806,Maeve,2,Entire home/apt,150,0,3.09,150
13807,Michelle,2,Entire home/apt,170,354,0.03,524
13808,Shaun,3,Private room,65,12,0.93,77
13809,Omar,1,Entire home/apt,90,0,0.04,90
13810,Hai-Hsin,2,Private room,55,0,0.81,55
13813,Nick,2,Entire home/apt,319,112,1.84,431
13814,Jeniffer,1,Entire home/apt,120,345,0.13,465
13815,Mahmood,5,Private room,50,276,3.7,326
13818,Soonbin,2,Entire home/apt,175,129,0.46,304
13819,Marta,2,Private room,67,0,0.41,67
13822,Dominique,2,Entire home/apt,165,330,0.36,495
13824,Jeniffer,1,Entire home/apt,150,298,0.2,448
13825,Ann,2,Private room,115,56,0.69,171
13826,Tj,2,Private room,65,321,0.19,386
13827,Wesleyan,2,Private room,70,365,0.81,435
13828,Dimitri,1,Entire home/apt,219,306,0.09,525
13829,Brooklyn&   Breakfast    -Len-,2,Private room,45,324,4.82,369
13830,Eleonora,2,Private room,55,365,0.06,420
13832,Matthew,1,Private room,45,0,0.35,45
13833,Brooklyn&   Breakfast    -Len-,2,Private room,65,329,1.53,394
13835,Malik,1,Private room,65,0,0.19,65
13837,Seva,2,Entire home/apt,160,305,0.16,465
13838,Carine,1,Entire home/apt,500,321,0.58,821
13839,Lydia,2,Entire home/apt,120,288,2.46,408
13841,Scott,1,Entire home/apt,400,105,1.02,505
13842,Hans,2,Private room,45,342,0.06,387
13843,Eddie&Vlad,1,Private room,87,55,2.29,142
13845,Jennifer And Kenneth,1,Entire home/apt,115,157,2.85,272
13847,Nora,2,Private room,43,311,0.12,354
13849,Daniel,1,Entire home/apt,125,0,0.19,125
13850,Dave,2,Private room,55,0,0.09,55
13851,Trini,2,Private room,50,0,0.12,50
13852,Isabella,2,Private room,60,0,0.03,60
13853,Travis,4,Entire home/apt,88,170,2.9,258
13854,Jemier,4,Entire home/apt,85,277,0.24,362
13855,Chialing,2,Entire home/apt,275,292,0.46,567
13856,Dannale,2,Private room,65,343,0.24,408
13858,Hamid,2,Private room,40,20,0.25,60
13859,Alex And Zeena,1,Private room,85,338,3.96,423
13860,Alex And Zeena,1,Private room,85,352,3.62,437
13861,Alex And Zeena,1,Private room,85,344,3.91,429
13862,Cecil,2,Entire home/apt,120,0,0.12,120
13863,Elle,1,Entire home/apt,220,135,1.21,355
13864,Sarah,2,Private room,80,308,1.96,388
13865,Amy,1,Entire home/apt,275,219,0.25,494
13866,Dorina,3,Entire home/apt,125,306,2.22,431
13868,Catherine,1,Entire home/apt,65,0,0.07,65
13869,Hajra,2,Private room,58,2,0.13,60
13871,Dorina,3,Entire home/apt,115,314,0.14,429
13873,Shirley (Fred),3,Private room,49,332,0.13,381
13874,Erin,2,Entire home/apt,70,0,0.11,70
13876,Federica,1,Entire home/apt,196,31,0.05,227
13877,Melissa,1,Private room,80,0,0.12,80
13878,Rita,5,Private room,35,320,2.1,355
13879,Darren,1,Private room,82,0,0.3,82
13880,Ofir,1,Entire home/apt,136,365,0.1,501
13881,Andrew,1,Private room,75,268,2.1,343
13882,Greg,1,Entire home/apt,68,0,0.6,68
13883,Felix,2,Private room,64,18,0.59,82
13884,Pippa,2,Entire home/apt,100,0,0.02,100
13885,Johanna,2,Private room,65,0,0.05,65
13887,Katherine,1,Entire home/apt,450,0,0.03,450
13890,Steven,2,Private room,48,0,0.03,48
13891,Marie-Adele,2,Entire home/apt,85,29,2.5,114
13893,Mike,1,Entire home/apt,180,253,3.45,433
13895,J,2,Entire home/apt,175,0,1.07,175
13896,Dennis,2,Entire home/apt,245,66,0.4,311
13897,Jay,2,Private room,45,0,0.31,45
13898,Mfoniso,3,Private room,34,0,0.02,34
13900,Michael,2,Entire home/apt,75,195,3.79,270
13901,Kara,2,Entire home/apt,125,316,3.27,441
13902,Stanton,1,Entire home/apt,200,342,0.22,542
13903,Karol,3,Entire home/apt,100,0,0.13,100
13904,Bianca,1,Entire home/apt,70,38,0.33,108
13906,Gosia,2,Entire home/apt,154,289,3.01,443
13907,Emma,1,Entire home/apt,300,358,0.04,658
13908,Suzette,1,Entire home/apt,250,329,2.13,579
13909,Sonia,1,Entire home/apt,140,242,1.65,382
13910,David,1,Private room,59,0,0.61,59
13911,John,1,Private room,80,63,2.43,143
13912,Maryla,2,Entire home/apt,230,26,0.94,256
13913,Carolina,1,Entire home/apt,150,0,0.11,150
13914,Angela,3,Private room,45,337,1.94,382
13915,Ashley,2,Entire home/apt,144,0,0.02,144
13916,Nick,2,Private room,44,0,1.3,44
13918,Brittni,2,Private room,45,29,0.62,74
13919,Gurdane,1,Private room,129,0,0.27,129
13920,Rob,1,Private room,75,0,0.02,75
13921,Eej,2,Entire home/apt,220,354,0.31,574
13922,Guillermo,2,Entire home/apt,125,37,3.5,162
13923,Eej,2,Entire home/apt,150,326,0.47,476
13924,Madeline,1,Private room,63,0,0.07,63
13929,Samantha,1,Entire home/apt,450,0,0.05,450
13931,Vincent,2,Private room,36,0,0.02,36
13932,Sarah,2,Private room,48,0,0.1,48
13933,Carol,2,Private room,50,365,0.92,415
13934,Christina,3,Private room,59,3,0.99,62
13935,Anjulika,2,Private room,39,0,0.02,39
13936,Joel,1,Entire home/apt,70,0,0.1,70
13938,Alison,2,Entire home/apt,100,0,0.05,100
13940,Mark,2,Entire home/apt,125,171,1.81,296
13942,Lisa,2,Private room,45,0,0.03,45
13943,Jeniffer,1,Entire home/apt,185,332,0.21,517
13944,Moss,2,Private room,60,0,0.46,60
13945,Jonny,2,Private room,40,0,0.02,40
13946,Moss,2,Private room,80,0,0.85,80
13948,Ildiko,2,Entire home/apt,135,241,3.18,376
13949,Anna,1,Private room,70,311,2.23,381
13950,Lily,2,Entire home/apt,600,67,0.17,667
13951,Mark,1,Private room,110,0,0.03,110
13952,Paige,2,Entire home/apt,105,0,0.14,105
13953,Nata,1,Private room,100,19,2.08,119
13954,Drew,2,Private room,65,0,0.21,65
13955,Amanda,1,Entire home/apt,125,22,1.29,147
13956,Claire,2,Private room,50,179,0.92,229
13957,Luigi,2,Entire home/apt,360,201,0.18,561
13958,Jason & Carlos,2,Entire home/apt,160,11,0.4,171
13961,Sabrina And Antoine,1,Entire home/apt,175,126,0.7,301
13963,John,2,Shared room,79,180,0.43,259
13964,Joseph,2,Private room,90,60,1.34,150
13965,Antonella,2,Entire home/apt,283,234,2.34,517
13968,Brooklyn&   Breakfast    -Len-,2,Private room,70,313,5.87,383
13969,Antonella,2,Entire home/apt,199,242,1.31,441
13970,Shawn,2,Private room,45,286,0.77,331
13971,Dino,1,Private room,325,88,0.23,413
13973,Jeniffer,1,Entire home/apt,130,331,0.15,461
13974,Eli,1,Entire home/apt,179,252,3.3,431
13975,Erika,1,Private room,80,332,0.28,412
13976,Mary Sue,1,Private room,99,57,1.62,156
13977,Brenn,1,Entire home/apt,135,0,0.39,135
13978,Hatim,2,Entire home/apt,145,0,1.0,145
13979,Matt,2,Entire home/apt,69,0,1.16,69
13981,Nadine,1,Private room,75,0,0.5,75
13983,Kesang,3,Private room,55,297,1.28,352
13985,Valeria,2,Entire home/apt,75,15,4.04,90
13986,Jerome,1,Entire home/apt,90,0,0.07,90
13987,Louise,2,Entire home/apt,98,273,2.59,371
13988,Cassy,1,Entire home/apt,70,0,0.81,70
13990,Michael,2,Private room,50,47,1.79,97
13991,Jeremy & Laura,1,Entire home/apt,250,331,0.13,581
13993,Shelby,1,Entire home/apt,99,0,1.05,99
13994,Claudia,2,Private room,77,343,1.88,420
13996,De & Claudia,3,Entire home/apt,130,352,1.27,482
13997,Rob,2,Private room,60,0,0.03,60
13998,Jennifer,1,Entire home/apt,200,245,5.01,445
13999,Marion,2,Entire home/apt,117,1,0.43,118
14000,Sharra,2,Entire home/apt,89,0,0.02,89
14001,Rob,2,Private room,44,297,0.75,341
14002,Betsy,1,Private room,70,312,0.03,382
14003,Marcin,1,Private room,39,0,0.1,39
14004,Rosa,1,Entire home/apt,150,0,0.36,150
14007,Cindy,1,Private room,89,0,0.21,89
14008,Gina,1,Entire home/apt,200,205,1.14,405
14009,Judene,2,Entire home/apt,124,104,2.45,228
14012,Ted,2,Entire home/apt,100,0,0.19,100
14013,Jeremy & Laura,1,Entire home/apt,117,198,0.07,315
14015,Connie,2,Private room,50,0,0.07,50
14016,Romany,2,Private room,75,93,0.11,168
14017,Siobhán,2,Private room,75,0,0.07,75
14018,Adam,2,Entire home/apt,75,0,0.02,75
14020,William,2,Private room,65,0,0.04,65
14021,Jessica And Danny,3,Shared room,22,0,0.34,22
14023,Teddy,1,Entire home/apt,320,142,0.18,462
14026,Terra,1,Entire home/apt,115,0,0.09,115
14027,Sarah,1,Entire home/apt,120,0,0.05,120
14030,Celine,2,Entire home/apt,425,0,0.05,425
14031,Karolina,2,Entire home/apt,75,123,4.47,198
14032,Thomas,2,Entire home/apt,150,0,0.57,150
14033,Sandra And Cary,2,Private room,49,269,0.54,318
14034,Valissa,1,Entire home/apt,165,351,0.21,516
14036,Lacy,1,Entire home/apt,175,0,0.03,175
14037,Kara & Tyler,2,Private room,97,9,5.02,106
14038,Jane,1,Entire home/apt,270,15,4.14,285
14039,Sandrine,2,Entire home/apt,155,223,3.74,378
14041,Joel & Renee,1,Private room,80,133,1.79,213
14042,Vian,4,Private room,70,0,0.03,70
14043,Julio,3,Private room,35,0,0.02,35
14044,Ellie,1,Entire home/apt,110,0,0.07,110
14045,Gal,1,Entire home/apt,129,328,0.11,457
14046,Brian,2,Private room,45,134,4.11,179
14047,Tyler,1,Private room,50,0,0.05,50
14048,Riah,2,Private room,105,0,0.69,105
14049,Justin,2,Private room,45,80,0.34,125
14050,Eugene,1,Private room,83,1,0.37,84
14051,Candace,1,Shared room,40,173,1.35,213
14053,Martin,1,Entire home/apt,400,261,3.0,661
14054,Pika,1,Private room,64,40,1.28,104
14055,Joseph F,1,Entire home/apt,130,13,0.45,143
14057,Nia,1,Entire home/apt,200,364,0.03,564
14058,Chantelle,3,Entire home/apt,200,354,1.23,554
14060,Adriana,3,Private room,60,280,1.57,340
14061,Neida,1,Private room,60,82,3.16,142
14062,Helen,1,Entire home/apt,80,0,0.02,80
14064,Mike,2,Entire home/apt,125,0,0.02,125
14066,Maria,1,Private room,80,140,1.72,220
14068,Alisha,2,Entire home/apt,50,0,0.04,50
14069,Ghe,2,Private room,37,0,0.46,37
14070,Ohad,1,Entire home/apt,200,0,0.03,200
14071,Mar,2,Private room,65,0,0.24,65
14072,Mikael,1,Private room,130,355,0.79,485
14073,Uri,2,Entire home/apt,95,0,0.08,95
14074,Ninell,2,Private room,54,316,1.52,370
14076,Ryan,1,Entire home/apt,105,0,0.08,105
14077,Maggie,2,Shared room,30,189,0.14,219
14079,Xin,1,Private room,45,0,0.05,45
14082,Michael,1,Entire home/apt,219,341,2.46,560
14084,Karen,2,Shared room,25,349,2.9,374
14085,Karen,1,Entire home/apt,250,0,0.08,250
14088,Christopher,3,Private room,90,358,0.09,448
14089,Douglas,2,Private room,87,10,2.74,97
14092,Sj,2,Entire home/apt,225,350,0.26,575
14093,Setareh,1,Private room,45,0,0.15,45
14094,Gregory,2,Entire home/apt,129,0,0.12,129
14096,Gretta J.,2,Entire home/apt,120,0,0.12,120
14097,Barry,4,Private room,35,11,1.81,46
14098,Ben,1,Entire home/apt,200,0,0.03,200
14099,Janice,2,Entire home/apt,100,318,2.17,418
14101,Lindsey,2,Private room,122,0,0.82,122
14104,Darius,2,Entire home/apt,120,0,0.02,120
14105,Serafima,1,Entire home/apt,150,174,0.3,324
14107,Fiona,2,Entire home/apt,110,312,0.03,422
14108,Nick,1,Entire home/apt,245,184,1.49,429
14113,Raanan,1,Entire home/apt,110,333,0.06,443
14114,Courtney,2,Private room,33,0,0.02,33
14115,Ronit,2,Entire home/apt,98,342,3.1,440
14116,Cyrus,1,Entire home/apt,133,0,0.05,133
14117,Alex,2,Private room,45,0,0.02,45
14118,Alvaro,2,Private room,65,0,0.05,65
14120,Debbie,2,Private room,80,0,0.15,80
14123,Ali,2,Entire home/apt,149,0,1.08,149
14125,Neta,1,Private room,150,363,0.43,513
14126,April,2,Private room,35,0,0.06,35
14127,Laurène,1,Private room,36,0,0.08,36
14128,Robert,1,Private room,45,90,1.32,135
14130,David,1,Private room,90,0,0.03,90
14131,Marissa,2,Private room,68,0,1.1,68
14132,Nic,2,Private room,36,0,0.03,36
14133,Nathaniel,2,Private room,34,349,0.17,383
14135,Faizal,2,Entire home/apt,135,0,0.03,135
14136,Paul,1,Private room,128,235,0.85,363
14137,Chaz,1,Private room,40,0,0.44,40
14139,Kathleen,2,Entire home/apt,155,251,3.94,406
14140,Jennifer,3,Private room,50,211,1.21,261
14141,Erin,2,Private room,40,0,2.88,40
14142,Miriam,2,Entire home/apt,250,243,3.22,493
14143,Anna,1,Entire home/apt,295,0,0.18,295
14144,Zamena,3,Entire home/apt,145,302,1.52,447
14148,Adil,1,Entire home/apt,175,0,0.02,175
14150,Christopher,3,Private room,89,0,0.1,89
14152,Cory,2,Entire home/apt,350,86,0.05,436
14153,Michelange,1,Entire home/apt,105,0,0.4,105
14154,Samantha,2,Entire home/apt,185,105,3.12,290
14155,Kaya,1,Entire home/apt,195,103,3.26,298
14156,Kunjan,1,Entire home/apt,135,0,0.13,135
14160,Shakima,2,Private room,45,339,0.78,384
14161,Anna,1,Entire home/apt,199,0,0.05,199
14162,Karen,1,Entire home/apt,125,0,1.88,125
14163,Jabari,4,Entire home/apt,109,58,1.51,167
14165,Cathy,2,Entire home/apt,150,0,0.03,150
14166,West Village,1,Entire home/apt,1100,313,0.12,1413
14168,Jesse,1,Private room,119,66,3.42,185
14169,Jenna,1,Private room,70,0,0.05,70
14170,Ergie,1,Private room,100,66,3.55,166
14171,Lauren,1,Entire home/apt,250,0,0.22,250
14172,Cristina,1,Entire home/apt,150,0,0.4,150
14176,Max,1,Shared room,35,320,0.08,355
14177,David,1,Entire home/apt,200,365,0.38,565
14178,Jon,1,Private room,99,0,1.6,99
14180,Kevin,1,Entire home/apt,170,63,0.45,233
14181,Keith,1,Entire home/apt,399,12,0.25,411
14184,Nessa,2,Private room,55,0,0.17,55
14185,Devon,2,Private room,40,0,0.22,40
14186,Hannah,2,Private room,55,0,0.07,55
14187,Lior,1,Entire home/apt,140,365,0.08,505
14188,Alex,3,Private room,71,291,2.76,362
14189,Weisbrod,2,Entire home/apt,177,363,0.6,540
14190,Désirée,1,Entire home/apt,395,279,1.41,674
14191,Min,1,Private room,80,87,0.11,167
14192,Kate,1,Entire home/apt,198,267,1.07,465
14193,Sabina,1,Entire home/apt,199,0,0.16,199
14194,Carol,3,Entire home/apt,97,290,6.08,387
14195,Frank,2,Entire home/apt,162,18,0.64,180
14196,Rose,4,Entire home/apt,99,311,0.07,410
14198,Mark,1,Private room,65,0,0.02,65
14199,Paulo,1,Private room,150,32,1.85,182
14200,Lindsey,2,Private room,35,0,0.05,35
14201,Ariel,2,Private room,30,0,0.02,30
14202,Jayson,1,Private room,50,209,2.57,259
14203,Angela,1,Private room,40,0,0.11,40
14204,A.J.,1,Entire home/apt,259,122,0.14,381
14205,Katherine,1,Private room,125,87,0.07,212
14206,Sherrilyn,2,Shared room,85,365,0.11,450
14207,Liz,1,Entire home/apt,160,4,1.23,164
14208,Tracy,2,Entire home/apt,450,9,0.06,459
14209,Ann,2,Entire home/apt,90,64,0.45,154
14210,Giuseppa,3,Entire home/apt,140,32,2.09,172
14212,Lisa-Marie,1,Private room,85,0,0.02,85
14213,Nina,1,Private room,79,321,0.74,400
14214,Rubi,2,Entire home/apt,76,0,0.05,76
14216,Annie,2,Entire home/apt,150,0,0.17,150
14217,Peter,3,Entire home/apt,175,0,0.54,175
14219,Karina,3,Entire home/apt,90,0,0.12,90
14220,Victoria,2,Entire home/apt,92,0,0.63,92
14223,Hannah,2,Private room,64,21,0.07,85
14224,Matt,1,Entire home/apt,90,0,0.03,90
14225,Molly,1,Entire home/apt,200,112,0.65,312
14226,Tecla,1,Entire home/apt,150,190,0.22,340
14229,Balla,1,Private room,60,83,2.43,143
14230,Brooklyn&   Breakfast    -Len-,2,Private room,65,339,5.87,404
14231,Allison,3,Private room,70,89,1.66,159
14232,Jessica,2,Entire home/apt,162,22,1.06,184
14233,Ali,1,Entire home/apt,250,0,0.13,250
14234,James  And  Mina,2,Private room,75,354,0.47,429
14235,Charles,4,Entire home/apt,95,144,4.98,239
14236,Deirdre,2,Private room,75,227,3.36,302
14237,Amy,3,Private room,60,67,3.07,127
14238,Jack,1,Entire home/apt,189,23,0.23,212
14241,Courtney,2,Entire home/apt,190,0,1.66,190
14242,Jenna,2,Private room,50,0,0.02,50
14243,Somar,1,Entire home/apt,814,353,0.78,1167
14244,Chantal,1,Private room,100,0,0.03,100
14245,Patricia,2,Entire home/apt,125,37,3.86,162
14246,Mathieu,2,Private room,90,0,0.44,90
14249,Jonathan,1,Entire home/apt,300,176,0.64,476
14250,Yair,2,Entire home/apt,145,235,3.62,380
14251,Dee,1,Private room,65,0,0.3,65
14252,Natalie,1,Entire home/apt,150,0,0.03,150
14254,Lior,1,Entire home/apt,80,356,0.07,436
14255,Peter,1,Entire home/apt,200,67,0.17,267
14256,Eliahu,1,Private room,69,365,3.16,434
14257,Richard,1,Entire home/apt,150,7,1.26,157
14258,Bond,1,Entire home/apt,79,290,3.63,369
14259,Dasha,2,Entire home/apt,219,275,2.93,494
14260,Sarah,1,Entire home/apt,199,39,1.64,238
14263,Jada,1,Entire home/apt,550,267,1.44,817
14265,Ofer,1,Entire home/apt,90,0,0.22,90
14266,Victoria,1,Private room,70,0,0.02,70
14267,Victoria,1,Private room,70,0,0.05,70
14270,Ross,1,Private room,150,0,0.05,150
14271,Paul,1,Entire home/apt,200,0,0.8,200
14272,Alice,1,Entire home/apt,145,0,0.05,145
14273,Jonathan,2,Private room,79,2,3.26,81
14274,Lilly,1,Private room,95,88,0.14,183
14275,Pengfei,3,Private room,55,21,2.92,76
14276,Xolie,2,Entire home/apt,207,1,1.49,208
14277,Andy,1,Private room,83,80,3.55,163
14278,David,1,Private room,50,113,2.54,163
14280,Pat,1,Entire home/apt,200,165,3.19,365
14281,Apollo,1,Private room,100,303,0.46,403
14282,Joseph,2,Entire home/apt,119,111,3.75,230
14283,Xolie,2,Entire home/apt,175,331,1.45,506
14284,Brian,2,Private room,49,59,2.96,108
14286,Kevin,1,Entire home/apt,110,348,5.53,458
14288,Shpresa,1,Entire home/apt,500,249,1.23,749
14289,Samaa,2,Entire home/apt,180,185,0.91,365
14290,Charlie,2,Entire home/apt,145,47,4.66,192
14293,Artie,1,Private room,57,247,2.26,304
14294,Lamee,2,Entire home/apt,98,140,0.32,238
14295,Natalie,1,Entire home/apt,120,0,0.86,120
14296,Annette,3,Entire home/apt,100,0,0.03,100
14297,Chandni,1,Private room,90,0,0.14,90
14298,Matt,2,Entire home/apt,85,0,0.03,85
14299,Shay,2,Entire home/apt,120,0,0.22,120
14300,Alessandro,1,Entire home/apt,180,0,0.59,180
14302,Carlo,1,Entire home/apt,90,6,0.18,96
14303,Han Sheng,1,Entire home/apt,250,0,0.14,250
14304,Jodi,3,Private room,50,0,0.41,50
14307,Valentina,2,Entire home/apt,90,71,0.83,161
14308,Kai,2,Entire home/apt,165,43,3.08,208
14309,Emily,2,Private room,70,0,0.07,70
14310,Shully'S,4,Entire home/apt,90,319,5.0,409
14311,Adam,2,Entire home/apt,109,0,0.08,109
14312,Lex And Raun,2,Entire home/apt,96,256,1.58,352
14313,Daniel,2,Entire home/apt,390,13,0.36,403
14314,Stephen,2,Entire home/apt,78,0,0.02,78
14315,Louise,2,Private room,50,0,0.03,50
14317,Fla,1,Private room,112,0,0.02,112
14318,Jeremy & Laura,1,Entire home/apt,117,327,0.13,444
14319,Brooklyn&   Breakfast    -Len-,2,Private room,50,286,6.23,336
14321,Jeremy,2,Entire home/apt,185,212,0.33,397
14322,Olu,4,Entire home/apt,85,304,3.88,389
14323,Dominik,1,Entire home/apt,235,184,1.63,419
14324,Remi O.,1,Entire home/apt,75,0,0.05,75
14325,Ruchi,1,Entire home/apt,180,364,0.03,544
14326,Maia,1,Entire home/apt,100,0,0.85,100
14329,Annie,1,Private room,125,0,0.15,125
14330,Host,1,Entire home/apt,130,246,0.17,376
14331,Clinton,3,Entire home/apt,99,0,0.44,99
14332,Brandon,2,Private room,40,0,0.12,40
14333,Catherine,1,Private room,120,17,0.89,137
14334,Rochel,2,Entire home/apt,350,274,1.38,624
14335,Johnny,3,Private room,84,69,2.56,153
14336,Mike,1,Entire home/apt,83,311,0.09,394
14337,Megan,2,Entire home/apt,125,0,0.2,125
14340,Ruchi,1,Entire home/apt,138,341,0.05,479
14341,Damian,2,Entire home/apt,100,0,0.11,100
14342,Jeff,1,Private room,150,0,0.92,150
14343,Dominik,1,Private room,90,0,0.12,90
14344,Tny,1,Entire home/apt,154,18,0.22,172
14345,Maurice,2,Private room,75,67,0.85,142
14346,Ariel,1,Entire home/apt,110,337,0.28,447
14347,Martin,3,Private room,129,250,1.27,379
14348,Joannie,2,Entire home/apt,190,288,0.62,478
14349,Jase,1,Entire home/apt,185,233,5.83,418
14350,Sharda,1,Private room,108,51,1.18,159
14351,Dominik,1,Private room,98,0,0.24,98
14353,Norga,2,Entire home/apt,145,271,3.23,416
14354,Samantha,1,Entire home/apt,125,0,0.47,125
14355,Austin,2,Private room,85,0,0.02,85
14356,Douglas,4,Entire home/apt,89,104,4.52,193
14359,Antoine,2,Private room,43,305,0.25,348
14360,Ella,2,Private room,40,0,0.03,40
14361,Apollo,1,Private room,200,333,0.21,533
14362,Jay,1,Private room,40,177,0.27,217
14365,Cristina,1,Entire home/apt,75,0,0.02,75
14367,David,1,Entire home/apt,199,0,0.25,199
14368,Cam,2,Private room,70,0,0.05,70
14369,Michael,2,Private room,33,231,4.08,264
14370,Thomas,1,Private room,90,0,0.07,90
14372,Kandee,1,Entire home/apt,229,283,3.9,512
14373,Suguna,2,Private room,34,0,0.05,34
14374,April,1,Entire home/apt,115,0,0.18,115
14375,David,2,Entire home/apt,171,293,4.87,464
14376,Herman,3,Private room,50,344,0.25,394
14378,Paulette,3,Private room,40,336,9.26,376
14379,Joyce,3,Private room,37,330,0.45,367
14380,Julien,3,Shared room,1800,90,0.13,1890
14381,Fely,2,Private room,36,0,0.53,36
14382,Zach,2,Private room,65,0,0.03,65
14384,Megan,1,Entire home/apt,135,0,0.62,135
14385,Jess,1,Entire home/apt,2000,75,0.06,2075
14387,Abigail,1,Entire home/apt,160,0,0.02,160
14389,Adrienne,1,Entire home/apt,140,0,0.18,140
14390,Caroll,2,Private room,69,317,0.57,386
14391,Jocelyn,1,Entire home/apt,125,0,0.05,125
14392,Jonty,1,Entire home/apt,700,266,2.12,966
14393,Dom,2,Private room,64,0,0.27,64
14394,Nicholas,2,Entire home/apt,250,0,0.38,250
14395,Felix,1,Private room,30,0,0.02,30
14396,Melanie,4,Private room,100,0,1.32,100
14400,Diana Mia,1,Entire home/apt,145,236,1.43,381
14402,Rick,2,Entire home/apt,70,203,0.47,273
14403,Hannah,1,Private room,70,283,2.93,353
14404,Andrea,1,Entire home/apt,168,0,0.02,168
14405,Bettina,2,Entire home/apt,195,15,0.14,210
14406,Juliana,1,Entire home/apt,250,0,0.15,250
14408,Nina,2,Entire home/apt,75,0,0.24,75
14411,Nina,2,Private room,50,243,0.25,293
14412,Matt,1,Private room,85,0,0.11,85
14413,Dorien,2,Private room,28,0,0.12,28
14414,Diane,1,Private room,60,271,1.2,331
14416,Matt,1,Entire home/apt,165,13,0.19,178
14417,Maria,1,Entire home/apt,145,0,0.02,145
14418,DaKyung,1,Entire home/apt,125,88,0.12,213
14419,Gabriella,1,Entire home/apt,250,0,0.02,250
14420,Iquo,2,Entire home/apt,69,0,0.34,69
14421,Rachel,1,Entire home/apt,140,8,0.13,148
14422,Brooklyn&   Breakfast    -Len-,2,Private room,250,0,0.63,250
14425,Lou,3,Private room,60,0,1.82,60
14426,Scott,2,Private room,30,0,0.05,30
14427,Eddy,2,Private room,65,0,0.25,65
14428,Kdn,1,Shared room,29,90,2.28,119
14429,Jeff,1,Private room,65,1,0.1,66
14431,Daniela,1,Entire home/apt,130,53,0.56,183
14433,Allison,2,Private room,50,0,0.03,50
14434,Monique,2,Entire home/apt,160,0,0.1,160
14436,Eric Charles,1,Private room,39,0,0.12,39
14437,Trevor,1,Entire home/apt,145,0,3.63,145
14438,Jazzy,2,Entire home/apt,195,236,3.01,431
14439,Calvin,1,Private room,79,0,0.05,79
14440,Melissa,2,Private room,50,326,0.31,376
14441,Jennyfer,1,Private room,35,31,0.24,66
14442,Lorraine,1,Private room,325,139,3.3,464
14443,Colin,1,Private room,40,0,0.05,40
14444,Charles,2,Entire home/apt,95,27,0.3,122
14446,Jenniffer,1,Private room,43,0,1.98,43
14447,Meg,2,Entire home/apt,225,89,0.28,314
14448,Daniel,1,Entire home/apt,175,0,0.08,175
14450,Kevin,2,Entire home/apt,94,4,0.98,98
14452,Nathaniel,1,Entire home/apt,200,0,0.03,200
14453,Sabia,1,Entire home/apt,95,92,1.85,187
14454,Angel,1,Shared room,65,89,0.67,154
14455,Chris,2,Entire home/apt,349,337,1.07,686
14456,Juliann,2,Private room,41,0,0.1,41
14457,Nate,1,Entire home/apt,200,0,0.03,200
14458,Han And Denyce,2,Entire home/apt,85,246,4.22,331
14460,Jaleelah A.,2,Private room,150,35,0.08,185
14461,Johanna,1,Private room,65,0,0.03,65
14462,Han,1,Private room,110,165,4.42,275
14464,Jay,1,Private room,80,3,1.7,83
14465,Richard,2,Private room,45,0,0.15,45
14466,Lisa,2,Entire home/apt,83,201,2.64,284
14467,Donald,4,Private room,40,276,2.08,316
14468,Diana,2,Private room,79,358,0.94,437
14470,Theresa,1,Entire home/apt,177,175,2.59,352
14472,Andy,1,Entire home/apt,190,0,0.05,190
14473,Ian,1,Entire home/apt,240,0,0.13,240
14474,Mac,1,Entire home/apt,150,0,0.25,150
14475,Will,2,Private room,31,0,0.25,31
14476,Talita,1,Entire home/apt,110,0,0.09,110
14477,Michael,2,Entire home/apt,120,0,0.13,120
14478,Rachel And Bart,2,Entire home/apt,176,54,3.63,230
14479,Conor,1,Entire home/apt,199,0,0.22,199
14483,Magdalena,2,Private room,60,0,0.02,60
14484,Tom & Emma,1,Entire home/apt,140,128,0.2,268
14485,Theresa,2,Entire home/apt,150,0,0.03,150
14487,Elizabeth,2,Private room,55,0,0.3,55
14488,Neriza,1,Entire home/apt,200,36,3.68,236
14489,Tom & Mel,1,Private room,100,235,1.9,335
14490,Marco,3,Entire home/apt,112,0,0.07,112
14492,Sandy,2,Private room,75,0,0.08,75
14493,Eugenia,2,Private room,45,0,0.03,45
14495,Pierce,2,Entire home/apt,160,6,5.08,166
14496,Laurie,3,Entire home/apt,100,0,0.17,100
14497,Kerri,1,Entire home/apt,175,0,0.05,175
14498,Eleena,1,Private room,80,0,0.05,80
14499,Michael,2,Private room,60,3,0.36,63
14500,Jeremy & Laura,1,Entire home/apt,175,312,0.05,487
14501,Say,3,Private room,65,314,0.44,379
14502,Dami,1,Entire home/apt,159,361,1.16,520
14503,Kayan,3,Entire home/apt,118,337,3.77,455
14504,Joseph,3,Entire home/apt,120,303,2.25,423
14505,Tim,1,Private room,91,80,1.1,171
14506,Hadley,2,Entire home/apt,125,0,0.03,125
14507,Amanda,2,Private room,55,0,0.53,55
14508,Nick,1,Entire home/apt,175,0,1.91,175
14510,Amy,1,Entire home/apt,140,256,0.47,396
14512,Waciuma,2,Private room,40,0,0.02,40
14513,Jeremy & Laura,1,Entire home/apt,180,303,0.15,483
14514,Eileen,3,Entire home/apt,110,66,0.84,176
14515,Tessa & Negra,3,Entire home/apt,90,266,2.91,356
14516,Chris,2,Private room,50,0,0.07,50
14517,Remo,2,Entire home/apt,135,281,3.97,416
14518,Geraldine,2,Private room,60,0,0.03,60
14519,Miranda,1,Private room,200,0,0.52,200
14520,Amir,1,Private room,90,8,0.6,98
14522,Dee,1,Entire home/apt,228,0,0.25,228
14523,Paula,1,Entire home/apt,250,0,0.08,250
14524,Annett And Chuck,3,Private room,40,88,0.03,128
14525,Dee,1,Private room,65,185,1.04,250
14526,Ruchi,1,Entire home/apt,188,342,0.06,530
14527,Maria,1,Entire home/apt,130,0,0.02,130
14528,Thais & Antoine,2,Entire home/apt,140,0,1.06,140
14529,Anthony,1,Private room,130,243,1.86,373
14530,Elizabeth,2,Entire home/apt,300,312,0.19,612
14531,Renata,1,Private room,50,162,3.31,212
14532,Laura,2,Entire home/apt,75,0,0.16,75
14533,Host,1,Entire home/apt,200,311,0.49,511
14534,Shae,2,Entire home/apt,250,0,0.15,250
14536,Savannah,2,Entire home/apt,112,291,4.11,403
14538,Jeremy & Laura,1,Entire home/apt,170,312,0.1,482
14539,Daniel,1,Private room,79,0,0.34,79
14541,Jeremy & Laura,1,Entire home/apt,285,311,0.19,596
14543,Zack,1,Private room,110,0,0.64,110
14544,Alberto,2,Entire home/apt,690,169,2.28,859
14545,Lisa,1,Entire home/apt,169,39,2.51,208
14546,Allison,2,Private room,60,0,0.03,60
14547,Eric,2,Private room,70,0,1.12,70
14548,Lugao,1,Private room,150,333,0.53,483
14551,Selim,1,Entire home/apt,160,343,0.48,503
14552,Josh & Madeleine,2,Private room,50,189,5.17,239
14553,Denisse,3,Entire home/apt,120,51,1.76,171
14554,Christopher,2,Entire home/apt,140,0,0.11,140
14555,Dan,2,Entire home/apt,619,54,0.23,673
14556,C.E.,1,Entire home/apt,600,338,0.71,938
14557,James,1,Entire home/apt,76,0,0.05,76
14559,Vidya,1,Shared room,75,0,0.1,75
14560,Grace,3,Private room,40,146,0.87,186
14561,Taniesha,2,Private room,54,333,1.17,387
14562,Ash,1,Entire home/apt,140,110,1.1,250
14564,Lendy,1,Private room,87,332,0.23,419
14565,Luis And Oriana,1,Entire home/apt,131,317,1.18,448
14567,Shai,1,Entire home/apt,450,329,0.33,779
14568,Renata And Howard,2,Entire home/apt,175,67,3.32,242
14569,Adam,1,Entire home/apt,100,0,0.03,100
14571,Ana,1,Private room,280,317,1.47,597
14572,Attika,2,Entire home/apt,135,365,0.64,500
14574,Bruce,1,Entire home/apt,1100,268,0.53,1368
14575,Denisse,3,Entire home/apt,87,58,2.13,145
14576,Amal & Emad,1,Entire home/apt,165,278,1.49,443
14577,Rupert,2,Entire home/apt,170,0,0.3,170
14579,John,4,Entire home/apt,79,365,0.18,444
14580,Andrea,1,Private room,84,23,0.36,107
14581,Neil,1,Entire home/apt,375,0,0.14,375
14582,Katy,1,Entire home/apt,135,0,0.83,135
14583,Daniel,2,Private room,125,0,0.17,125
14584,Joseph,2,Private room,79,0,0.41,79
14585,Ray,1,Entire home/apt,165,35,2.58,200
14586,Diana,1,Entire home/apt,300,201,0.03,501
14587,Cleo,1,Private room,45,0,0.05,45
14588,Host,1,Entire home/apt,400,188,0.06,588
14589,Afnan,2,Private room,40,0,0.05,40
14590,Mo,1,Private room,60,0,0.05,60
14591,Marta,1,Private room,250,198,4.42,448
14593,Peter,1,Entire home/apt,199,48,2.28,247
14594,Therese,2,Entire home/apt,130,0,1.06,130
14595,Ari,1,Private room,44,335,0.35,379
14596,Noah,1,Entire home/apt,200,0,0.12,200
14597,Erjon,3,Entire home/apt,90,0,0.02,90
14600,Tida,1,Entire home/apt,120,303,1.27,423
14601,Melissa,2,Entire home/apt,100,0,0.09,100
14604,Emily,2,Entire home/apt,100,0,0.02,100
14606,Robina,2,Entire home/apt,200,0,0.03,200
14607,Gautam,1,Private room,89,80,0.4,169
14608,Ashley,2,Private room,75,0,0.03,75
14610,Val,1,Private room,90,361,0.95,451
14611,Vinciane,1,Private room,190,38,1.42,228
14612,Jennifer,1,Entire home/apt,150,300,2.95,450
14613,Juliana,1,Entire home/apt,85,311,0.17,396
14614,Zachary,1,Private room,65,0,0.35,65
14615,Juliana,1,Entire home/apt,110,252,0.18,362
14616,Lynn,1,Shared room,70,55,5.44,125
14617,Pedro,2,Private room,55,0,0.25,55
14619,Calvin,1,Private room,59,0,0.02,59
14620,Emilie,2,Entire home/apt,200,0,0.1,200
14621,Tamir,1,Private room,85,0,0.03,85
14623,Sarah,3,Entire home/apt,158,0,0.03,158
14624,Liz,2,Private room,35,0,0.06,35
14625,Chris And Zach,2,Private room,57,89,5.2,146
14626,Jay,1,Entire home/apt,138,265,0.5,403
14627,Terrence,1,Entire home/apt,90,39,4.87,129
14628,Aswad,2,Entire home/apt,125,354,0.99,479
14629,John,2,Entire home/apt,999,361,2.85,1360
14630,Rae,1,Entire home/apt,225,0,0.1,225
14632,Teddy,1,Private room,150,0,0.91,150
14633,Darren,1,Entire home/apt,150,0,0.1,150
14634,Emily,1,Entire home/apt,140,0,0.2,140
14635,Renuca,3,Private room,40,318,0.33,358
14638,Anna,1,Private room,110,67,1.8,177
14639,Iwona,3,Entire home/apt,150,80,7.38,230
14642,Dan,2,Entire home/apt,115,126,1.11,241
14644,Kate,1,Entire home/apt,190,158,0.67,348
14645,Louise,3,Private room,60,0,0.05,60
14647,Gabriel,3,Entire home/apt,90,0,0.7,90
14649,Val,2,Entire home/apt,115,20,0.89,135
14652,David,1,Entire home/apt,135,0,0.03,135
14655,Raquel,2,Entire home/apt,148,275,1.96,423
14656,Luke,1,Private room,95,49,2.0,144
14657,Josh & Madeleine,2,Private room,50,189,4.72,239
14658,Raquel,2,Entire home/apt,79,250,2.42,329
14659,Das,2,Private room,50,0,0.27,50
14660,Hector,1,Private room,40,0,0.02,40
14661,Hiershenee B.,1,Entire home/apt,101,0,0.4,101
14662,Lloyd,2,Entire home/apt,135,281,1.6,416
14666,Bridget,1,Entire home/apt,299,0,0.19,299
14667,Arthur,1,Private room,79,0,0.1,79
14670,Shahla,2,Entire home/apt,295,326,0.07,621
14672,CRNY Monthly Rentals,1,Entire home/apt,110,126,0.14,236
14673,CRNY Monthly Rentals,1,Entire home/apt,215,125,0.06,340
14674,Sotira,2,Entire home/apt,100,365,0.14,465
14676,Octavio,2,Entire home/apt,95,32,0.28,127
14677,Kevin,2,Entire home/apt,140,30,3.23,170
14681,Ruchi,1,Entire home/apt,297,311,0.03,608
14682,Corporate Housing,1,Entire home/apt,133,311,0.22,444
14684,Martín,1,Private room,250,0,0.07,250
14685,Joe,3,Private room,65,0,0.03,65
14686,Madeline,2,Private room,50,0,0.07,50
14687,Jeremy & Laura,1,Entire home/apt,135,313,0.06,448
14688,Javier,2,Private room,80,12,1.91,92
14689,Ramond,2,Private room,69,91,1.9,160
14690,Jay,1,Private room,75,271,1.04,346
14691,Jasmin,2,Entire home/apt,125,0,0.2,125
14692,Corporate Housing,1,Entire home/apt,142,342,0.15,484
14695,Gordon,1,Private room,97,18,3.04,115
14696,Kris,1,Entire home/apt,229,0,0.02,229
14697,Niket,1,Entire home/apt,175,273,1.41,448
14698,Chris,2,Private room,63,0,0.02,63
14699,Maya,3,Private room,45,159,10.19,204
14700,Corporate Housing,1,Entire home/apt,185,0,0.08,185
14701,Jibari,1,Shared room,50,216,1.65,266
14702,Corporate Housing,1,Entire home/apt,175,161,0.16,336
14703,Corporate Housing,1,Entire home/apt,133,312,0.2,445
14704,Reina,2,Private room,62,260,5.28,322
14705,Martin,3,Private room,90,346,0.99,436
14706,Stefan,2,Private room,99,66,1.15,165
14707,Lisa,2,Private room,61,43,0.09,104
14708,Frankie,3,Entire home/apt,120,139,6.78,259
14709,Funda,3,Private room,100,32,2.67,132
14710,常春,1,Shared room,32,332,0.83,364
14711,Sara,1,Private room,80,0,0.31,80
14712,Alanna,2,Entire home/apt,90,0,0.14,90
14714,Elena,1,Private room,65,0,0.05,65
14715,Carmel,4,Private room,49,340,0.05,389
14716,Elena,1,Entire home/apt,100,0,0.03,100
14717,Emily & Joseph,2,Entire home/apt,380,290,1.94,670
14719,Anjela,1,Entire home/apt,100,0,0.06,100
14720,Luc,1,Private room,90,0,0.04,90
14722,Shanthi,4,Private room,35,155,0.49,190
14723,Paul,2,Private room,66,0,0.02,66
14724,Victoria,1,Private room,285,365,1.39,650
14725,Yilin,1,Private room,46,0,0.05,46
14726,Sameer,1,Entire home/apt,275,0,0.1,275
14728,Brandi,1,Entire home/apt,250,0,0.03,250
14729,Nicoletta,2,Entire home/apt,200,50,1.24,250
14730,Sheena,2,Entire home/apt,175,4,0.39,179
14731,Shasta,1,Entire home/apt,140,98,3.63,238
14732,Corporate Housing,1,Entire home/apt,133,311,0.26,444
14733,Corporate Housing,1,Entire home/apt,150,206,0.26,356
14734,Niki,3,Private room,55,180,3.13,235
14735,Corporate Housing,1,Entire home/apt,142,157,0.25,299
14736,Alexander,1,Entire home/apt,95,0,0.02,95
14738,Anthony,2,Entire home/apt,150,0,0.18,150
14739,Bill & May,1,Private room,99,365,0.07,464
14740,Corporate Housing,1,Entire home/apt,133,310,0.21,443
14741,Jenna,2,Entire home/apt,150,264,3.32,414
14742,Andrea,3,Entire home/apt,190,0,0.03,190
14744,Catherine,2,Entire home/apt,106,26,0.18,132
14746,Stuart,2,Entire home/apt,190,229,4.51,419
14748,Michael,4,Entire home/apt,150,37,1.45,187
14750,Wei,1,Entire home/apt,119,0,0.03,119
14751,Josh & Madeleine,2,Private room,62,189,6.02,251
14752,Imran,1,Private room,99,0,0.16,99
14753,Nicole,2,Private room,34,78,3.1,112
14754,George,1,Entire home/apt,129,26,2.07,155
14755,Laura,2,Entire home/apt,105,1,0.25,106
14758,Valery,1,Entire home/apt,205,331,1.76,536
14759,Peter,3,Private room,85,330,0.38,415
14761,Corporate Housing,1,Entire home/apt,150,311,0.27,461
14762,Giovanni,1,Entire home/apt,186,0,4.17,186
14764,Drew,2,Entire home/apt,200,0,0.31,200
14765,Jillian,1,Entire home/apt,172,34,0.37,206
14766,Jeremy & Laura,1,Entire home/apt,250,333,0.04,583
14767,Corporate Housing,1,Entire home/apt,133,311,0.15,444
14768,Ofir,1,Entire home/apt,150,220,0.1,370
14769,Mike,1,Entire home/apt,290,19,1.53,309
14770,Liz,3,Entire home/apt,120,0,0.1,120
14771,Josue,4,Entire home/apt,95,16,5.65,111
14772,Sandro,1,Entire home/apt,120,0,0.03,120
14773,Nissim,1,Entire home/apt,165,262,3.54,427
14775,Franco,1,Entire home/apt,180,0,0.25,180
14777,Katrina,2,Entire home/apt,85,190,0.98,275
14778,J. Ryan,1,Entire home/apt,145,0,0.07,145
14779,Anthony,2,Private room,29,0,3.54,29
14780,Sophia,2,Entire home/apt,120,0,0.16,120
14781,Corporate Housing,1,Entire home/apt,117,173,0.27,290
14782,Genevieve,2,Entire home/apt,70,0,0.03,70
14784,Beverly,2,Entire home/apt,115,0,0.11,115
14785,Sal,2,Entire home/apt,225,124,2.74,349
14786,Tny,1,Entire home/apt,140,57,0.3,197
14787,Denise,4,Private room,45,0,0.15,45
14788,Alexandre,1,Private room,119,0,0.42,119
14789,Corporate Housing,1,Entire home/apt,125,343,0.23,468
14792,Sarah,2,Entire home/apt,150,0,0.03,150
14793,Anna,1,Entire home/apt,120,34,0.5,154
14794,Chadanut,2,Private room,45,23,2.68,68
14795,Myra,2,Private room,115,3,1.05,118
14797,Daisy,1,Entire home/apt,110,0,0.03,110
14798,Kelly,2,Entire home/apt,250,1,0.15,251
14799,Robert,2,Entire home/apt,300,29,1.18,329
14800,Native,3,Private room,45,145,1.27,190
14801,Corporate Housing,1,Entire home/apt,159,190,0.37,349
14802,Ira,1,Entire home/apt,220,2,0.12,222
14803,Corporate Housing,1,Entire home/apt,159,312,0.14,471
14804,John,1,Entire home/apt,70,49,3.55,119
14805,Jordan,2,Private room,45,0,0.05,45
14807,Belkis,1,Private room,81,90,2.7,171
14808,Doris,1,Entire home/apt,190,323,1.17,513
14809,Bryan,1,Entire home/apt,225,42,0.96,267
14811,Brandon,1,Entire home/apt,125,5,2.63,130
14812,Rebecca,3,Entire home/apt,95,0,0.03,95
14813,Iliana,3,Entire home/apt,62,0,0.29,62
14814,Diva,1,Entire home/apt,150,157,0.42,307
14815,Jonathan,2,Entire home/apt,495,21,0.27,516
14816,Ron,1,Entire home/apt,130,16,1.87,146
14817,Ali,2,Private room,80,300,0.18,380
14818,Aram,2,Private room,89,114,5.07,203
14820,Michael,1,Entire home/apt,140,63,4.56,203
14821,孙浩,1,Private room,60,0,0.03,60
14822,Corporate Housing,1,Entire home/apt,142,357,0.19,499
14823,Corporate Housing,1,Entire home/apt,125,105,0.32,230
14824,Corporate Housing,1,Entire home/apt,133,281,0.21,414
14825,Jill,2,Entire home/apt,200,310,1.27,510
14826,Austin,2,Entire home/apt,85,0,0.07,85
14827,Stephen,1,Entire home/apt,625,130,0.47,755
14828,Thikshan,1,Private room,100,44,0.82,144
14829,Joel,2,Entire home/apt,176,236,0.31,412
14830,Teresa,1,Entire home/apt,175,116,5.71,291
14831,Jeffrey And Anna Rita,5,Entire home/apt,75,155,2.04,230
14833,Corporate Housing,1,Entire home/apt,125,157,0.29,282
14834,Corporate Housing,1,Entire home/apt,159,310,0.11,469
14836,Corporate Housing,1,Entire home/apt,150,188,0.18,338
14837,Alex,2,Entire home/apt,99,364,2.22,463
14838,Dellasie,2,Private room,49,4,2.16,53
14839,Gary,2,Private room,140,268,3.63,408
14840,Jessica,2,Entire home/apt,200,9,0.09,209
14841,Julia,1,Entire home/apt,148,0,0.13,148
14842,Corporate Housing,1,Entire home/apt,165,142,0.28,307
14843,Melissa,2,Private room,59,361,0.82,420
14844,Melissa,2,Private room,45,335,0.43,380
14845,Melissa,2,Private room,45,334,0.43,379
14846,Sarah,1,Entire home/apt,225,0,0.63,225
14847,Daniel,1,Private room,70,40,1.36,110
14848,Demetra,3,Entire home/apt,95,138,2.9,233
14849,Benjamin,2,Entire home/apt,100,87,0.81,187
14850,Sophie,3,Private room,59,106,1.87,165
14853,Or,1,Entire home/apt,100,0,0.07,100
14854,Antoine,1,Entire home/apt,199,215,3.95,414
14855,Anthony,2,Private room,35,272,4.09,307
14857,Adetutu,2,Entire home/apt,95,0,0.23,95
14858,Gayle,4,Private room,60,336,1.68,396
14859,Ziv,1,Entire home/apt,200,203,2.73,403
14860,Amy,1,Entire home/apt,200,14,1.08,214
14861,Leomaris,1,Private room,50,363,0.55,413
14862,Teri,1,Private room,102,178,0.76,280
14863,Sophie,1,Entire home/apt,152,0,0.03,152
14864,Meg,2,Entire home/apt,490,0,0.03,490
14865,Sohit,1,Entire home/apt,250,0,0.02,250
14866,Jennifer,1,Entire home/apt,450,229,0.17,679
14867,Ro,2,Entire home/apt,98,341,0.49,439
14869,Michael,3,Private room,50,0,0.03,50
14870,Ro,2,Entire home/apt,109,324,0.65,433
14871,Tyson,2,Entire home/apt,145,0,0.49,145
14873,Brian,2,Entire home/apt,165,0,0.13,165
14874,Donminique,2,Private room,65,0,0.03,65
14875,Hetor,1,Entire home/apt,130,226,2.93,356
14876,Kate,1,Entire home/apt,120,0,0.3,120
14877,Monzura,2,Entire home/apt,165,365,0.09,530
14878,Stine And Andrew,2,Entire home/apt,200,0,0.24,200
14879,Tracy,1,Private room,122,160,0.32,282
14880,Latrisha,1,Entire home/apt,400,88,0.06,488
14884,Emily,1,Private room,250,0,0.05,250
14885,Xela,1,Entire home/apt,120,0,0.23,120
14887,Garth,3,Private room,65,0,0.13,65
14890,Sophie,3,Private room,43,140,2.61,183
14892,Mary,1,Entire home/apt,154,17,1.95,171
14893,Elvin,2,Entire home/apt,135,88,0.26,223
14894,Hasi,3,Private room,86,365,0.15,451
14895,Katlyn,2,Private room,85,0,1.57,85
14896,Olga,3,Entire home/apt,80,334,1.79,414
14897,Kristen,2,Private room,70,0,0.05,70
14899,Nina,1,Entire home/apt,100,0,0.18,100
14900,Jackie,1,Entire home/apt,130,0,0.03,130
14901,Jamilya,2,Entire home/apt,139,75,1.7,214
14902,Baochen,2,Private room,35,0,0.24,35
14903,Andrew,2,Entire home/apt,100,0,0.03,100
14905,Corporate Housing,1,Entire home/apt,133,127,0.22,260
14906,Galina,1,Entire home/apt,275,170,3.4,445
14908,Corporate Housing,1,Entire home/apt,142,157,0.36,299
14909,Elizabeth,2,Entire home/apt,135,92,1.68,227
14910,Devon,2,Entire home/apt,165,0,0.8,165
14913,Swan,1,Entire home/apt,110,0,0.05,110
14915,Erika,1,Private room,70,38,4.27,108
14916,Leomaris,1,Private room,65,365,0.16,430
14917,Sen,3,Entire home/apt,95,357,0.09,452
14919,Alexandra,1,Entire home/apt,140,0,0.1,140
14921,Sarah,2,Entire home/apt,115,0,0.13,115
14922,Rachel,1,Private room,74,363,0.08,437
14923,Luca,2,Entire home/apt,175,157,0.16,332
14924,Heda,1,Entire home/apt,275,0,0.03,275
14925,Tugce,3,Entire home/apt,110,0,0.16,110
14926,Jeremy,1,Private room,69,0,0.02,69
14927,Kayla,2,Private room,50,0,0.07,50
14928,Thu Anh,2,Private room,85,0,0.3,85
14930,Corporate Housing,1,Entire home/apt,142,316,0.25,458
14931,Maya,1,Private room,75,232,0.67,307
14932,Patricia,1,Entire home/apt,133,0,0.08,133
14933,Marissa,1,Private room,79,0,0.03,79
14934,Xavier,4,Entire home/apt,80,0,0.05,80
14935,Kara,1,Entire home/apt,239,365,0.07,604
14937,Ethan,2,Entire home/apt,159,0,0.08,159
14938,John,1,Entire home/apt,140,0,0.02,140
14939,Meg,1,Entire home/apt,250,0,0.58,250
14940,Jason,2,Entire home/apt,135,270,4.87,405
14941,Joe,2,Private room,65,0,2.4,65
14942,Wayne And Yesim,1,Private room,75,188,0.03,263
14943,Emily,1,Entire home/apt,195,0,0.08,195
14944,Shai,2,Entire home/apt,99,39,0.9,138
14945,Maya,1,Private room,70,187,0.65,257
14947,Darya,1,Private room,65,249,0.9,314
14948,David,2,Entire home/apt,245,0,0.08,245
14949,Jiyoung,1,Entire home/apt,150,26,0.43,176
14950,Maria,2,Private room,55,0,0.03,55
14951,C,1,Entire home/apt,650,335,1.07,985
14952,Ricky,3,Private room,50,0,0.02,50
14953,Carlyne,2,Entire home/apt,81,309,1.18,390
14954,Rachel,1,Entire home/apt,92,0,0.11,92
14955,Jessica,1,Private room,105,0,0.36,105
14956,Mark,1,Private room,89,365,0.16,454
14957,Jessie,2,Entire home/apt,348,0,0.03,348
14958,Ari,2,Entire home/apt,168,344,1.66,512
14959,Amos,2,Private room,65,179,1.7,244
14961,Vanessa,1,Entire home/apt,175,53,3.33,228
14962,Eric,2,Entire home/apt,100,287,2.87,387
14963,Andre,2,Entire home/apt,119,280,3.38,399
14964,Jamie,2,Entire home/apt,105,11,0.67,116
14966,René,1,Entire home/apt,290,99,1.73,389
14969,Holly,2,Entire home/apt,65,0,0.03,65
14970,Annie,1,Private room,60,0,0.05,60
14971,Steven,1,Entire home/apt,160,0,0.05,160
14972,A.B.,3,Shared room,45,365,0.72,410
14973,C E,1,Entire home/apt,595,347,1.29,942
14974,Marina,2,Private room,60,0,0.13,60
14976,Maria,2,Private room,150,193,0.18,343
14978,Veronica,1,Private room,160,0,0.06,160
14979,Sarah,1,Entire home/apt,300,121,2.32,421
14980,Brooke,2,Entire home/apt,99,0,0.08,99
14982,Francesco,3,Private room,35,0,0.19,35
14983,Sasha,2,Entire home/apt,170,0,0.05,170
14985,Agustin,2,Shared room,38,84,0.95,122
14987,Caroline,1,Entire home/apt,500,330,1.8,830
14988,Lisah,2,Private room,85,0,0.03,85
14989,Micki & Kristian,2,Entire home/apt,110,0,0.1,110
14990,Leila,1,Private room,60,0,0.16,60
14991,Jorge,1,Entire home/apt,148,280,1.12,428
14992,Matt,1,Entire home/apt,133,0,1.82,133
14994,Young,1,Entire home/apt,250,0,0.03,250
14995,Ashraful,3,Private room,95,183,0.33,278
14996,Ara,1,Private room,69,0,0.18,69
14997,Rei,3,Entire home/apt,180,0,0.03,180
14998,Layla,1,Private room,40,0,0.4,40
14999,Harry,2,Private room,85,0,0.16,85
15000,Habby,2,Private room,65,0,0.37,65
15001,Vin,2,Private room,55,0,0.1,55
15002,Michelle,1,Shared room,75,0,0.1,75
15003,Tania,1,Entire home/apt,125,0,0.28,125
15004,Alba & Genesis,4,Private room,26,127,0.64,153
15005,Kailei,2,Entire home/apt,175,0,0.7,175
15006,Steve,2,Private room,85,59,4.58,144
15009,Kay,2,Private room,76,0,0.03,76
15010,Stephan And Liz,1,Entire home/apt,225,280,2.17,505
15011,David,1,Private room,40,0,0.16,40
15012,Sara,1,Entire home/apt,110,0,0.55,110
15013,Corporate Housing,1,Entire home/apt,117,311,0.25,428
15014,Marianna,3,Entire home/apt,78,0,0.1,78
15015,One,1,Entire home/apt,800,263,1.51,1063
15016,Stephanie,2,Entire home/apt,65,1,3.8,66
15017,Eugene,1,Entire home/apt,105,175,4.61,280
15018,Maya,2,Private room,45,0,0.08,45
15019,Sophie,3,Private room,34,164,2.35,198
15022,Steven,3,Entire home/apt,150,338,0.18,488
15023,Devon,1,Entire home/apt,160,0,0.5,160
15024,Jeremy & Laura,1,Entire home/apt,250,337,0.17,587
15026,Juliana,1,Entire home/apt,95,322,0.19,417
15027,Hatsumi,1,Private room,69,0,0.1,69
15028,Jasmine,2,Entire home/apt,145,296,2.52,441
15029,Sasha,2,Entire home/apt,75,0,0.18,75
15030,Judy,2,Entire home/apt,70,263,1.48,333
15032,Franklin,3,Private room,43,0,0.68,43
15033,Tee,2,Entire home/apt,121,294,0.6,415
15035,Anna,1,Entire home/apt,198,57,0.8,255
15036,Anthony,2,Private room,109,352,2.87,461
15037,Jonathan & Nancy,1,Entire home/apt,199,292,0.03,491
15038,Anne,4,Entire home/apt,150,267,1.99,417
15039,Dani,2,Private room,49,0,0.13,49
15044,Rebecca,2,Entire home/apt,170,0,0.53,170
15045,Kara,1,Entire home/apt,239,352,0.05,591
15046,Koji,2,Private room,80,0,0.03,80
15050,Cinthia,1,Entire home/apt,80,0,0.05,80
15051,Sachea,2,Entire home/apt,140,145,0.87,285
15053,Lin,2,Private room,60,0,0.03,60
15054,Josh & Jessica,1,Entire home/apt,200,231,3.31,431
15055,Julian,1,Entire home/apt,159,0,0.11,159
15056,Stephanie,2,Entire home/apt,65,0,1.58,65
15057,Yuan,1,Private room,70,0,0.05,70
15059,Stephen,1,Private room,120,365,0.23,485
15061,Pete,1,Private room,125,81,1.4,206
15062,Molly,2,Entire home/apt,200,0,0.15,200
15063,Sebastian,1,Private room,50,0,1.14,50
15064,David,1,Entire home/apt,120,331,0.46,451
15066,Bárbara,2,Private room,80,0,0.05,80
15067,Tanya,1,Entire home/apt,140,0,0.03,140
15068,Haydee,2,Entire home/apt,105,360,1.68,465
15069,Mariana,2,Private room,49,365,0.08,414
15070,Annette,2,Entire home/apt,180,333,0.13,513
15071,Michael,1,Private room,70,0,0.08,70
15072,Mark,1,Entire home/apt,450,287,1.17,737
15073,Adam,2,Private room,44,0,0.38,44
15074,Christen,2,Private room,89,269,2.56,358
15075,Thomas,2,Entire home/apt,172,87,2.31,259
15076,SaeHo,1,Entire home/apt,350,0,0.05,350
15077,Nka,1,Private room,68,365,1.23,433
15078,Sebastian,1,Private room,52,39,1.46,91
15079,Catharina,3,Private room,70,89,0.81,159
15080,Arthur,2,Entire home/apt,223,0,0.03,223
15082,Arthur,2,Private room,97,0,0.05,97
15083,Mia,1,Private room,75,0,0.13,75
15084,David,1,Private room,65,0,0.16,65
15085,Virginia,2,Private room,64,0,0.63,64
15086,Joey,2,Private room,59,268,3.63,327
15088,Sushanti,2,Private room,60,364,0.53,424
15089,Iris,3,Private room,73,276,0.17,349
15090,Iris,3,Entire home/apt,219,273,0.22,492
15091,Atul,1,Entire home/apt,999,164,0.28,1163
15093,Sophie,3,Private room,52,174,2.71,226
15094,Olivia Loksing,2,Entire home/apt,90,0,0.05,90
15095,Tracy,1,Entire home/apt,150,220,0.42,370
15096,Jarett,1,Entire home/apt,325,223,1.12,548
15097,Amber,1,Entire home/apt,170,121,1.39,291
15098,Florin,3,Entire home/apt,79,311,1.6,390
15099,Brian,2,Private room,175,179,1.51,354
15101,Valerie,2,Entire home/apt,120,208,1.79,328
15102,Nicolas,1,Private room,72,204,2.5,276
15105,Bryant,1,Entire home/apt,125,0,0.38,125
15106,R,1,Private room,200,365,0.1,565
15107,Albert,1,Entire home/apt,1000,349,0.51,1349
15108,Andrew,2,Private room,45,0,0.03,45
15109,Melissa,1,Entire home/apt,175,0,0.16,175
15110,Zhenni,2,Private room,89,365,0.13,454
15113,Mey,1,Entire home/apt,149,326,2.23,475
15114,Christine,2,Entire home/apt,110,0,0.26,110
15115,Alina,2,Private room,40,298,0.7,338
15116,Carla,2,Entire home/apt,98,0,0.36,98
15117,Beth,1,Entire home/apt,160,318,0.93,478
15119,Tanya,1,Entire home/apt,380,0,0.16,380
15120,Elissa,2,Private room,35,157,0.03,192
15124,John,1,Entire home/apt,200,0,0.08,200
15127,Stefano,1,Entire home/apt,140,0,0.1,140
15129,Angela,1,Private room,56,0,0.05,56
15131,Kara,1,Entire home/apt,239,352,0.06,591
15134,Isra,2,Private room,91,0,0.86,91
15136,Eej,2,Entire home/apt,169,365,0.34,534
15137,Charles,1,Private room,35,0,0.24,35
15138,Gilad,2,Entire home/apt,180,0,0.05,180
15139,Anne,2,Private room,55,0,0.11,55
15140,Kara,1,Entire home/apt,239,351,0.23,590
15142,SaeHo,1,Private room,175,0,0.03,175
15143,Erica & Tayo,2,Entire home/apt,67,0,2.22,67
15145,Emily,1,Private room,65,0,0.13,65
15146,Corporate Housing,1,Entire home/apt,125,127,0.25,252
15147,Peter,2,Entire home/apt,200,239,0.41,439
15148,Jonathan,2,Entire home/apt,81,1,0.24,82
15149,Michel And Antoine,1,Entire home/apt,325,246,2.56,571
15150,Adam,1,Entire home/apt,333,323,6.38,656
15152,L.R.,1,Entire home/apt,245,48,0.61,293
15153,Maria,2,Private room,90,358,0.15,448
15154,Elizabeth Anne,1,Entire home/apt,999,58,1.49,1057
15156,Jeremy & Laura,1,Entire home/apt,400,311,0.03,711
15157,Jeremy & Laura,1,Entire home/apt,160,336,0.07,496
15158,John,2,Entire home/apt,75,0,0.08,75
15159,Tim,1,Entire home/apt,206,0,1.41,206
15160,Shawn,1,Private room,70,0,0.4,70
15161,Kendra,2,Private room,65,0,0.03,65
15162,Maya,2,Entire home/apt,126,182,4.73,308
15165,Ben,2,Entire home/apt,129,0,0.15,129
15166,Louise,2,Entire home/apt,92,0,0.14,92
15167,Kim,1,Private room,82,39,2.7,121
15168,Kara,1,Entire home/apt,369,345,0.12,714
15170,Feli,1,Entire home/apt,99,213,4.33,312
15175,Fran & Jason,4,Entire home/apt,125,185,3.59,310
15176,Nina,1,Entire home/apt,99,227,0.24,326
15177,Alicia,1,Entire home/apt,75,0,0.34,75
15178,Amos Rothschild,1,Entire home/apt,300,9,0.08,309
15179,Pooran,1,Entire home/apt,140,7,0.2,147
15180,Weiyi,1,Private room,98,0,0.05,98
15181,Jeff,1,Private room,99,320,3.85,419
15182,Jeremy & Laura,1,Entire home/apt,178,332,0.06,510
15184,Sara,2,Entire home/apt,75,36,1.22,111
15185,Eric,3,Private room,225,364,0.92,589
15186,Caty,1,Private room,60,0,0.13,60
15187,Dee,1,Entire home/apt,268,0,0.08,268
15189,Mike,1,Entire home/apt,177,0,0.3,177
15190,Gayle,4,Private room,60,249,1.22,309
15191,Vanessa,1,Private room,60,0,0.21,60
15192,Gayle,4,Private room,55,280,0.81,335
15193,Gayle,4,Private room,60,171,1.96,231
15194,Lonnie,2,Entire home/apt,135,359,2.49,494
15196,Noel,1,Entire home/apt,139,230,4.68,369
15197,Carmen,1,Entire home/apt,100,0,0.16,100
15198,Caroline,2,Private room,100,7,0.14,107
15199,Dorota,3,Private room,40,1,1.24,41
15200,Shawn,1,Private room,55,0,0.03,55
15201,Mackenzie,1,Entire home/apt,175,0,0.05,175
15202,Kelly,2,Entire home/apt,300,76,0.86,376
15203,Thomas,1,Private room,45,0,0.03,45
15204,Ruma,2,Entire home/apt,144,69,1.28,213
15205,Mrs. Alabi,2,Private room,60,39,3.32,99
15207,William,2,Private room,45,0,0.18,45
15208,Paul,1,Private room,80,0,0.03,80
15210,Daniel,1,Entire home/apt,149,0,0.43,149
15211,Denia,1,Private room,89,271,1.82,360
15212,Katherine,1,Private room,110,292,0.91,402
15213,Yael,1,Private room,179,104,1.8,283
15214,Ren,3,Shared room,500,365,0.39,865
15215,Jeen,2,Entire home/apt,150,0,0.29,150
15216,Peter,3,Entire home/apt,175,55,0.83,230
15217,Sol And Coach,2,Entire home/apt,79,258,3.48,337
15218,James,2,Entire home/apt,117,0,0.03,117
15220,Yiin,1,Private room,65,0,0.08,65
15222,Alex And Zeena,1,Private room,85,321,5.34,406
15223,CRNY Monthly Rentals,1,Entire home/apt,150,143,0.14,293
15224,Elizabeth,3,Private room,80,245,4.48,325
15226,Simone,2,Entire home/apt,325,160,1.93,485
15227,Harry,1,Private room,95,0,0.25,95
15229,Peter,1,Shared room,85,76,1.2,161
15230,Rhea,2,Entire home/apt,115,0,0.21,115
15231,Ashley,1,Entire home/apt,111,4,1.17,115
15232,Geri,1,Private room,84,0,0.69,84
15234,Neil,1,Private room,95,0,0.1,95
15235,Albert,2,Entire home/apt,110,0,0.15,110
15236,Sasha,2,Private room,50,0,0.03,50
15238,Mara,1,Entire home/apt,225,0,0.14,225
15240,Liz,2,Private room,110,342,0.05,452
15241,Aurélien,2,Private room,49,0,0.36,49
15242,(Email hidden by Airbnb),1,Private room,90,188,2.91,278
15243,Antoinette,3,Entire home/apt,299,318,0.31,617
15244,Yiin,1,Private room,60,0,0.14,60
15245,Jeremy & Laura,1,Entire home/apt,175,311,0.08,486
15246,Andrea,1,Entire home/apt,115,3,0.48,118
15249,Adam + Yulu,1,Entire home/apt,120,0,0.05,120
15250,Preeti,2,Entire home/apt,409,0,0.03,409
15251,Tony,3,Entire home/apt,350,365,0.39,715
15252,Natasha,3,Private room,95,361,0.79,456
15253,Nicholas,2,Private room,49,0,0.03,49
15254,Brigid,1,Entire home/apt,155,0,0.05,155
15255,Brandee,2,Entire home/apt,265,285,3.25,550
15256,Kelly,2,Entire home/apt,215,279,1.28,494
15257,Elizabeth,3,Private room,120,268,4.12,388
15258,Jessica,2,Private room,54,319,0.03,373
15261,Carla,1,Entire home/apt,60,4,0.41,64
15262,Ben,3,Entire home/apt,750,352,0.36,1102
15264,Mitchell,1,Entire home/apt,210,2,1.49,212
15265,Mimi,2,Private room,80,0,0.05,80
15266,Ray,2,Entire home/apt,85,0,2.38,85
15267,Shelia,2,Entire home/apt,99,0,1.16,99
15269,Janelle,2,Private room,84,282,4.59,366
15270,Miki,2,Entire home/apt,105,20,0.18,125
15272,Donna,3,Private room,88,0,0.84,88
15275,Clare,1,Entire home/apt,140,0,0.03,140
15276,Rick,2,Private room,50,0,0.35,50
15277,Genevieve,2,Entire home/apt,175,0,0.05,175
15279,Amy,2,Private room,50,0,0.38,50
15280,Shirley,3,Private room,60,141,1.69,201
15284,Ivana And Tami,2,Private room,60,346,3.45,406
15285,Mckenzie,1,Entire home/apt,143,0,0.81,143
15286,Sam,1,Entire home/apt,85,282,0.11,367
15287,Angelica,3,Entire home/apt,110,128,1.52,238
15290,Kara,1,Entire home/apt,369,345,0.04,714
15292,Loretta,2,Entire home/apt,295,292,1.8,587
15293,Irina,1,Entire home/apt,110,34,0.05,144
15294,Michael,1,Private room,65,0,0.05,65
15295,Corporate Housing,1,Entire home/apt,109,159,0.28,268
15296,Joerg,2,Private room,35,0,0.05,35
15297,Anita,2,Private room,50,0,0.1,50
15298,Stephen,2,Private room,44,357,0.23,401
15299,Alex,1,Entire home/apt,275,307,1.84,582
15300,Alex,1,Private room,110,307,1.17,417
15301,Frederikke,2,Entire home/apt,120,0,0.03,120
15302,Zhaoyan,2,Private room,50,0,0.11,50
15303,Tracey,2,Entire home/apt,87,260,2.25,347
15306,Marc,1,Private room,109,0,0.09,109
15307,Zineb,1,Private room,65,0,0.03,65
15308,Dominik,1,Private room,150,274,1.07,424
15309,Michelle,1,Entire home/apt,225,255,1.16,480
15310,Natalie,1,Entire home/apt,100,0,0.03,100
15311,Gregory,1,Entire home/apt,125,339,2.67,464
15312,Jessica,1,Entire home/apt,115,0,1.19,115
15313,Becky,2,Private room,62,0,0.03,62
15314,Jordan,2,Private room,50,0,0.06,50
15315,Doni,1,Entire home/apt,200,0,1.15,200
15316,Ben,3,Entire home/apt,225,352,0.56,577
15317,Corporate Housing,1,Entire home/apt,159,281,0.18,440
15318,Amy,1,Entire home/apt,150,331,0.11,481
15319,Kristen,2,Private room,29,0,0.11,29
15321,Feather,2,Private room,80,0,0.23,80
15322,Carol,2,Private room,35,337,0.84,372
15323,Brian,1,Entire home/apt,250,294,0.22,544
15325,Natalie,1,Entire home/apt,175,0,0.32,175
15326,Ada,2,Entire home/apt,150,330,0.28,480
15327,Alexandra,3,Entire home/apt,165,0,0.08,165
15329,Ada,2,Entire home/apt,159,317,0.34,476
15330,Jon,2,Entire home/apt,140,278,2.89,418
15331,Maggie,2,Entire home/apt,159,0,0.05,159
15332,Savion,1,Private room,77,311,0.46,388
15333,Javier,2,Private room,49,0,0.08,49
15334,Eric,2,Private room,55,281,1.46,336
15335,Eric,2,Private room,50,352,2.87,402
15336,Bill & May,1,Entire home/apt,359,309,2.48,668
15337,Barrie,2,Private room,50,0,0.08,50
15338,Bianca,2,Entire home/apt,40,0,0.05,40
15339,Laura,1,Entire home/apt,219,0,0.13,219
15340,Christine,2,Entire home/apt,189,83,1.73,272
15341,Adrien,1,Entire home/apt,140,0,0.05,140
15342,Kris,3,Entire home/apt,96,325,0.47,421
15344,Peggy,3,Private room,125,301,0.28,426
15345,Salima & Carlos,2,Private room,150,364,0.28,514
15346,Rich,2,Private room,60,90,0.81,150
15347,Swathi,1,Private room,99,0,1.31,99
15348,Rich,2,Private room,60,90,0.41,150
15349,Stephanie,1,Entire home/apt,198,0,0.98,198
15350,Pierre,1,Entire home/apt,350,247,3.16,597
15351,Andrew,2,Entire home/apt,85,275,0.15,360
15353,Shaye,2,Entire home/apt,80,0,0.15,80
15354,Jeremy & Laura,1,Entire home/apt,135,311,0.16,446
15355,Sheila,2,Entire home/apt,61,246,2.38,307
15356,Dustin,2,Private room,45,0,0.08,45
15357,Jam,2,Private room,70,249,0.06,319
15358,Fernando,1,Private room,60,0,1.02,60
15359,Fernando,1,Private room,75,0,1.17,75
15360,David & Suzanne,2,Entire home/apt,165,0,0.08,165
15361,Cla,2,Entire home/apt,112,21,0.28,133
15362,Nka,1,Private room,69,365,0.97,434
15363,Aric,2,Private room,39,360,0.56,399
15364,Evan & Maria,1,Entire home/apt,239,242,3.39,481
15368,Sean,1,Entire home/apt,194,0,0.13,194
15369,Graham,2,Private room,75,0,0.03,75
15371,Serkan,1,Entire home/apt,165,222,2.87,387
15373,Anna B,1,Entire home/apt,200,0,0.08,200
15375,Natalie And Dan,2,Entire home/apt,205,4,0.18,209
15376,Jamie,2,Private room,45,89,0.91,134
15377,K Alexandra,1,Entire home/apt,139,154,3.66,293
15378,Bill & May,1,Entire home/apt,339,318,2.28,657
15379,Michele,2,Entire home/apt,49,291,0.08,340
15380,Tanya,1,Entire home/apt,190,118,0.08,308
15381,Justin,2,Entire home/apt,450,365,0.5,815
15382,Chadanut,2,Private room,45,0,2.68,45
15383,Jacqueline,2,Entire home/apt,199,174,0.74,373
15385,Ilya,2,Private room,33,297,0.2,330
15386,Peter,2,Entire home/apt,149,0,0.14,149
15387,Amanda,2,Private room,80,0,1.37,80
15388,Gabriel,2,Entire home/apt,120,0,0.72,120
15389,Guillermo,2,Private room,73,0,0.11,73
15391,Sean,2,Private room,44,0,0.83,44
15392,Patrice,1,Entire home/apt,105,0,0.21,105
15394,Alejandro,1,Private room,120,0,0.43,120
15395,Shean,2,Private room,57,345,0.85,402
15396,Eliza,3,Entire home/apt,120,0,0.03,120
15397,Danny,1,Private room,100,164,3.36,264
15398,E.C.,1,Entire home/apt,525,314,1.26,839
15400,Alexis,2,Private room,75,0,0.09,75
15402,Kristina,2,Private room,65,0,0.06,65
15403,Karen,2,Entire home/apt,132,264,1.77,396
15405,Shirley,3,Private room,50,171,2.15,221
15406,Fer,1,Private room,60,0,0.69,60
15407,Danny,4,Private room,59,336,3.11,395
15408,Mike,1,Private room,80,0,0.85,80
15409,Buddy,4,Entire home/apt,450,342,2.07,792
15410,Matt,2,Private room,45,133,0.41,178
15411,Bill & May,1,Entire home/apt,359,318,3.21,677
15412,Jonathan,1,Private room,200,0,0.03,200
15413,Cassandra,1,Entire home/apt,120,0,0.32,120
15414,Evan,1,Entire home/apt,140,0,0.17,140
15415,Doug,2,Entire home/apt,436,27,0.37,463
15416,Bryan,1,Entire home/apt,249,0,0.23,249
15418,Young,2,Entire home/apt,140,312,1.1,452
15419,Serra,2,Entire home/apt,170,290,0.9,460
15421,Francisco,2,Private room,60,0,0.05,60
15422,Bob,1,Private room,94,364,0.1,458
15424,Henrik,2,Private room,45,0,0.18,45
15425,Nataly,2,Private room,60,0,0.05,60
15426,Luis,3,Private room,169,256,0.78,425
15427,Britta,1,Private room,80,0,0.03,80
15428,Alexi,2,Private room,55,22,0.75,77
15429,Gabi,1,Entire home/apt,220,341,3.6,561
15430,Carmen,2,Entire home/apt,235,322,0.88,557
15431,Jackie,2,Entire home/apt,125,0,0.05,125
15432,Allison,3,Private room,66,0,0.03,66
15433,Daniela,1,Private room,80,0,0.13,80
15435,Ben,3,Private room,57,0,0.37,57
15436,Anthony,2,Private room,48,268,2.74,316
15437,Martin,1,Entire home/apt,99,0,0.06,99
15438,Dlb,3,Private room,40,173,1.19,213
15440,Elizabeth,1,Private room,180,90,0.4,270
15441,Michael,1,Entire home/apt,115,0,0.2,115
15442,Martina,2,Private room,104,249,0.49,353
15443,Jonathan,2,Entire home/apt,325,6,0.49,331
15444,Laura,1,Entire home/apt,299,0,0.36,299
15445,Caitlin,2,Private room,40,0,0.13,40
15446,Alice,1,Private room,89,198,0.23,287
15447,Jeniffer,1,Entire home/apt,100,244,0.19,344
15448,Shanie,3,Entire home/apt,59,62,0.7,121
15449,Shan,1,Entire home/apt,300,335,2.66,635
15451,JoJo,1,Private room,50,310,1.98,360
15454,Franco,2,Private room,80,66,0.77,146
15455,Rem,1,Private room,56,0,0.03,56
15456,Kyle,1,Entire home/apt,219,235,2.66,454
15458,Collin,2,Entire home/apt,260,48,2.85,308
15459,Marie,1,Entire home/apt,115,0,0.13,115
15460,Danny,4,Private room,75,150,1.8,225
15461,Miriam,2,Private room,66,0,0.03,66
15462,Aldo,3,Private room,75,364,0.55,439
15464,Jocelyne,3,Entire home/apt,215,77,1.75,292
15465,Kevin,1,Entire home/apt,175,280,3.51,455
15466,K.Arina,1,Entire home/apt,140,111,3.37,251
15469,Jackie,2,Private room,80,0,0.03,80
15471,Kim,3,Entire home/apt,120,0,0.03,120
15472,Eugenia,4,Entire home/apt,85,0,0.31,85
15473,Jason,2,Entire home/apt,100,0,0.1,100
15474,Rishe,2,Private room,64,0,0.18,64
15475,Gracie,1,Private room,75,0,0.08,75
15476,Jeffrey Paul,1,Private room,62,0,0.83,62
15477,Jeniffer,1,Entire home/apt,96,246,0.13,342
15480,Elizabeth,2,Entire home/apt,290,0,0.11,290
15481,Carole,1,Private room,50,0,0.31,50
15483,Joseph,1,Private room,81,188,0.7,269
15484,Rob,3,Private room,70,89,0.46,159
15485,Manon,2,Private room,70,0,0.83,70
15487,Maya,2,Entire home/apt,95,0,0.37,95
15488,Donnell,2,Entire home/apt,150,188,0.03,338
15489,Shawn,2,Entire home/apt,169,251,3.46,420
15492,Viola,1,Entire home/apt,140,0,0.03,140
15493,Tim,1,Entire home/apt,130,0,0.13,130
15494,Clarissa,2,Private room,60,365,1.37,425
15496,Kevin,2,Private room,55,0,0.05,55
15498,Bryant,2,Private room,45,0,0.08,45
15499,Arkadiy,2,Entire home/apt,199,340,4.25,539
15500,Jenna,1,Entire home/apt,290,0,0.08,290
15501,Scott,1,Entire home/apt,85,0,0.18,85
15502,Jeniffer,1,Entire home/apt,150,332,0.12,482
15503,Mrs. Alabi,2,Entire home/apt,60,33,6.22,93
15504,Marni,2,Entire home/apt,170,82,1.44,252
15505,Dante,3,Private room,47,0,0.39,47
15506,Anita,2,Private room,55,88,1.62,143
15507,Phillip,1,Entire home/apt,195,14,2.04,209
15508,Gabi,1,Entire home/apt,186,73,3.6,259
15509,Nkem,1,Entire home/apt,99,0,0.08,99
15511,David,2,Private room,60,308,0.71,368
15512,Grace,2,Private room,100,0,0.03,100
15513,Heidi,1,Entire home/apt,500,44,0.09,544
15514,Kali,2,Entire home/apt,150,319,1.74,469
15515,Nassim,1,Entire home/apt,175,0,0.09,175
15516,Marco,1,Entire home/apt,148,145,2.7,293
15517,Martin,1,Private room,130,80,1.15,210
15518,Atlanta,1,Private room,80,0,0.08,80
15519,Alexis,1,Entire home/apt,150,0,0.13,150
15520,Aunim,2,Entire home/apt,285,0,0.44,285
15521,Adrien,1,Private room,70,0,0.03,70
15523,Benjamin,2,Entire home/apt,155,61,0.09,216
15524,Katherine,1,Private room,82,0,0.16,82
15525,Sarah,1,Entire home/apt,200,0,0.13,200
15528,H,1,Private room,159,155,0.44,314
15529,Ellen,1,Private room,38,0,0.31,38
15530,Eli,1,Entire home/apt,155,2,0.31,157
15531,Sara,2,Entire home/apt,184,222,2.21,406
15532,Mabel,3,Private room,65,86,3.16,151
15534,Joe,2,Private room,50,0,1.79,50
15535,Paulette,2,Private room,60,0,0.88,60
15536,Elika,1,Private room,100,0,0.21,100
15537,Rachel,3,Private room,60,307,0.78,367
15539,Kiri,2,Private room,50,0,0.06,50
15541,Zach,1,Entire home/apt,225,18,1.54,243
15542,Nathan,1,Entire home/apt,190,165,1.4,355
15543,Brendon,2,Entire home/apt,119,0,0.1,119
15544,Susan,1,Entire home/apt,650,137,0.09,787
15545,Yahaira,4,Entire home/apt,104,86,0.85,190
15546,Cristina,1,Entire home/apt,175,0,0.11,175
15548,Baochan,1,Private room,40,0,0.03,40
15549,J. E,2,Entire home/apt,100,48,9.67,148
15552,MaTT,1,Private room,85,160,0.67,245
15553,Carlos Esteban,2,Private room,60,0,0.05,60
15554,Rose,1,Private room,90,296,0.22,386
15555,Felipe,1,Private room,53,185,0.17,238
15556,Juan,2,Private room,50,0,0.68,50
15557,Christa,1,Private room,45,0,0.08,45
15558,John 'Lance',1,Private room,110,125,0.23,235
15562,Tom,1,Entire home/apt,199,0,0.08,199
15563,Hua,3,Private room,65,333,0.77,398
15564,Josh,2,Private room,95,9,0.03,104
15566,Jeremy & Laura,1,Entire home/apt,200,337,0.13,537
15567,Mila & Jon,1,Entire home/apt,274,339,0.94,613
15568,Jasmin,2,Private room,50,202,2.39,252
15569,Linda,2,Private room,105,83,4.5,188
15572,Zineb,1,Private room,350,90,0.23,440
15573,Nina,1,Entire home/apt,180,210,0.14,390
15574,Michael,1,Entire home/apt,225,218,3.39,443
15575,Janelle,3,Entire home/apt,100,0,0.03,100
15577,常春,1,Private room,55,332,0.13,387
15578,Christie,2,Entire home/apt,70,0,0.12,70
15580,Rebecca,2,Private room,67,0,0.03,67
15581,Abe & Gail,1,Entire home/apt,150,0,0.03,150
15582,Mency,1,Private room,35,0,0.09,35
15583,Monica,2,Private room,90,6,1.05,96
15584,Grant,1,Private room,53,0,0.23,53
15587,Laura,1,Entire home/apt,299,0,0.15,299
15588,Joyell,2,Private room,41,0,1.88,41
15589,Neil,2,Private room,50,0,0.03,50
15590,Michael,3,Entire home/apt,70,0,0.21,70
15592,Jc,1,Entire home/apt,185,279,1.31,464
15593,Athena,1,Private room,98,278,2.66,376
15594,Diane And Ward,1,Entire home/apt,399,237,1.47,636
15595,Jamie (& Jacob),1,Entire home/apt,170,0,0.31,170
15597,Razia,1,Entire home/apt,376,310,1.4,686
15598,Lydie,4,Entire home/apt,99,2,1.78,101
15600,Caleb,2,Entire home/apt,91,0,0.12,91
15602,Phil,1,Private room,60,240,1.31,300
15604,Anne,1,Entire home/apt,250,0,0.03,250
15605,Emory,1,Entire home/apt,209,8,1.93,217
15607,Rina,3,Private room,48,0,0.29,48
15608,Anna,1,Private room,60,98,3.55,158
15609,Natalia,5,Entire home/apt,165,298,2.78,463
15610,Ronald,1,Entire home/apt,218,152,1.81,370
15612,Madeleine,1,Entire home/apt,200,51,4.02,251
15613,Christopher,2,Private room,53,0,0.14,53
15614,Xiomara,2,Private room,65,23,1.98,88
15615,Viviana,2,Entire home/apt,280,125,0.79,405
15616,Pillo,2,Private room,60,310,1.85,370
15617,Elizabeth,2,Entire home/apt,800,357,0.1,1157
15618,Cindy,3,Entire home/apt,99,7,5.97,106
15619,David,1,Entire home/apt,120,189,0.47,309
15620,Kaan,1,Private room,70,156,0.75,226
15621,Amy,1,Entire home/apt,235,209,0.1,444
15622,Amy,1,Entire home/apt,275,199,0.15,474
15623,Julian,3,Private room,86,242,0.74,328
15624,Jackie,1,Shared room,49,0,0.08,49
15625,Randy,1,Private room,85,240,2.28,325
15626,Seth,3,Entire home/apt,125,0,0.26,125
15627,Randy,1,Private room,85,228,2.37,313
15628,Jacob,2,Entire home/apt,70,0,0.05,70
15629,Clarissa,2,Private room,60,363,1.84,423
15630,Jeanne,2,Private room,50,2,0.56,52
15631,Ronald,1,Entire home/apt,218,185,2.1,403
15632,Inna,1,Entire home/apt,135,330,0.37,465
15633,Brian,2,Private room,120,0,0.06,120
15634,Laura,3,Private room,55,0,0.08,55
15635,Emily,2,Entire home/apt,150,0,0.19,150
15636,Ron,2,Entire home/apt,75,362,0.26,437
15638,Joei,1,Entire home/apt,115,1,4.06,116
15639,Penélope,3,Private room,60,101,2.72,161
15640,Megan,2,Entire home/apt,160,1,0.87,161
15641,J,1,Shared room,39,131,1.22,170
15642,Natalie,1,Private room,45,0,1.26,45
15643,Liz,2,Private room,45,0,0.19,45
15646,Noreen,1,Entire home/apt,125,0,0.03,125
15647,Dante,3,Private room,67,0,5.27,67
15649,Michael,1,Entire home/apt,110,12,0.13,122
15650,Kimberly,2,Entire home/apt,177,73,2.22,250
15653,Jada,2,Entire home/apt,150,259,1.89,409
15655,Camila,2,Private room,41,188,1.19,229
15656,Kelly,1,Entire home/apt,185,0,0.26,185
15657,Nicole,3,Entire home/apt,175,141,2.42,316
15658,Rose,1,Private room,40,0,0.03,40
15659,Rosa,2,Entire home/apt,135,365,0.23,500
15660,Pepper,2,Entire home/apt,195,0,0.97,195
15662,Vanessa,2,Private room,50,0,0.11,50
15663,Nick,2,Private room,40,0,0.11,40
15664,Tulika,1,Entire home/apt,150,0,0.05,150
15665,Shirah,2,Private room,75,301,0.13,376
15667,Andrea,2,Private room,65,0,0.08,65
15668,JaNae,2,Private room,250,0,0.05,250
15669,Mike,1,Entire home/apt,136,0,0.82,136
15670,Deeva,1,Entire home/apt,180,213,4.44,393
15671,Nina,2,Private room,55,0,0.11,55
15673,Aamir,2,Entire home/apt,225,0,1.25,225
15674,Charles,2,Private room,99,0,0.17,99
15675,Kuma,2,Private room,90,0,0.08,90
15677,Eva,1,Private room,980,90,0.03,1070
15678,Mica,1,Private room,100,33,1.88,133
15679,J,1,Private room,73,122,1.77,195
15680,Florence,2,Entire home/apt,380,0,0.26,380
15681,Jackie,1,Private room,99,0,0.05,99
15682,Racquel,2,Entire home/apt,105,13,1.17,118
15683,Cupid,2,Private room,35,176,0.31,211
15684,Alexandre,2,Entire home/apt,200,117,0.28,317
15685,Cyrille,2,Private room,105,31,0.11,136
15687,Mike,1,Entire home/apt,87,365,0.06,452
15689,June,1,Private room,69,0,0.13,69
15690,Stephanie,1,Entire home/apt,150,0,0.05,150
15691,Anna,1,Private room,75,128,0.53,203
15694,Hannah,1,Entire home/apt,100,0,0.76,100
15695,Vincent,1,Entire home/apt,224,0,0.03,224
15696,Rupi,3,Private room,119,363,0.57,482
15697,Belgin,3,Private room,80,364,1.37,444
15700,Dafni,3,Private room,58,20,1.76,78
15701,Javier,2,Private room,128,12,0.08,140
15703,Nikkita,1,Private room,115,0,0.05,115
15706,Javier,2,Private room,76,11,1.81,87
15707,Jamie,2,Private room,45,89,1.06,134
15708,Shelby,2,Private room,80,0,0.05,80
15709,Annie,2,Private room,75,0,0.19,75
15711,Janine,2,Private room,89,303,3.81,392
15713,Jeremy & Laura,1,Entire home/apt,197,104,0.06,301
15715,Valeska,2,Entire home/apt,180,0,0.78,180
15717,Michael,2,Entire home/apt,125,0,0.08,125
15718,Nina,1,Entire home/apt,170,0,0.05,170
15719,Drew,1,Entire home/apt,180,0,0.15,180
15720,Jeniffer,1,Entire home/apt,142,307,0.13,449
15721,Peggy,3,Private room,60,300,0.4,360
15722,Daniela,1,Private room,98,241,0.21,339
15723,Shirley,3,Private room,40,323,2.75,363
15724,Sigal,1,Private room,59,0,0.08,59
15725,Shirley,3,Private room,40,105,2.73,145
15726,Cesar,1,Entire home/apt,250,18,0.77,268
15727,Janet,2,Private room,80,0,0.11,80
15728,Peggy,3,Private room,50,345,1.82,395
15729,Yutian,1,Private room,50,0,0.05,50
15730,Peggy,3,Private room,65,329,1.31,394
15731,Zhenya And Lenka,1,Entire home/apt,140,0,0.16,140
15732,Hurriyet Aydın /,2,Private room,47,258,0.91,305
15733,Nina,1,Entire home/apt,184,332,0.25,516
15734,Matthew,2,Entire home/apt,139,0,0.31,139
15735,Michael,2,Entire home/apt,57,0,0.13,57
15738,Corey,1,Private room,50,0,0.03,50
15739,Anna,3,Entire home/apt,250,189,1.04,439
15740,Leah,2,Entire home/apt,125,0,0.14,125
15741,Nikki,2,Private room,50,0,0.21,50
15742,Justin,1,Entire home/apt,240,37,1.56,277
15743,Monique Ngozi,2,Private room,60,346,0.12,406
15744,Andrea,2,Entire home/apt,160,0,0.24,160
15745,Jen,1,Private room,45,0,0.03,45
15749,Adam,2,Private room,50,0,0.05,50
15750,Arturo,3,Entire home/apt,135,363,0.47,498
15751,Monika,1,Entire home/apt,259,175,1.51,434
15753,Jacob,1,Private room,60,0,0.03,60
15754,Mickael,2,Private room,70,0,0.08,70
15755,Kennedy,2,Private room,99,0,0.05,99
15757,Dimitris,3,Entire home/apt,190,53,0.85,243
15758,Amanda,1,Entire home/apt,115,0,0.03,115
15759,Michael,1,Entire home/apt,250,0,0.76,250
15760,Samir,2,Private room,70,0,0.24,70
15761,Nick,2,Entire home/apt,225,0,0.85,225
15762,Charlötte,2,Private room,31,0,0.03,31
15763,Hurriyet Aydın /,2,Private room,40,236,1.02,276
15764,Hurriyet Aydın /,2,Private room,37,212,1.06,249
15765,Matt,2,Entire home/apt,239,0,0.13,239
15766,Ella,1,Private room,75,310,4.6,385
15767,K,1,Private room,90,0,0.6,90
15768,Michael,1,Private room,46,0,0.03,46
15771,Judy,1,Entire home/apt,175,14,1.63,189
15773,Jeremy & Laura,1,Entire home/apt,155,335,0.03,490
15774,Nina,1,Entire home/apt,143,0,0.03,143
15776,Amanda,1,Entire home/apt,120,0,0.11,120
15777,Albert,3,Entire home/apt,79,331,2.35,410
15778,Flora,1,Private room,50,0,0.05,50
15779,Michelle & Eddie,3,Private room,289,280,2.99,569
15780,Heather,2,Entire home/apt,62,0,0.19,62
15781,Jason,3,Private room,85,125,0.71,210
15783,Ranny,2,Private room,50,92,3.86,142
15784,Flower,2,Entire home/apt,120,243,1.15,363
15785,Mark,2,Entire home/apt,180,0,0.03,180
15786,Jinsoon,1,Entire home/apt,90,0,0.06,90
15789,Nicole,2,Private room,90,0,0.05,90
15790,Jay,1,Private room,55,0,0.13,55
15791,Robert,3,Private room,49,341,0.18,390
15792,Elisse,1,Entire home/apt,105,0,0.08,105
15793,Sarah,4,Private room,40,338,4.01,378
15795,Cristian,3,Entire home/apt,120,0,0.03,120
15796,Kate,1,Private room,90,0,0.08,90
15797,Blase,2,Entire home/apt,110,0,0.15,110
15798,Tny,1,Entire home/apt,140,290,0.15,430
15799,Kasey,3,Entire home/apt,125,345,0.58,470
15800,Marion,1,Entire home/apt,95,159,0.13,254
15802,Alba,4,Entire home/apt,75,265,2.45,340
15803,George,1,Entire home/apt,244,282,4.57,526
15804,Imanuelly,3,Private room,75,351,0.92,426
15805,Vh,1,Private room,75,37,2.99,112
15806,Lilly,1,Private room,105,15,0.36,120
15807,David,2,Private room,100,0,0.28,100
15808,Denise,1,Entire home/apt,150,26,0.34,176
15810,James,1,Private room,35,0,0.08,35
15811,Juan,1,Private room,51,313,1.78,364
15812,Diane,1,Private room,105,29,0.19,134
15813,Jacqueline,2,Private room,80,0,0.05,80
15814,Larissa,1,Private room,84,294,4.22,378
15815,Tyler,2,Private room,70,281,0.29,351
15816,Viviana,2,Entire home/apt,70,206,0.67,276
15818,Viola,1,Entire home/apt,150,0,0.04,150
15820,Yan,1,Private room,100,0,0.03,100
15821,Trish,1,Private room,85,142,0.83,227
15822,Devon,2,Entire home/apt,225,122,2.48,347
15823,Karen,1,Private room,120,0,0.34,120
15824,Ayesha,1,Private room,90,90,0.42,180
15825,Anna,2,Entire home/apt,175,209,2.5,384
15826,Zoraida,1,Private room,65,72,1.2,137
15827,Margaret,3,Entire home/apt,260,42,0.46,302
15828,Larry,2,Entire home/apt,225,1,0.85,226
15829,Hilal & Maryam,2,Entire home/apt,135,91,3.84,226
15831,An,2,Entire home/apt,195,225,0.67,420
15832,Marielle,1,Private room,99,0,0.08,99
15833,Lisa,1,Entire home/apt,1000,274,0.71,1274
15834,Charese,1,Entire home/apt,177,10,0.65,187
15836,Jeremy & Laura,1,Entire home/apt,190,330,0.08,520
15837,Lisa,1,Entire home/apt,1000,240,0.7,1240
15838,Mari,2,Private room,80,0,0.16,80
15839,Munnesa,3,Private room,60,98,2.84,158
15840,Shane,1,Entire home/apt,195,0,0.03,195
15841,Caroline,2,Private room,60,293,2.68,353
15842,Zoey,2,Entire home/apt,99,12,0.73,111
15844,Joyce,2,Entire home/apt,125,262,3.08,387
15845,Grace,2,Private room,89,179,0.43,268
15846,Anna,1,Private room,55,0,0.14,55
15847,Cory,3,Entire home/apt,130,11,0.45,141
15848,Brandon,2,Private room,70,0,0.95,70
15849,Rachel,2,Entire home/apt,110,0,0.23,110
15850,Michelle,1,Private room,100,0,0.03,100
15852,Saskia,1,Entire home/apt,195,0,0.03,195
15853,Sammie,3,Private room,30,64,1.39,94
15855,Israel,3,Entire home/apt,68,0,0.31,68
15856,Andrew,1,Private room,90,0,0.16,90
15857,Carly,1,Entire home/apt,85,0,0.06,85
15858,Ohad,2,Entire home/apt,200,232,1.13,432
15860,Kathryn,1,Private room,150,0,0.47,150
15862,Carolyn,1,Private room,60,0,0.05,60
15863,Alexander,3,Entire home/apt,135,0,0.72,135
15864,Nathan,1,Private room,100,0,0.13,100
15865,Ken,1,Entire home/apt,163,350,0.05,513
15866,Ken,1,Entire home/apt,187,287,0.09,474
15867,Ken,1,Entire home/apt,225,365,0.05,590
15868,Diana,2,Entire home/apt,120,0,0.03,120
15869,Camila,2,Private room,73,188,1.37,261
15870,Matt,2,Private room,100,42,3.83,142
15871,Ramon,2,Entire home/apt,99,0,0.07,99
15872,Lucy,2,Entire home/apt,300,259,1.03,559
15873,Gina,1,Entire home/apt,92,0,0.05,92
15875,Mohammad,1,Private room,100,0,0.21,100
15876,Melissa,3,Private room,40,0,0.03,40
15878,Anna,2,Entire home/apt,170,46,0.11,216
15880,Michael,2,Entire home/apt,109,0,0.26,109
15881,Corporate Housing,1,Entire home/apt,150,126,0.32,276
15882,David,1,Private room,50,365,0.09,415
15883,Mario,4,Private room,49,348,0.87,397
15884,Chris And Zaneta,2,Entire home/apt,265,0,0.21,265
15886,Leanna,2,Private room,44,0,0.11,44
15887,Tana,1,Private room,260,3,0.58,263
15888,Corporate Housing,1,Entire home/apt,133,342,0.1,475
15889,Snezhana,3,Entire home/apt,80,0,0.41,80
15890,Mark,2,Private room,1000,365,0.16,1365
15891,Christopher,1,Entire home/apt,154,0,0.08,154
15892,Shane & Nicole,2,Entire home/apt,150,326,0.27,476
15894,Corporate Housing,1,Entire home/apt,125,149,0.23,274
15895,Keith,1,Private room,60,0,0.03,60
15897,Oxana,1,Entire home/apt,75,317,4.58,392
15898,Andrey,1,Entire home/apt,100,269,5.16,369
15899,Brendan,1,Entire home/apt,100,17,0.78,117
15900,Trevor,1,Private room,65,361,4.03,426
15901,Martina,1,Entire home/apt,200,17,0.24,217
15902,Rene,1,Entire home/apt,180,0,0.03,180
15903,Abdoulaye,3,Private room,60,316,1.05,376
15904,Uğur,3,Private room,33,337,0.18,370
15905,Deanna,1,Private room,112,18,0.61,130
15907,Mike,1,Entire home/apt,230,0,1.03,230
15909,Tolley,1,Entire home/apt,375,0,0.06,375
15910,Abby,1,Private room,130,304,0.49,434
15912,Eduardo,1,Private room,120,0,0.03,120
15914,Inna,1,Entire home/apt,150,325,0.35,475
15916,Jessica,2,Private room,150,0,0.4,150
15917,Ariela,2,Private room,30,0,0.03,30
15918,Ken,1,Entire home/apt,191,323,0.09,514
15919,Ken,1,Entire home/apt,219,344,0.24,563
15920,Evan,2,Entire home/apt,250,0,0.41,250
15921,Evan,2,Entire home/apt,180,0,0.08,180
15922,Jeniffer,1,Entire home/apt,115,65,0.12,180
15924,Juan,1,Entire home/apt,399,0,0.84,399
15925,Peter,2,Private room,52,0,0.08,52
15926,Yvelisse,1,Entire home/apt,95,81,3.3,176
15927,Mark,2,Entire home/apt,190,8,2.19,198
15928,Michael,1,Entire home/apt,480,263,2.99,743
15929,Doreen,1,Entire home/apt,180,0,0.06,180
15930,Shannon,2,Entire home/apt,150,0,0.08,150
15931,Peter,2,Private room,150,364,0.16,514
15932,Kelly,1,Private room,140,321,2.23,461
15933,Arthur,2,Private room,70,0,0.03,70
15934,Maham,2,Private room,70,4,0.54,74
15935,Jeremy & Laura,1,Entire home/apt,197,325,0.3,522
15937,Helen,1,Entire home/apt,128,178,0.79,306
15938,Elizabeth,1,Entire home/apt,150,0,0.11,150
15940,Michelle,3,Entire home/apt,75,64,1.99,139
15941,Ken,1,Entire home/apt,280,364,0.1,644
15943,Jeremy & Laura,1,Entire home/apt,390,239,0.07,629
15945,Ken,1,Entire home/apt,256,358,0.09,614
15947,Michael And Fernanda,1,Entire home/apt,200,0,0.03,200
15948,Deqing,2,Entire home/apt,150,0,0.11,150
15949,Layla,1,Private room,41,0,0.16,41
15951,Andrea,1,Private room,75,0,0.03,75
15952,Michael,1,Entire home/apt,300,0,0.05,300
15953,Querlim,2,Private room,50,0,0.08,50
15956,Aj,1,Private room,50,0,0.1,50
15958,Jack,2,Entire home/apt,179,137,3.04,316
15959,Kevin,1,Private room,72,83,1.56,155
15960,Thomas,1,Entire home/apt,150,0,0.08,150
15961,Fotini,2,Entire home/apt,110,0,0.03,110
15962,Andrew,1,Entire home/apt,200,0,0.16,200
15963,Yohan,1,Private room,50,333,0.04,383
15964,Elena,2,Private room,35,0,0.13,35
15965,Julia Marie,1,Private room,45,0,0.16,45
15966,Maddy,2,Entire home/apt,195,0,0.16,195
15967,Kelly,1,Entire home/apt,90,0,0.03,90
15968,Zack,2,Entire home/apt,325,0,0.72,325
15969,Brit,2,Entire home/apt,100,8,0.09,108
15970,Darren,1,Private room,85,69,0.14,154
15971,Jessica,5,Private room,40,0,0.14,40
15972,Quentin,1,Private room,80,0,0.08,80
15973,Jay,1,Private room,149,0,0.18,149
15974,Charis,1,Private room,67,0,0.03,67
15975,Regina,2,Private room,80,14,1.58,94
15976,Ari,2,Private room,80,0,0.43,80
15977,Lucy,2,Entire home/apt,275,271,0.71,546
15978,Digna,2,Entire home/apt,123,67,1.67,190
15979,Nick,1,Entire home/apt,179,0,0.03,179
15980,Julia And Juan,2,Entire home/apt,196,365,0.12,561
15981,Vincent,1,Private room,180,0,0.73,180
15983,Zachary,1,Entire home/apt,140,0,0.16,140
15984,Oge,1,Private room,59,0,0.03,59
15985,Lee,1,Entire home/apt,200,0,0.16,200
15986,Fred,2,Private room,165,342,0.09,507
15988,Bryan,2,Private room,90,0,0.19,90
15989,Alan,3,Entire home/apt,200,16,0.11,216
15990,Mark And Josephine,1,Entire home/apt,450,341,1.5,791
15991,Matt,1,Private room,120,96,1.18,216
15992,Shirley,3,Private room,60,174,1.64,234
15993,Lucia,4,Shared room,51,89,0.26,140
15994,Harvin,2,Entire home/apt,200,286,2.09,486
15995,Trevor,1,Entire home/apt,250,80,0.9,330
15997,Philipe,1,Entire home/apt,180,0,0.18,180
15998,Ian,2,Private room,66,0,0.03,66
15999,George,1,Entire home/apt,180,0,0.03,180
16000,Hoan,1,Private room,65,0,0.17,65
16001,Mike,1,Entire home/apt,87,365,0.16,452
16002,Liz,2,Private room,60,0,0.03,60
16003,Jane Anne,2,Entire home/apt,124,237,2.75,361
16004,Danielle,1,Entire home/apt,225,0,0.03,225
16005,Max,1,Entire home/apt,77,0,0.03,77
16006,Joellen,2,Private room,79,127,1.52,206
16007,Kara,1,Entire home/apt,239,365,0.1,604
16008,Joellen,2,Private room,65,116,2.04,181
16011,Chris And Zaneta,2,Private room,72,0,0.1,72
16012,Caroline,2,Private room,75,0,0.14,75
16013,Mira,2,Private room,35,0,0.03,35
16014,Jamie,2,Private room,45,16,2.58,61
16015,Laura,1,Private room,67,0,0.13,67
16016,Asher,1,Entire home/apt,700,236,0.03,936
16017,Daniel,1,Entire home/apt,150,0,1.3,150
16018,Jon,2,Entire home/apt,115,0,0.05,115
16019,Sarah,2,Entire home/apt,150,75,2.84,225
16020,Jasmine,2,Private room,50,27,0.55,77
16021,Jon,1,Private room,60,0,0.03,60
16022,Besinfe,1,Private room,50,352,3.06,402
16023,Ehsan,4,Private room,34,0,0.05,34
16024,Ana Paula,2,Entire home/apt,100,0,0.16,100
16027,Mike,1,Entire home/apt,125,203,2.73,328
16028,Nicole,2,Private room,45,0,0.05,45
16029,Grace,1,Entire home/apt,198,0,0.84,198
16030,Alex,1,Private room,150,121,0.13,271
16031,En & Lora,2,Private room,39,0,2.34,39
16032,Jeniffer,1,Entire home/apt,150,339,0.12,489
16033,Nick,3,Private room,80,0,1.29,80
16034,Courtney,1,Private room,46,0,0.08,46
16035,Don,5,Entire home/apt,78,300,2.56,378
16036,Sidiq,2,Entire home/apt,219,71,1.36,290
16037,Jessica,1,Private room,145,180,0.11,325
16041,Erika,1,Entire home/apt,175,0,0.33,175
16042,Amy,2,Entire home/apt,220,318,1.11,538
16043,Kseniya,2,Shared room,85,0,0.03,85
16045,H,1,Private room,110,189,0.81,299
16046,Kamil,3,Private room,58,346,1.57,404
16047,Maria,1,Entire home/apt,350,92,0.14,442
16048,Jules,1,Entire home/apt,329,205,2.79,534
16049,Kamil,3,Private room,58,364,0.97,422
16050,Kamil,3,Private room,60,364,0.78,424
16051,A.B.,3,Shared room,43,362,0.73,405
16052,Paige,2,Private room,88,0,1.19,88
16053,Jeff,2,Entire home/apt,90,0,0.18,90
16054,Aleksey,2,Private room,41,0,0.05,41
16055,Tiago And Renata,2,Private room,65,80,0.96,145
16057,Brian,1,Entire home/apt,160,0,0.05,160
16058,Sophia,2,Entire home/apt,140,11,0.53,151
16059,Ken,1,Entire home/apt,169,347,0.13,516
16060,Robbie,1,Entire home/apt,115,4,0.09,119
16061,Mariella,2,Private room,67,365,0.53,432
16062,Chris And Zaneta,2,Private room,60,0,0.03,60
16063,Chris,2,Private room,45,332,0.37,377
16064,Sabina,1,Private room,60,0,0.08,60
16065,AFI Apartments,1,Entire home/apt,142,319,0.15,461
16066,Nahid,2,Entire home/apt,350,0,0.08,350
16067,Justine,1,Private room,40,0,0.08,40
16068,Erica,2,Private room,65,0,0.21,65
16069,Francesco,3,Private room,50,0,0.15,50
16070,Francesco,3,Private room,42,0,0.09,42
16072,Andrea,1,Private room,100,65,0.05,165
16073,Liz,1,Entire home/apt,175,48,0.82,223
16074,Boyd,1,Entire home/apt,399,212,2.11,611
16077,Marian,3,Private room,40,0,0.96,40
16078,Wing Yan,1,Private room,100,0,0.03,100
16079,Lucy,2,Entire home/apt,575,259,1.12,834
16080,Marian,3,Private room,63,0,0.03,63
16081,Katie,1,Entire home/apt,177,0,0.06,177
16082,Willow,1,Entire home/apt,158,193,4.81,351
16083,Stephanie,2,Entire home/apt,400,6,0.29,406
16084,Addie,2,Entire home/apt,90,2,0.87,92
16085,Jaime,1,Entire home/apt,135,0,0.44,135
16086,Aurora,2,Entire home/apt,200,318,0.15,518
16087,Julian,2,Entire home/apt,155,83,3.53,238
16088,Jackson,1,Private room,100,0,0.22,100
16089,Jerry,1,Entire home/apt,315,38,0.16,353
16090,Rick,1,Shared room,45,347,1.41,392
16092,Pedro Pablo,1,Private room,49,142,0.49,191
16093,Michelle,1,Entire home/apt,220,364,0.08,584
16094,Michelle,1,Private room,220,365,0.09,585
16095,Beth,3,Entire home/apt,100,40,1.31,140
16096,Annalisa,2,Private room,70,0,0.08,70
16097,Yaakov (Jacob),1,Entire home/apt,74,0,0.21,74
16098,Pierce,1,Entire home/apt,290,0,0.08,290
16100,Zandelle,2,Private room,85,35,1.46,120
16101,Jorge,1,Entire home/apt,199,85,2.36,284
16102,Noah,2,Private room,65,0,0.03,65
16103,Mia,2,Private room,45,45,1.23,90
16104,Aj,1,Private room,95,7,0.17,102
16105,Ben,1,Private room,95,0,0.11,95
16106,Laura,2,Entire home/apt,80,0,0.85,80
16107,Michael,1,Entire home/apt,300,87,0.58,387
16109,Elizabeth,1,Entire home/apt,120,0,0.18,120
16110,Jacob,1,Entire home/apt,150,4,1.05,154
16111,Shutong,1,Entire home/apt,120,0,0.06,120
16112,Caroline,1,Entire home/apt,225,0,0.87,225
16113,Isabella,2,Private room,100,0,1.07,100
16114,Trista,2,Entire home/apt,160,0,0.35,160
16116,Reah,1,Entire home/apt,150,0,0.92,150
16118,Christine,1,Entire home/apt,275,0,0.43,275
16119,Katherine E,2,Private room,45,0,0.08,45
16120,Joel,2,Entire home/apt,195,97,1.42,292
16121,Lorraine,2,Private room,100,304,0.37,404
16123,Shylie,1,Entire home/apt,195,0,0.24,195
16124,Andrew,3,Entire home/apt,87,49,3.5,136
16125,Nicole & Tyson,2,Entire home/apt,120,0,0.08,120
16126,Christine,1,Entire home/apt,170,0,0.26,170
16127,Chunxiao,1,Entire home/apt,160,0,0.05,160
16130,Efrem,2,Entire home/apt,225,0,0.13,225
16131,Maria,2,Entire home/apt,125,132,1.85,257
16132,Gharet,1,Entire home/apt,350,0,0.1,350
16133,Chris,2,Entire home/apt,175,128,3.37,303
16134,Shean,2,Private room,65,298,1.09,363
16135,Pierre,1,Entire home/apt,350,236,2.55,586
16136,Joyell,2,Private room,45,69,6.68,114
16137,Nat,2,Entire home/apt,120,0,0.56,120
16139,Diane,1,Private room,100,0,0.05,100
16140,Torun,1,Entire home/apt,850,10,0.26,860
16141,Stephanie,2,Private room,40,0,0.03,40
16142,John,3,Shared room,100,0,0.03,100
16143,Jeff,2,Entire home/apt,178,3,0.59,181
16144,Steve,3,Entire home/apt,170,229,4.21,399
16145,Kevin And Kitty,3,Private room,45,278,6.15,323
16146,Emily,1,Entire home/apt,180,0,0.05,180
16147,Tom,2,Private room,89,0,0.03,89
16148,Yvonne,2,Private room,50,0,0.13,50
16149,Johann,2,Private room,80,0,0.05,80
16150,Denise,2,Entire home/apt,250,0,0.11,250
16151,Carlos,1,Private room,70,8,0.11,78
16154,Tanya,1,Shared room,45,258,0.53,303
16155,Keith,2,Entire home/apt,100,0,0.55,100
16156,Sacha,2,Private room,65,189,0.86,254
16157,Tanya,1,Shared room,45,323,0.58,368
16158,Tanya,1,Shared room,45,289,0.58,334
16159,Tanya,1,Shared room,45,294,0.58,339
16160,Tanya,1,Private room,90,246,2.08,336
16161,Khatia,1,Entire home/apt,150,15,0.45,165
16163,Flo And Erin,2,Entire home/apt,125,0,0.51,125
16164,Marco,1,Entire home/apt,125,34,2.63,159
16165,Robert,2,Entire home/apt,175,7,3.17,182
16166,Jon,2,Shared room,75,155,0.66,230
16167,Elena,2,Private room,30,0,0.03,30
16168,Michael,1,Entire home/apt,295,77,1.33,372
16169,Sheila,2,Entire home/apt,50,236,2.03,286
16171,Francisca,2,Private room,69,362,2.72,431
16173,Jeremy & Laura,1,Entire home/apt,175,365,0.1,540
16175,Nika,1,Private room,90,0,0.05,90
16176,Amy,1,Private room,100,0,0.03,100
16177,Sarah,2,Private room,49,7,0.3,56
16178,Jonathan,1,Private room,55,326,0.88,381
16179,Bc,1,Entire home/apt,249,177,0.06,426
16180,Jasmina,3,Private room,36,228,1.03,264
16181,Adriana,3,Private room,65,0,0.74,65
16182,Naomi,2,Private room,60,0,0.05,60
16183,Guy,1,Entire home/apt,180,0,0.1,180
16184,Robin Laverne,2,Private room,50,40,1.04,90
16185,Feliz,2,Entire home/apt,110,0,0.03,110
16186,Mike,1,Entire home/apt,87,365,0.05,452
16187,Santron,2,Entire home/apt,100,0,0.35,100
16188,Jacob,3,Entire home/apt,120,0,0.08,120
16189,Alina,2,Private room,42,207,0.96,249
16190,Braydon,1,Entire home/apt,145,0,2.62,145
16192,Kyle,1,Private room,99,0,0.05,99
16193,Angelina,2,Entire home/apt,129,124,2.33,253
16194,Cate,1,Entire home/apt,186,209,5.24,395
16195,Lara,2,Entire home/apt,350,78,0.14,428
16196,Marie Clare,2,Entire home/apt,165,0,0.22,165
16197,Ken,1,Entire home/apt,210,329,0.43,539
16198,Luis,3,Entire home/apt,119,336,1.01,455
16199,Mil,1,Private room,75,38,0.48,113
16200,Steven,1,Entire home/apt,400,31,0.33,431
16201,Nathalie,2,Private room,60,6,1.56,66
16202,Deshawn,2,Private room,140,89,0.21,229
16204,Ken,1,Entire home/apt,245,236,0.12,481
16205,Ken,1,Entire home/apt,245,262,0.07,507
16207,Michelle & Eddie,3,Entire home/apt,89,252,3.85,341
16212,Darian,2,Entire home/apt,140,0,0.05,140
16213,Vivek,2,Private room,37,0,0.03,37
16214,Yuan,1,Shared room,49,0,0.61,49
16215,Jeniffer,1,Entire home/apt,115,331,0.17,446
16216,Francisca,2,Private room,69,365,3.46,434
16217,Emily,1,Entire home/apt,100,0,0.05,100
16218,Simona,1,Entire home/apt,300,361,1.01,661
16219,Jackie,3,Private room,52,57,1.27,109
16220,Emily,2,Private room,50,0,0.11,50
16223,Michael,2,Entire home/apt,199,0,0.25,199
16224,Katie,2,Private room,90,47,0.05,137
16225,Sadecia,2,Entire home/apt,65,0,0.35,65
16226,Trish,1,Entire home/apt,400,344,2.7,744
16227,Priyanka,2,Entire home/apt,65,0,0.03,65
16228,Eduardo,3,Entire home/apt,71,0,1.96,71
16229,Ken,1,Entire home/apt,199,328,0.03,527
16230,Nina,1,Entire home/apt,163,332,0.17,495
16231,Christina,1,Entire home/apt,126,0,0.29,126
16232,David,1,Entire home/apt,150,248,3.71,398
16233,Kara,1,Entire home/apt,199,365,0.03,564
16234,Rebecca,2,Private room,51,0,0.03,51
16236,Ken,1,Entire home/apt,289,339,0.08,628
16237,Ken,1,Entire home/apt,219,340,0.04,559
16239,Warren,2,Entire home/apt,125,0,0.03,125
16240,Isaac,2,Private room,90,0,0.13,90
16241,Liz,1,Entire home/apt,150,0,0.11,150
16242,Dallas,2,Private room,40,0,0.04,40
16243,Jt,2,Entire home/apt,120,0,0.18,120
16245,Sacha,1,Entire home/apt,126,0,0.47,126
16246,Jeniffer,1,Entire home/apt,200,341,0.12,541
16247,Jason,3,Entire home/apt,195,256,6.31,451
16248,Jerrell,1,Entire home/apt,175,75,0.98,250
16250,Angela,1,Private room,130,0,0.1,130
16251,Carla,1,Entire home/apt,170,262,2.97,432
16252,Francisco,2,Private room,60,0,0.03,60
16253,Jay,3,Entire home/apt,110,0,0.03,110
16254,Jennifer,3,Private room,70,138,0.29,208
16255,Vanessa,2,Entire home/apt,105,32,0.18,137
16257,Whitney,1,Entire home/apt,140,170,0.74,310
16258,Abe,1,Entire home/apt,175,0,0.08,175
16260,Claudine,2,Entire home/apt,90,302,3.3,392
16261,Peter,2,Entire home/apt,128,0,0.03,128
16262,Eve,1,Entire home/apt,110,0,0.13,110
16263,Megahn,3,Entire home/apt,99,0,0.44,99
16264,Mychelle,2,Private room,125,311,0.56,436
16267,Ken,1,Entire home/apt,205,0,0.06,205
16269,Ken,1,Entire home/apt,230,350,0.03,580
16270,Augie,2,Private room,40,0,0.08,40
16273,Steve,2,Entire home/apt,225,53,1.01,278
16274,Lane,2,Private room,50,0,0.05,50
16275,Joseph,2,Private room,45,0,0.19,45
16276,Corporate Housing,1,Entire home/apt,159,281,0.14,440
16279,Jeremy & Laura,1,Entire home/apt,180,281,0.04,461
16280,Robert,2,Entire home/apt,225,306,3.48,531
16282,Michelle & Eddie,3,Private room,49,355,1.7,404
16284,Bridgestreet Corporate,1,Entire home/apt,559,0,0.17,559
16285,Jean-Guy,2,Private room,109,213,1.97,322
16286,Lincoln,1,Entire home/apt,250,0,0.49,250
16287,Ken,1,Entire home/apt,269,364,0.13,633
16288,Tiffany,2,Private room,81,120,3.5,201
16289,Cameron,2,Private room,53,0,0.05,53
16290,Spencer,1,Entire home/apt,206,0,0.03,206
16291,Jiandong,1,Private room,40,0,0.03,40
16293,Catalina,1,Entire home/apt,105,0,0.16,105
16294,Kartik,1,Private room,75,0,0.21,75
16295,Claire,2,Entire home/apt,499,25,0.2,524
16296,Gerald,1,Entire home/apt,165,64,1.37,229
16297,Pedro Pablo,1,Private room,55,3,0.08,58
16298,Sasha,4,Entire home/apt,57,68,0.31,125
16299,Jack,2,Entire home/apt,201,159,1.78,360
16300,Yety,2,Entire home/apt,80,0,0.05,80
16301,Rebecca,2,Private room,80,0,0.24,80
16302,Emily,2,Entire home/apt,59,3,4.74,62
16304,Michelle,1,Private room,200,0,0.03,200
16306,Vanessa,1,Private room,60,0,0.62,60
16307,Gool-Jitzu,2,Entire home/apt,150,0,0.08,150
16309,Michion,3,Private room,40,335,0.42,375
16310,Neanna,2,Entire home/apt,175,284,2.68,459
16311,Nick,3,Entire home/apt,151,17,2.3,168
16312,Tony,1,Entire home/apt,250,0,1.4,250
16313,Stephanie,3,Private room,100,0,0.03,100
16315,Kristen,2,Entire home/apt,120,0,0.13,120
16316,Michael,2,Entire home/apt,100,15,1.69,115
16318,Camille,1,Private room,80,3,1.96,83
16319,Daniel,1,Private room,60,0,1.74,60
16320,Brandon,1,Entire home/apt,123,0,0.2,123
16321,Gabby,2,Entire home/apt,189,0,0.16,189
16322,Vivian,1,Entire home/apt,235,12,0.23,247
16323,Jeniffer,1,Entire home/apt,90,223,0.33,313
16324,Justin,2,Private room,85,0,1.14,85
16325,Alexander,2,Private room,40,3,3.16,43
16326,Real Estate To Go,4,Entire home/apt,67,140,5.39,207
16327,Jack,2,Private room,63,0,0.05,63
16328,Chris,2,Entire home/apt,150,0,0.16,150
16329,Iman,2,Private room,70,0,0.59,70
16330,Breath Beyond,1,Private room,75,73,3.89,148
16331,Kunal,1,Entire home/apt,99,2,0.54,101
16332,Gingie,1,Entire home/apt,199,30,0.8,229
16334,Eli,2,Entire home/apt,67,0,0.03,67
16335,Anna,3,Private room,71,286,1.06,357
16336,Sara Cecilia,2,Private room,35,0,0.22,35
16337,Lorraine,2,Private room,100,342,0.8,442
16340,Hans,1,Entire home/apt,138,215,2.54,353
16341,Sinida,2,Private room,52,115,2.55,167
16342,Heather,3,Private room,120,0,0.03,120
16343,Wayne,3,Entire home/apt,125,263,4.13,388
16344,Jessica,1,Entire home/apt,119,0,0.03,119
16345,Angela,2,Entire home/apt,225,0,0.3,225
16346,Chris,1,Private room,75,279,2.86,354
16348,Natalia,1,Entire home/apt,70,11,2.97,81
16350,Zac,2,Private room,45,0,0.03,45
16351,Daniel,1,Entire home/apt,600,336,0.63,936
16352,Dena,2,Entire home/apt,175,254,0.86,429
16353,Spencer,2,Entire home/apt,150,299,3.79,449
16354,Jessica,2,Private room,76,177,0.62,253
16355,Peter,2,Entire home/apt,200,0,0.16,200
16356,Nicky,2,Entire home/apt,170,255,2.0,425
16357,Alexander,1,Entire home/apt,225,44,0.85,269
16358,Nicole,2,Private room,50,0,0.05,50
16359,Deborah,2,Entire home/apt,150,117,1.11,267
16360,Kyle,1,Private room,100,0,0.05,100
16361,Amy,1,Entire home/apt,202,147,0.3,349
16362,Jean,1,Private room,60,0,0.05,60
16363,George,2,Entire home/apt,99,0,0.16,99
16364,Kevin And Kitty,3,Private room,38,192,4.49,230
16365,Charlotte And Mary,1,Private room,70,0,1.55,70
16366,Brian,2,Entire home/apt,117,0,0.47,117
16369,Agustina,2,Private room,75,329,1.53,404
16370,Leslie,1,Entire home/apt,105,0,0.19,105
16371,Ryan,1,Entire home/apt,130,34,1.68,164
16373,Sami,1,Entire home/apt,100,83,0.09,183
16377,Elizabeth,2,Entire home/apt,269,0,0.03,269
16378,Kara,1,Entire home/apt,325,333,0.18,658
16380,Corey,1,Entire home/apt,80,0,0.06,80
16381,Rupi,3,Entire home/apt,509,264,0.2,773
16382,Lauren,2,Entire home/apt,200,0,0.03,200
16384,Claudia,1,Entire home/apt,195,0,0.19,195
16385,Ken,1,Entire home/apt,225,249,0.04,474
16386,Jose,3,Shared room,35,340,3.18,375
16387,Ivette,3,Entire home/apt,92,0,0.11,92
16390,Jamie,2,Private room,95,0,1.44,95
16391,Christian,3,Private room,95,93,1.19,188
16392,Michael,1,Entire home/apt,119,17,3.59,136
16393,Tale,1,Entire home/apt,154,4,0.62,158
16394,Mayra,1,Private room,80,49,0.34,129
16396,Alex,2,Entire home/apt,99,363,1.1,462
16398,Ja'Tovia,2,Entire home/apt,75,0,0.05,75
16401,Ken,1,Entire home/apt,199,364,0.06,563
16402,Elliot,1,Private room,99,2,4.86,101
16403,Anthony,1,Private room,62,188,0.03,250
16405,Marla,1,Private room,180,122,0.48,302
16406,Amanda,1,Entire home/apt,115,0,0.11,115
16407,Amit,1,Entire home/apt,150,0,0.3,150
16408,Aicha,2,Private room,65,48,2.24,113
16409,Janelle,2,Entire home/apt,85,18,3.09,103
16410,Rosa,1,Private room,70,291,1.1,361
16411,Jean,1,Private room,50,0,0.21,50
16412,Maggie,2,Private room,65,0,0.13,65
16414,George,1,Entire home/apt,150,6,0.33,156
16415,Christina,2,Entire home/apt,250,0,0.32,250
16416,Erica,1,Entire home/apt,140,0,1.01,140
16417,Elicia,2,Private room,70,364,3.06,434
16418,Sasha,2,Private room,80,0,0.23,80
16419,Elicia,2,Private room,85,365,1.26,450
16421,Quinlan & Barbara,3,Entire home/apt,99,1,2.52,100
16423,Elicia,2,Private room,75,363,3.24,438
16424,Ed,1,Entire home/apt,99,0,0.08,99
16425,Kelsey,1,Entire home/apt,165,0,0.06,165
16427,Michelle,1,Private room,85,58,0.65,143
16429,Peter,1,Private room,55,0,0.19,55
16430,Meggan,2,Entire home/apt,80,68,0.14,148
16431,Stacy,3,Entire home/apt,95,0,0.03,95
16435,Kara,1,Entire home/apt,369,345,0.03,714
16436,Varos,3,Private room,75,16,0.88,91
16437,Lucy,2,Entire home/apt,136,279,4.48,415
16438,Taylor,2,Private room,101,13,1.15,114
16439,Ezra,1,Private room,40,16,0.29,56
16441,Ling,2,Private room,43,6,1.15,49
16442,Ben,1,Private room,100,0,0.29,100
16443,Roxane,1,Private room,40,260,2.87,300
16444,Rachael,1,Entire home/apt,165,0,0.03,165
16445,Caitlin,2,Entire home/apt,319,82,1.32,401
16449,Maya,3,Private room,50,28,0.68,78
16450,Kofi,1,Entire home/apt,160,31,1.51,191
16451,Bret,1,Private room,109,161,2.33,270
16455,Andy,2,Private room,50,27,0.05,77
16456,Kange,2,Entire home/apt,150,55,0.42,205
16457,Laura,1,Private room,50,0,0.03,50
16458,Nicole,1,Entire home/apt,115,0,0.22,115
16462,Jennifer,1,Private room,131,180,0.88,311
16463,Katie,1,Shared room,99,0,1.53,99
16464,Bridget,3,Private room,160,365,0.11,525
16465,Anna,1,Entire home/apt,250,0,0.09,250
16466,Jesse,1,Entire home/apt,250,0,0.47,250
16467,Andrea,2,Entire home/apt,150,0,0.08,150
16468,Anni,1,Entire home/apt,150,0,0.16,150
16469,Hakan,3,Private room,65,20,2.23,85
16471,Emily,1,Private room,85,362,0.3,447
16472,Jean,2,Private room,44,0,0.31,44
16475,Juan,2,Entire home/apt,150,149,3.29,299
16476,Stephen,2,Private room,75,0,1.46,75
16477,Mary,1,Entire home/apt,105,290,0.91,395
16478,Eleni,2,Private room,50,40,0.21,90
16479,Gary,1,Entire home/apt,275,82,0.66,357
16480,Wasim,1,Private room,149,333,0.59,482
16481,Zichen,1,Private room,90,0,0.08,90
16482,Perri,2,Private room,56,0,0.45,56
16483,Sarah,2,Entire home/apt,220,0,0.03,220
16484,Emily,2,Private room,42,0,0.16,42
16485,Allyson,1,Entire home/apt,129,0,0.28,129
16486,Jean,2,Private room,50,31,0.28,81
16487,Jennifer,2,Entire home/apt,110,6,0.08,116
16488,Jeremy & Laura,1,Entire home/apt,160,344,0.09,504
16489,Silvia,2,Private room,35,326,2.29,361
16490,Vadim,5,Private room,72,237,0.66,309
16491,Leticia,3,Entire home/apt,95,244,1.23,339
16492,Lawrence,1,Entire home/apt,100,0,0.13,100
16493,Khalil,1,Private room,115,0,0.03,115
16494,Sarah,2,Entire home/apt,115,0,0.03,115
16495,Tony,1,Private room,79,74,1.49,153
16496,Siyu,1,Private room,36,0,0.03,36
16498,Valerie Lynn-McDonough,2,Entire home/apt,75,191,0.03,266
16501,Ben,1,Private room,59,166,0.68,225
16503,Millie,2,Entire home/apt,99,167,0.43,266
16504,Rhemy,2,Private room,49,239,2.44,288
16505,Alexis,2,Entire home/apt,113,0,0.08,113
16506,Sophie,3,Private room,47,156,2.35,203
16508,Renata And Howard,2,Entire home/apt,650,23,0.08,673
16509,Marwa,1,Private room,110,0,0.06,110
16510,Yuanyuan,1,Entire home/apt,199,93,1.51,292
16512,Letha M.,2,Entire home/apt,60,221,0.06,281
16515,Rachel,1,Private room,52,4,0.91,56
16516,Jordan,2,Entire home/apt,155,218,2.5,373
16517,George Steven,1,Entire home/apt,171,188,0.08,359
16518,Silvia,2,Private room,39,329,1.9,368
16519,Morgan,1,Shared room,120,0,0.32,120
16520,Harvey,2,Entire home/apt,115,105,1.47,220
16521,Justin,1,Entire home/apt,165,0,0.35,165
16522,Jeff,1,Private room,69,180,0.91,249
16523,Wil,2,Private room,55,0,0.03,55
16525,Noah,2,Entire home/apt,133,0,0.33,133
16526,Glenn,1,Private room,79,47,3.65,126
16528,Taeko,1,Entire home/apt,160,0,0.03,160
16529,Vlad,1,Entire home/apt,170,198,1.0,368
16530,Fone,3,Private room,45,0,0.09,45
16532,Caroline,1,Private room,66,0,0.17,66
16533,Dylana,2,Private room,52,74,3.59,126
16534,Luke,1,Entire home/apt,200,0,0.31,200
16535,Gg,1,Private room,80,45,7.45,125
16536,Diana,2,Private room,75,2,2.65,77
16537,Brian,1,Private room,125,0,0.13,125
16539,Aida,1,Private room,65,15,1.39,80
16540,Bernardo,1,Private room,79,0,0.05,79
16541,Ferenc,2,Entire home/apt,125,1,1.12,126
16542,Sean,2,Entire home/apt,105,0,0.36,105
16543,Arturo,2,Entire home/apt,140,275,3.26,415
16544,Pierre-Alexis,2,Private room,70,0,0.05,70
16545,James,1,Entire home/apt,2000,362,0.11,2362
16547,Sue,1,Shared room,75,231,0.26,306
16548,Paloma,2,Private room,36,0,0.09,36
16549,Karin,1,Entire home/apt,240,0,0.03,240
16550,Ozge,1,Entire home/apt,200,205,1.03,405
16552,Marie,2,Shared room,46,365,0.58,411
16553,Wallace,1,Entire home/apt,120,0,0.6,120
16554,Gillian,1,Private room,80,0,3.98,80
16555,Viviana,1,Entire home/apt,120,261,0.34,381
16556,Kevin,2,Entire home/apt,150,1,0.17,151
16558,Calliea,1,Entire home/apt,200,0,0.03,200
16559,Mark,1,Private room,100,0,0.03,100
16560,Dawn,2,Private room,73,359,0.14,432
16561,Aurelie,2,Private room,60,0,0.24,60
16562,Britt,2,Entire home/apt,110,0,0.08,110
16563,Viviana,1,Private room,55,246,1.68,301
16564,Nina,1,Entire home/apt,110,0,0.19,110
16565,Noel,1,Private room,70,0,0.11,70
16566,Yiming (Steven),2,Private room,60,0,0.06,60
16567,Benjamin,2,Entire home/apt,270,255,0.11,525
16569,Emily,1,Private room,100,0,0.11,100
16571,Omar,1,Entire home/apt,150,0,0.17,150
16572,CRNY Monthly Rentals,1,Entire home/apt,150,64,0.07,214
16573,Mario & Marijke,2,Private room,77,46,1.25,123
16574,David,2,Private room,59,0,2.31,59
16575,David,1,Private room,110,0,0.12,110
16576,David,1,Private room,110,280,0.26,390
16578,Roberto,3,Private room,125,0,0.17,125
16579,David,1,Private room,110,5,0.58,115
16580,David,2,Private room,89,0,1.83,89
16581,Fadi And Michael,2,Private room,75,0,0.19,75
16582,Christopher Und Nora,2,Private room,100,0,0.3,100
16583,Cory,2,Entire home/apt,250,0,0.14,250
16584,Maura,1,Entire home/apt,149,0,0.03,149
16585,Andrea,2,Private room,50,0,0.05,50
16587,Ryan,2,Entire home/apt,160,0,0.19,160
16588,Sophia,1,Private room,79,36,1.33,115
16591,Katharine,2,Private room,65,0,0.45,65
16592,Michael,2,Entire home/apt,95,0,0.03,95
16593,Gabrielle,1,Entire home/apt,185,0,0.05,185
16594,Marie-Luisa,2,Entire home/apt,68,0,0.11,68
16595,Dorothy,1,Private room,85,72,1.23,157
16596,Jocelyn,2,Private room,150,72,5.9,222
16597,Tobias,2,Private room,65,0,0.16,65
16598,Amara,1,Entire home/apt,200,0,0.05,200
16599,Maki,2,Private room,55,75,1.36,130
16601,Alex,1,Entire home/apt,250,0,0.03,250
16602,Simon,2,Private room,89,0,0.08,89
16603,Dylan,2,Private room,100,283,0.88,383
16604,Marissa,1,Entire home/apt,300,0,0.05,300
16605,Stefan,3,Private room,45,18,1.29,63
16606,Rlg,1,Entire home/apt,133,126,0.44,259
16607,Hardy,4,Entire home/apt,500,345,0.56,845
16608,Lannon,2,Private room,68,0,0.25,68
16609,Irina,2,Private room,56,110,1.61,166
16610,Laura,1,Private room,75,80,0.4,155
16612,Yukee,1,Private room,299,345,0.08,644
16613,Sam,2,Private room,51,35,2.42,86
16614,Breath Beyond,1,Private room,115,3,0.8,118
16615,Lucas,2,Entire home/apt,180,0,0.14,180
16616,Tiffany,2,Private room,50,3,0.08,53
16617,Angela,2,Private room,80,0,0.05,80
16618,Sarah,3,Entire home/apt,300,0,0.11,300
16619,Katelyn,2,Entire home/apt,79,70,4.21,149
16620,Katie,1,Entire home/apt,150,0,0.81,150
16621,Isa,2,Entire home/apt,94,94,2.71,188
16622,Michel,2,Private room,65,0,0.46,65
16623,Laura,1,Private room,83,125,0.74,208
16625,Maria,2,Entire home/apt,120,0,0.03,120
16626,Jean&  Toney,2,Private room,500,179,0.03,679
16629,Etta,1,Entire home/apt,150,139,2.41,289
16630,Roshan,2,Entire home/apt,149,69,1.1,218
16631,Mark,1,Entire home/apt,150,2,0.31,152
16632,David,1,Private room,75,0,0.08,75
16633,Anna,1,Entire home/apt,195,0,0.03,195
16634,Sarah,2,Private room,80,0,0.03,80
16635,Owen,1,Entire home/apt,250,0,0.29,250
16636,Julie,1,Entire home/apt,225,0,0.56,225
16637,Nate,1,Entire home/apt,450,0,1.16,450
16638,Wenqin,3,Private room,35,339,1.78,374
16639,Sunny,2,Private room,70,342,0.73,412
16640,Skye,2,Private room,80,0,0.03,80
16643,Laura,1,Private room,84,89,0.71,173
16644,Gabriel,1,Entire home/apt,172,0,0.08,172
16645,Lisa,1,Entire home/apt,110,0,0.14,110
16646,Jonathan,2,Private room,55,0,0.03,55
16647,Cesar,3,Private room,78,0,0.72,78
16648,Nicky,2,Entire home/apt,115,81,2.0,196
16649,Justin,1,Entire home/apt,180,0,0.03,180
16650,Yaron,4,Entire home/apt,139,131,0.8,270
16651,Juan,2,Private room,120,0,0.27,120
16652,Janea,2,Entire home/apt,77,0,0.03,77
16653,Paulo,1,Entire home/apt,150,0,0.03,150
16654,Thomas,1,Private room,67,0,0.03,67
16655,C-Van,1,Entire home/apt,159,0,0.35,159
16656,Gregory,2,Private room,100,0,0.08,100
16658,Stacey,1,Entire home/apt,199,0,0.11,199
16659,Habib,2,Private room,75,0,0.25,75
16660,Marie,1,Private room,70,0,0.06,70
16661,Yaron,4,Private room,49,148,1.59,197
16662,Yaron,4,Private room,41,146,1.54,187
16663,David,1,Private room,150,0,0.18,150
16664,John,1,Private room,60,73,1.94,133
16665,Shahar,3,Entire home/apt,40,0,0.11,40
16666,Rohit,3,Entire home/apt,99,5,0.11,104
16668,Carli,2,Private room,40,0,0.03,40
16669,Ana,3,Private room,100,161,0.92,261
16671,Beck,2,Private room,50,0,0.08,50
16672,Ivonne,1,Entire home/apt,110,0,0.26,110
16673,Daria,2,Entire home/apt,375,22,0.18,397
16674,Malene,2,Entire home/apt,229,236,2.54,465
16675,Darcy And Ross,2,Entire home/apt,175,298,3.54,473
16676,En & Lora,2,Private room,40,0,2.23,40
16677,Mimie,4,Private room,41,68,0.61,109
16678,Eugene,1,Private room,110,129,1.62,239
16679,Mindy,1,Entire home/apt,150,0,0.67,150
16680,Kathryn,1,Entire home/apt,165,0,0.13,165
16681,Kara,1,Entire home/apt,239,365,0.04,604
16682,Diana,3,Entire home/apt,125,271,2.39,396
16684,Emmanuel,3,Private room,80,83,0.1,163
16685,Jeanne,2,Entire home/apt,329,0,0.98,329
16686,Lyshaan,2,Entire home/apt,175,0,0.27,175
16687,Erika,1,Entire home/apt,150,0,0.08,150
16689,Ira,1,Entire home/apt,200,154,0.12,354
16690,Ania,2,Private room,75,0,0.22,75
16691,Dave And Shaceline,4,Entire home/apt,89,303,5.15,392
16692,Jeffrey,2,Entire home/apt,120,254,5.14,374
16693,Adriana,1,Private room,35,0,0.03,35
16694,David,2,Private room,100,0,0.63,100
16696,Penny,2,Private room,70,0,0.03,70
16697,Anne,2,Entire home/apt,114,0,0.08,114
16698,Vanessa,1,Entire home/apt,200,34,3.24,234
16701,Vianney,1,Entire home/apt,199,0,0.03,199
16703,Nicole,1,Entire home/apt,199,127,0.11,326
16704,Vernon,4,Private room,40,266,0.61,306
16705,Michael,3,Entire home/apt,200,6,0.49,206
16707,Alice,1,Entire home/apt,140,0,0.17,140
16708,Ioannis,3,Entire home/apt,50,0,0.08,50
16709,Jamie,1,Entire home/apt,375,351,1.5,726
16710,Scott,2,Entire home/apt,250,114,0.18,364
16711,Colin,2,Private room,40,0,0.06,40
16712,Patrick,1,Private room,99,365,0.59,464
16713,Farrah,2,Entire home/apt,140,0,0.08,140
16714,Aaron,5,Entire home/apt,150,83,0.12,233
16715,Gregory,2,Private room,75,0,0.05,75
16716,Robert,2,Private room,55,48,0.8,103
16717,Althea,2,Entire home/apt,145,314,2.18,459
16718,Elise,2,Entire home/apt,95,39,2.56,134
16719,Ashton,2,Entire home/apt,69,0,0.13,69
16720,Lauren Wesley,2,Entire home/apt,175,99,1.44,274
16721,Jamie,1,Entire home/apt,350,297,1.3,647
16722,Sarah-Jane,1,Private room,119,0,0.44,119
16723,Carole,1,Private room,160,0,0.08,160
16724,Kyla,2,Private room,55,0,1.51,55
16725,Cem,3,Private room,48,71,1.27,119
16726,Wyatt,1,Private room,85,0,0.24,85
16727,Evan,1,Entire home/apt,97,0,0.08,97
16728,Moenen,2,Entire home/apt,110,0,0.52,110
16729,Landon,1,Entire home/apt,91,0,0.03,91
16730,Brendan,2,Entire home/apt,150,0,0.03,150
16731,Will,1,Private room,80,0,0.11,80
16732,Sylvia,2,Private room,60,0,0.04,60
16733,Giselle,2,Private room,55,0,0.19,55
16735,Kris,2,Entire home/apt,163,154,0.52,317
16737,Victoria,1,Private room,54,0,0.05,54
16738,Allison,2,Private room,46,0,0.03,46
16739,Fahim,3,Entire home/apt,125,50,0.85,175
16740,Brian,2,Entire home/apt,150,300,5.13,450
16741,En & Lora,2,Private room,47,0,2.32,47
16743,Josh+Emily,2,Entire home/apt,120,0,0.05,120
16744,Gregory,1,Private room,67,0,0.23,67
16745,Jamie,2,Entire home/apt,73,3,3.49,76
16746,Petra,2,Entire home/apt,128,133,2.0,261
16747,Ella,2,Entire home/apt,121,14,0.64,135
16748,Joshua,2,Entire home/apt,250,0,0.08,250
16749,Catalina,1,Entire home/apt,80,0,0.11,80
16750,Rahel,1,Entire home/apt,77,0,0.05,77
16752,Corporate Housing,1,Entire home/apt,117,105,0.4,222
16753,Easton,2,Private room,75,0,0.62,75
16754,Michelle,3,Entire home/apt,99,211,5.28,310
16755,Stephen,1,Entire home/apt,279,0,0.05,279
16756,Eddie,1,Entire home/apt,140,0,1.47,140
16759,Jilly,2,Private room,95,0,0.24,95
16761,Imri,1,Private room,149,156,0.68,305
16763,Zachary,1,Entire home/apt,250,0,0.05,250
16764,Victoria,2,Entire home/apt,150,0,0.38,150
16765,Benjamin,2,Entire home/apt,120,342,0.38,462
16766,Kyle,1,Private room,85,0,0.08,85
16770,Sam,1,Entire home/apt,90,221,0.24,311
16771,Kevin And Kitty,3,Private room,45,287,3.77,332
16772,Sabina,2,Private room,100,0,0.06,100
16773,Brook,1,Private room,89,165,3.62,254
16774,Corporate Housing,1,Entire home/apt,199,0,0.14,199
16775,Godfrey,1,Entire home/apt,76,30,0.31,106
16776,Nancy,2,Entire home/apt,143,0,0.08,143
16777,Jessy,2,Shared room,40,0,0.91,40
16778,Hope,1,Entire home/apt,125,7,0.84,132
16780,Erika,3,Entire home/apt,110,0,0.11,110
16783,Kareem,1,Entire home/apt,300,0,0.43,300
16784,Greg & Adriane,2,Entire home/apt,99,29,3.98,128
16785,Kristina,2,Entire home/apt,125,216,2.65,341
16787,Kevin,1,Private room,80,0,0.73,80
16788,Miguel,1,Private room,150,0,0.32,150
16790,Ana,2,Private room,40,0,0.03,40
16791,Tobias,2,Entire home/apt,250,0,0.13,250
16792,Betsy,1,Entire home/apt,450,221,3.73,671
16793,Rich,2,Private room,50,90,0.33,140
16794,Nell,2,Entire home/apt,75,0,0.13,75
16795,Alex,1,Entire home/apt,139,235,2.74,374
16796,Corporate Housing,1,Entire home/apt,200,101,0.12,301
16797,Robert,2,Private room,65,309,2.7,374
16798,Dawn,2,Entire home/apt,115,282,2.44,397
16799,Taylor,1,Private room,70,0,0.11,70
16800,Deena,2,Entire home/apt,50,0,0.05,50
16801,Eduardo,1,Private room,85,0,0.11,85
16802,John,1,Entire home/apt,275,0,0.03,275
16803,Gabriela,3,Entire home/apt,120,365,1.45,485
16804,Corporate Housing,1,Entire home/apt,185,0,0.13,185
16805,Connie,1,Entire home/apt,150,0,0.05,150
16806,Oded,1,Entire home/apt,145,0,0.08,145
16807,Jill,2,Entire home/apt,130,0,0.03,130
16809,Utku,1,Entire home/apt,88,0,0.06,88
16812,Omar,1,Private room,64,0,0.03,64
16813,CRNY Monthly Rentals,1,Entire home/apt,185,139,0.04,324
16814,Kai,1,Entire home/apt,165,358,0.9,523
16815,Matt,2,Entire home/apt,200,0,0.09,200
16817,Mathieu,2,Private room,90,0,0.65,90
16818,Amine,1,Entire home/apt,140,0,0.33,140
16819,Andrew,2,Entire home/apt,150,0,0.43,150
16820,Juan,2,Entire home/apt,92,113,0.5,205
16821,Jp,1,Private room,100,243,2.12,343
16822,Miriam,2,Entire home/apt,135,21,0.03,156
16823,Devon,2,Entire home/apt,45,244,2.99,289
16824,Sasha,4,Entire home/apt,110,77,0.3,187
16825,Andre,1,Private room,250,358,0.05,608
16827,Jeremy,1,Private room,175,19,3.19,194
16828,Jyllian,2,Entire home/apt,175,16,0.14,191
16830,Eleanor,2,Entire home/apt,99,0,0.11,99
16833,Kara,1,Entire home/apt,235,365,0.04,600
16834,Ruby,2,Private room,45,0,0.03,45
16835,Michael And Sandra,5,Entire home/apt,85,248,2.97,333
16837,Hakan,3,Private room,38,24,1.46,62
16838,Neel,3,Private room,65,0,0.03,65
16839,Maija,1,Entire home/apt,79,0,1.14,79
16842,Kara,1,Entire home/apt,239,179,0.08,418
16844,Mason,2,Private room,35,0,0.37,35
16845,Kara,1,Entire home/apt,239,365,0.04,604
16847,Yaron,4,Private room,33,145,1.75,178
16848,Kara,1,Entire home/apt,239,365,0.04,604
16849,Kara,1,Entire home/apt,239,365,0.07,604
16851,Kyle,1,Entire home/apt,229,0,0.08,229
16852,Agustina,4,Private room,45,156,1.83,201
16853,Kara,1,Entire home/apt,239,365,0.03,604
16854,Alexandrinho,1,Entire home/apt,179,151,2.71,330
16856,Kara,1,Entire home/apt,239,357,0.06,596
16860,Sister Shai,3,Entire home/apt,100,350,1.22,450
16861,Matt,2,Private room,55,0,0.19,55
16862,Laszlo,2,Private room,95,0,0.09,95
16863,Cassidy,2,Private room,41,0,0.05,41
16864,Steven,2,Entire home/apt,40,223,0.7,263
16865,Kyle,1,Entire home/apt,150,213,0.06,363
16866,Kyle,1,Entire home/apt,150,335,0.77,485
16867,Kyle,1,Entire home/apt,219,362,0.3,581
16868,Christine,1,Entire home/apt,142,78,3.92,220
16869,Nicole,4,Entire home/apt,99,264,2.87,363
16870,En & Lora,2,Private room,41,0,2.18,41
16871,Andrew,1,Private room,48,0,0.06,48
16873,Mayra,1,Private room,52,0,0.28,52
16874,Paul,2,Entire home/apt,150,0,0.12,150
16876,Alisa,1,Private room,160,0,0.27,160
16877,Sayre,2,Private room,45,0,0.05,45
16879,Clair&Charles,3,Entire home/apt,178,342,2.22,520
16880,Kyle,1,Entire home/apt,176,0,0.15,176
16881,Cam,1,Private room,70,0,0.19,70
16882,Lucy,2,Entire home/apt,190,2,0.25,192
16883,Raphaëlle,2,Private room,62,0,0.13,62
16884,Joel,2,Entire home/apt,175,0,0.03,175
16885,Raoul,1,Entire home/apt,125,0,0.05,125
16886,Anna & Keith,1,Private room,76,12,3.4,88
16887,Nancy And David,2,Entire home/apt,225,0,0.05,225
16888,Chris And Zaneta,2,Private room,65,0,0.35,65
16889,Justin,2,Private room,70,0,0.14,70
16890,Kent,1,Entire home/apt,240,0,0.11,240
16891,Lee,3,Private room,70,77,0.42,147
16892,Jessica,1,Entire home/apt,130,0,0.03,130
16893,Xier,1,Private room,50,0,0.03,50
16894,Marta,2,Private room,70,190,1.63,260
16897,Arman,1,Entire home/apt,169,280,0.17,449
16898,Mikalena,2,Private room,50,0,0.08,50
16899,Yi Qun,1,Private room,120,360,0.57,480
16900,Yi Qun,1,Private room,120,338,0.35,458
16902,Andi,2,Private room,90,305,2.43,395
16903,Jesse,2,Entire home/apt,105,85,0.84,190
16904,Kris,2,Entire home/apt,130,0,0.59,130
16906,Lau,2,Entire home/apt,100,0,0.08,100
16907,Tony,1,Entire home/apt,288,0,0.06,288
16908,Kyle,1,Entire home/apt,150,332,0.04,482
16909,Matthew,2,Private room,85,0,0.03,85
16910,Samantha,2,Entire home/apt,75,0,0.22,75
16912,Cooper,1,Entire home/apt,200,0,0.76,200
16913,Laye,1,Entire home/apt,78,0,0.35,78
16914,Panya,1,Entire home/apt,234,0,0.11,234
16915,Valeria,1,Entire home/apt,325,118,0.2,443
16916,Dominik,1,Private room,119,0,0.09,119
16917,Dominik,1,Private room,95,0,0.27,95
16918,Dayne,3,Entire home/apt,255,268,3.18,523
16919,Angelo,3,Entire home/apt,125,56,0.47,181
16920,Emma,1,Private room,99,0,0.08,99
16921,Allon,1,Entire home/apt,175,0,0.75,175
16923,Richard,2,Entire home/apt,75,53,1.14,128
16924,Breiana,2,Private room,50,0,0.03,50
16925,Deirdre,2,Entire home/apt,99,308,3.27,407
16926,Nat,2,Entire home/apt,85,52,1.27,137
16927,Stephen,1,Entire home/apt,137,0,0.05,137
16928,Anna,1,Entire home/apt,165,10,0.38,175
16929,Brett,2,Entire home/apt,92,7,0.31,99
16930,Julie,1,Entire home/apt,101,0,0.03,101
16931,David,1,Private room,95,89,0.38,184
16932,Mary,1,Private room,119,0,0.11,119
16933,Susan,2,Entire home/apt,195,230,4.03,425
16934,Eugene,1,Entire home/apt,170,0,0.24,170
16935,Lili,1,Entire home/apt,150,6,1.27,156
16936,Jerrel,1,Entire home/apt,157,0,0.29,157
16938,Zakaria,4,Private room,30,0,0.3,30
16939,Bryan,2,Entire home/apt,250,0,0.16,250
16940,Amanda,2,Private room,40,0,0.11,40
16941,Noemi,3,Entire home/apt,80,365,0.1,445
16943,Douglas,1,Private room,49,0,0.03,49
16944,James,1,Private room,101,116,2.97,217
16946,Gianni,1,Entire home/apt,199,242,0.98,441
16948,Antoine,2,Entire home/apt,175,0,0.03,175
16949,Nina,1,Entire home/apt,175,0,0.05,175
16950,Roberto,2,Private room,50,102,2.1,152
16951,Reynaldo,1,Private room,45,0,0.03,45
16952,Maria,3,Entire home/apt,110,74,1.0,184
16953,Alicia,2,Entire home/apt,70,0,0.08,70
16954,Ivan And Emily,2,Entire home/apt,129,0,0.03,129
16955,Kylie,1,Entire home/apt,139,0,0.23,139
16956,Ksenia,2,Entire home/apt,135,0,0.06,135
16957,Pepa,1,Entire home/apt,90,0,0.09,90
16958,Stacey Rae,2,Entire home/apt,125,20,1.41,145
16960,Petros,3,Entire home/apt,75,0,0.03,75
16961,Bernardo,1,Private room,65,0,0.14,65
16962,Kelly,1,Entire home/apt,190,0,0.05,190
16963,Erez,2,Entire home/apt,85,0,0.03,85
16964,Anne,2,Entire home/apt,119,313,1.04,432
16966,Natalia,1,Entire home/apt,196,29,0.52,225
16968,Anna,1,Private room,90,338,1.76,428
16969,Blake,2,Private room,125,0,0.03,125
16970,Shannon,1,Private room,65,0,0.03,65
16971,Adam,1,Entire home/apt,110,0,0.16,110
16972,Illy,1,Entire home/apt,100,340,0.09,440
16975,Vinciane,1,Entire home/apt,360,333,0.66,693
16977,Michele,2,Private room,65,10,1.08,75
16978,Emily,2,Private room,65,0,0.58,65
16979,Daniel,2,Entire home/apt,160,0,0.08,160
16980,Julie,2,Entire home/apt,450,360,0.64,810
16981,Roxy,1,Private room,75,0,0.08,75
16982,Justin,1,Private room,69,0,0.54,69
16983,C.S.,2,Entire home/apt,203,0,0.13,203
16984,Sue,1,Private room,169,88,0.51,257
16985,Justin,1,Private room,79,18,0.84,97
16986,DrAnita,1,Entire home/apt,230,41,0.33,271
16987,Sarah,3,Private room,65,278,1.11,343
16988,Meghan,2,Private room,50,0,0.16,50
16989,Giovanna,2,Private room,100,365,0.3,465
16990,Verena,3,Private room,70,250,0.4,320
16991,Will,1,Entire home/apt,175,0,0.03,175
16992,Neil,2,Private room,142,10,0.22,152
16993,Shanee,2,Entire home/apt,190,226,1.07,416
16998,Andrew,2,Private room,61,0,0.21,61
17000,Kyle,1,Private room,80,0,0.41,80
17001,Ken,1,Entire home/apt,225,341,0.03,566
17003,Sam,1,Entire home/apt,100,243,0.11,343
17004,Carlos,2,Entire home/apt,50,0,0.03,50
17005,Bernadette,1,Private room,109,140,0.91,249
17006,Nicole,1,Private room,75,0,0.3,75
17008,Jessica,2,Private room,60,0,0.41,60
17010,Rachel,1,Entire home/apt,130,0,0.16,130
17011,Tom & Lily,2,Private room,65,300,2.83,365
17012,Ryan,1,Private room,90,0,0.16,90
17013,Daniel,2,Private room,50,0,0.03,50
17014,Lori,1,Private room,67,4,0.3,71
17015,Howard,2,Entire home/apt,100,0,0.38,100
17018,Nicholas,3,Entire home/apt,100,0,0.03,100
17019,Ashley,2,Entire home/apt,300,11,0.47,311
17022,Ken,1,Entire home/apt,167,342,0.04,509
17023,Hudson,1,Entire home/apt,180,0,0.35,180
17024,Bev,2,Entire home/apt,95,0,0.3,95
17026,Sunny,2,Private room,85,115,0.92,200
17027,Ephraim,1,Entire home/apt,115,45,3.21,160
17028,Tny,1,Entire home/apt,150,267,0.36,417
17029,Stephen,2,Entire home/apt,80,0,0.08,80
17032,Pippa,2,Entire home/apt,325,0,0.07,325
17033,Iris,1,Private room,99,59,1.06,158
17034,Judah,1,Private room,90,66,0.08,156
17035,Ephraim,1,Entire home/apt,110,44,3.37,154
17038,Sen & Ti,5,Entire home/apt,105,318,3.55,423
17042,Andre,2,Private room,80,189,0.21,269
17043,Marielle,2,Entire home/apt,120,0,0.05,120
17044,Andre,2,Private room,525,189,0.99,714
17045,Brian,1,Entire home/apt,150,157,0.23,307
17047,Andre,2,Private room,90,189,0.11,279
17048,Miraya,2,Entire home/apt,130,0,0.18,130
17049,Llerone,2,Entire home/apt,155,0,0.53,155
17050,Ben,1,Private room,90,0,0.22,90
17051,Josh,1,Private room,90,0,0.03,90
17053,Allan,1,Entire home/apt,199,246,3.02,445
17054,Seohee,1,Shared room,70,0,0.04,70
17055,Elizabeth,1,Private room,36,0,0.06,36
17056,Joel,1,Private room,59,0,0.38,59
17057,Bridget,1,Entire home/apt,185,26,0.92,211
17058,Arthur,2,Entire home/apt,75,89,1.25,164
17060,Sijia,2,Private room,75,37,4.58,112
17061,Henry,3,Private room,74,33,5.66,107
17063,Eric,1,Entire home/apt,161,0,0.74,161
17064,Ken,1,Entire home/apt,260,341,0.07,601
17067,Cheryn,2,Private room,60,0,0.08,60
17068,Joshua,1,Private room,100,0,0.03,100
17071,Sarah,2,Entire home/apt,175,0,0.17,175
17072,Eric,2,Entire home/apt,250,254,0.27,504
17074,Mike,1,Entire home/apt,95,342,0.23,437
17075,CRNY Monthly Rentals,1,Entire home/apt,250,215,0.04,465
17077,Fernando,2,Private room,76,0,0.21,76
17078,Dori,1,Entire home/apt,200,0,0.03,200
17079,Ken,1,Entire home/apt,199,329,0.09,528
17080,Zahra,1,Entire home/apt,140,0,0.93,140
17081,Keryn,1,Private room,57,0,0.11,57
17082,Morgan,2,Private room,60,0,0.05,60
17083,Tracey,2,Entire home/apt,80,0,0.17,80
17084,Philippia,3,Entire home/apt,125,0,0.06,125
17085,Corporate Housing,1,Entire home/apt,150,319,0.07,469
17086,Richard,2,Entire home/apt,70,3,2.12,73
17087,Rlg,1,Entire home/apt,125,325,0.32,450
17088,Austin,2,Private room,56,0,0.03,56
17089,Lauren And Ben,2,Entire home/apt,170,65,2.67,235
17090,Gayle,1,Entire home/apt,179,3,0.65,182
17091,Para,2,Entire home/apt,75,0,0.06,75
17093,George Steven,1,Entire home/apt,295,0,0.06,295
17094,Ondina,2,Entire home/apt,150,0,0.16,150
17095,Taran & Najla,3,Entire home/apt,174,340,1.81,514
17096,W. Alvaro,1,Private room,67,90,0.59,157
17098,Jewel,2,Private room,62,48,4.52,110
17099,Laura,3,Private room,150,0,0.05,150
17100,Marcus,2,Private room,115,82,0.09,197
17101,Angela,3,Private room,40,293,1.82,333
17103,Ken,1,Entire home/apt,149,339,0.08,488
17104,Evan,1,Entire home/apt,125,125,4.88,250
17105,W. Alvaro,1,Private room,73,90,0.31,163
17106,Jay Cee,1,Entire home/apt,200,3,0.22,203
17107,Anne-Marie,2,Private room,34,0,0.03,34
17112,Timothy + Gina,2,Private room,89,64,4.1,153
17113,Aris,2,Entire home/apt,115,0,0.11,115
17114,Frank,1,Entire home/apt,200,268,1.42,468
17115,Daniel,1,Entire home/apt,100,100,1.11,200
17117,Daniel,2,Private room,58,0,0.03,58
17118,Jessie,1,Private room,81,0,0.52,81
17119,Stephanie,1,Private room,95,281,0.05,376
17120,Gregory,2,Private room,38,67,4.27,105
17121,Cate,1,Entire home/apt,150,11,0.19,161
17122,Sofia,1,Private room,40,0,0.1,40
17124,Krystina,1,Entire home/apt,99,0,0.3,99
17125,Edward,2,Entire home/apt,250,0,0.03,250
17126,Paul,1,Private room,69,0,0.03,69
17127,Cortland,2,Private room,35,0,0.03,35
17128,Brian,2,Private room,65,0,0.08,65
17130,Chris,2,Entire home/apt,150,0,0.14,150
17131,Laura,2,Entire home/apt,270,0,0.25,270
17132,Silvia,2,Entire home/apt,150,327,1.08,477
17134,Vincent And Jessica,3,Entire home/apt,119,0,0.52,119
17135,Bozhena,1,Entire home/apt,129,246,4.31,375
17136,Shoshana,2,Entire home/apt,175,144,2.9,319
17137,Sarah,2,Private room,40,0,0.08,40
17138,Anthony,2,Entire home/apt,125,0,0.03,125
17139,William,3,Entire home/apt,101,7,2.52,108
17140,David,1,Private room,49,285,0.17,334
17141,Shervin,1,Entire home/apt,300,3,0.41,303
17142,Sarah,2,Private room,75,125,1.0,200
17143,Michael,2,Entire home/apt,85,62,5.85,147
17144,Matthew,2,Entire home/apt,185,50,1.34,235
17145,Jay,1,Entire home/apt,185,65,4.88,250
17147,Nathan,1,Private room,110,0,0.03,110
17148,Mira,2,Private room,65,249,1.28,314
17149,Alex,1,Entire home/apt,185,292,0.21,477
17150,Jungwon,2,Entire home/apt,195,0,0.11,195
17151,Miriam,1,Private room,85,16,0.71,101
17152,Patricia,1,Entire home/apt,295,0,1.33,295
17153,Doreen,2,Private room,120,0,0.59,120
17154,Dragica,2,Entire home/apt,189,15,0.41,204
17156,Ryad,1,Entire home/apt,123,1,0.9,124
17157,Mariam,1,Private room,89,0,0.03,89
17158,Valeryia,1,Entire home/apt,140,0,0.18,140
17159,Corie,2,Entire home/apt,85,337,2.87,422
17160,Ronald,1,Entire home/apt,169,242,3.28,411
17161,Mel And Laurie,1,Entire home/apt,145,0,0.11,145
17162,Valentina,2,Entire home/apt,145,11,1.74,156
17163,Rick,1,Entire home/apt,165,0,0.35,165
17165,Devi,2,Private room,99,36,0.28,135
17167,Joshua,2,Private room,40,0,0.09,40
17168,Karine,1,Private room,115,15,0.59,130
17169,Mario & Marijke,2,Entire home/apt,157,0,0.12,157
17170,Paula,2,Entire home/apt,1000,365,0.28,1365
17171,Shamaine,2,Private room,72,333,0.68,405
17172,Jasmina,3,Private room,40,179,1.63,219
17174,Tunde,2,Entire home/apt,90,4,2.22,94
17175,Angel,1,Private room,65,0,0.18,65
17176,Mary,1,Private room,79,0,0.16,79
17177,Phillipa,2,Entire home/apt,350,344,1.0,694
17178,Lexia,2,Entire home/apt,71,69,1.25,140
17179,Xiaoxu,1,Private room,50,0,0.03,50
17180,Raymond,1,Entire home/apt,115,289,0.14,404
17182,Ashlee,1,Private room,70,0,0.06,70
17183,Jennifer,1,Entire home/apt,110,34,0.17,144
17184,Dominique,2,Entire home/apt,140,0,0.17,140
17185,Ashley,1,Entire home/apt,89,5,0.34,94
17186,Lauren,1,Entire home/apt,259,0,0.08,259
17187,Niki,1,Entire home/apt,160,40,1.3,200
17188,Heather,1,Entire home/apt,113,0,0.03,113
17190,Cynthia,1,Entire home/apt,125,67,0.7,192
17191,JacQueline,1,Entire home/apt,105,0,0.06,105
17193,Connie,2,Private room,125,151,1.36,276
17195,Nekeshia,1,Entire home/apt,275,12,0.33,287
17197,Isabelle,2,Private room,65,199,3.45,264
17198,Amy,1,Entire home/apt,400,0,0.06,400
17199,Corporate Housing,1,Entire home/apt,159,312,0.14,471
17200,Christina,1,Entire home/apt,200,0,0.3,200
17201,Lauren,1,Private room,225,0,0.03,225
17202,Priya,1,Entire home/apt,199,0,0.09,199
17203,Christina,1,Shared room,75,0,0.16,75
17204,Gina,2,Private room,44,0,0.03,44
17205,Aidan,2,Private room,100,0,0.03,100
17206,Meg,2,Entire home/apt,130,80,0.59,210
17207,Alba,1,Entire home/apt,408,106,0.85,514
17208,Freddy,2,Entire home/apt,120,0,0.12,120
17211,Suzanne,3,Private room,80,0,0.49,80
17212,Sarah,2,Private room,60,0,0.03,60
17214,Melanie,3,Entire home/apt,125,0,0.14,125
17215,Marissa,1,Entire home/apt,200,0,0.68,200
17216,Blaine,1,Entire home/apt,199,250,2.96,449
17217,Damian,1,Entire home/apt,265,364,0.18,629
17218,Barbara,1,Entire home/apt,700,0,0.5,700
17219,Thaya,1,Private room,80,28,0.94,108
17220,Jessie,2,Private room,35,0,0.05,35
17221,Satsko,1,Entire home/apt,135,76,2.81,211
17222,Lawrence,1,Private room,70,0,0.09,70
17225,Ali,2,Entire home/apt,135,0,0.03,135
17227,Jessica,1,Entire home/apt,128,0,0.08,128
17228,Christina,2,Private room,60,1,1.33,61
17229,Lana,2,Entire home/apt,170,0,0.06,170
17230,Elizabeth,1,Private room,85,0,0.11,85
17231,Dominic,3,Private room,60,0,0.17,60
17233,Chris,1,Entire home/apt,349,0,0.79,349
17237,Jessica,2,Entire home/apt,200,0,0.08,200
17238,Karine,1,Private room,110,0,0.03,110
17239,Gary,1,Entire home/apt,325,0,1.3,325
17241,Charles,2,Entire home/apt,180,0,0.07,180
17242,Joshua,1,Entire home/apt,134,0,0.65,134
17243,Conrad,1,Entire home/apt,150,207,0.37,357
17245,Ella,2,Entire home/apt,200,257,1.71,457
17246,Savannah,2,Entire home/apt,110,0,0.2,110
17247,Nate,2,Entire home/apt,105,0,0.3,105
17250,Tatenda,1,Entire home/apt,165,0,0.08,165
17251,Justin,1,Private room,75,184,0.11,259
17252,Rebekah,2,Entire home/apt,104,182,3.13,286
17253,Jem,1,Entire home/apt,130,0,0.42,130
17254,Paulina,1,Private room,130,0,0.11,130
17255,Susan,1,Entire home/apt,145,0,0.23,145
17256,Gladys,1,Private room,60,157,0.03,217
17257,Marilyn,3,Private room,40,179,0.03,219
17259,T,1,Entire home/apt,99,0,0.2,99
17261,Crispy,3,Private room,70,215,1.58,285
17262,Elvira,2,Entire home/apt,109,107,2.53,216
17263,Zhenya,1,Entire home/apt,250,23,0.15,273
17264,Katie,1,Entire home/apt,129,0,0.11,129
17266,Eric,1,Entire home/apt,150,39,1.33,189
17267,Kacie,1,Entire home/apt,198,0,0.22,198
17268,Janeth,2,Private room,55,89,0.14,144
17269,Demarius,1,Private room,61,0,0.11,61
17270,Ron,3,Entire home/apt,90,0,0.05,90
17271,Weipeng,1,Private room,45,0,0.06,45
17272,Tory,3,Entire home/apt,200,4,0.95,204
17273,Tanisha,2,Private room,60,0,0.07,60
17275,Sushil,2,Entire home/apt,125,0,0.08,125
17278,Yenmin,2,Private room,35,0,0.06,35
17279,Laureta,3,Private room,40,57,3.17,97
17281,Anna,2,Entire home/apt,100,222,0.06,322
17282,Jens,2,Entire home/apt,259,7,0.11,266
17283,Danielle,1,Entire home/apt,129,0,0.25,129
17284,Cynthia,2,Entire home/apt,89,1,0.09,90
17286,Alina,2,Entire home/apt,135,7,0.25,142
17287,Nimmi,1,Entire home/apt,200,0,0.03,200
17288,Andrew,1,Private room,90,0,0.22,90
17289,Pol,2,Entire home/apt,200,3,0.03,203
17291,Kat,2,Entire home/apt,150,100,1.93,250
17292,Sarah,1,Entire home/apt,110,0,0.05,110
17293,Paula,1,Entire home/apt,150,0,0.03,150
17294,Amy,1,Private room,115,0,0.11,115
17295,Mari,2,Private room,42,0,0.22,42
17296,Simon,2,Private room,75,0,0.03,75
17297,Sadie,1,Entire home/apt,189,27,1.95,216
17298,Reylyn,1,Entire home/apt,125,0,0.19,125
17300,Host,1,Entire home/apt,175,283,0.14,458
17301,Denis,1,Private room,99,0,1.3,99
17302,Kathryn,4,Entire home/apt,85,299,1.19,384
17303,Host,1,Entire home/apt,185,346,0.29,531
17304,Christopher,1,Entire home/apt,177,0,0.05,177
17305,Julie,2,Private room,100,0,0.68,100
17306,Mickey,1,Entire home/apt,102,0,0.42,102
17307,Thomas,1,Entire home/apt,120,0,0.11,120
17308,Nina,1,Entire home/apt,155,0,0.05,155
17309,Nzingha,1,Private room,67,0,0.98,67
17310,Albert,2,Private room,50,0,0.04,50
17312,Darryle,5,Entire home/apt,100,88,0.57,188
17313,Vanessa,1,Entire home/apt,125,0,0.06,125
17315,Cameron,2,Private room,39,0,0.05,39
17317,Rlg,1,Entire home/apt,125,0,0.25,125
17318,Rlg,1,Entire home/apt,133,126,0.34,259
17319,George,2,Entire home/apt,149,189,0.08,338
17320,Mark,2,Private room,110,41,6.19,151
17321,Ivan,2,Private room,150,0,0.06,150
17322,Jay And Katt,3,Entire home/apt,205,324,1.41,529
17323,Jenson,1,Entire home/apt,100,16,0.57,116
17324,Nesha,2,Private room,30,27,0.54,57
17325,Florence,1,Private room,69,0,0.03,69
17327,Robert,2,Entire home/apt,190,0,0.09,190
17329,Jacob,2,Private room,79,179,0.03,258
17330,Josh,1,Entire home/apt,176,143,2.99,319
17331,Amjad,2,Entire home/apt,199,0,0.63,199
17333,Alexander,2,Private room,64,0,0.06,64
17337,Theodora,1,Entire home/apt,118,0,0.03,118
17338,Sebastien,1,Entire home/apt,189,362,0.19,551
17339,Izzi,1,Private room,79,0,0.08,79
17340,Sam,2,Entire home/apt,75,0,0.05,75
17341,Stepha,2,Entire home/apt,100,0,0.06,100
17343,Fred,2,Private room,65,0,3.5,65
17344,Julia,3,Entire home/apt,90,310,3.31,400
17345,Eduardo,4,Entire home/apt,65,0,0.25,65
17346,Katrina,1,Entire home/apt,125,308,0.79,433
17347,Victor,1,Private room,124,147,4.58,271
17348,Keona,2,Entire home/apt,120,0,0.94,120
17349,Blondine,2,Entire home/apt,300,218,2.43,518
17350,Luffy,3,Shared room,27,361,0.35,388
17352,W. Alvaro,1,Private room,86,90,0.93,176
17355,Xi,1,Private room,50,0,0.46,50
17356,Lara,1,Entire home/apt,155,0,0.03,155
17357,Ben,1,Private room,90,0,0.12,90
17358,Mari,2,Private room,44,0,0.43,44
17361,Dori,2,Private room,90,0,0.44,90
17362,Sabrina,1,Entire home/apt,118,0,0.16,118
17363,Victor,4,Private room,42,0,0.06,42
17364,Sava,1,Private room,57,0,0.11,57
17365,Jordan,2,Entire home/apt,150,0,0.24,150
17369,Brian,1,Private room,65,11,2.79,76
17370,Bryan,1,Private room,40,0,0.41,40
17375,Brigitte,1,Private room,59,0,0.26,59
17377,Lb,2,Entire home/apt,300,83,0.03,383
17378,Weimin,3,Private room,59,0,0.41,59
17379,Lea,2,Private room,45,0,0.05,45
17380,Yarynka,1,Private room,110,146,1.0,256
17381,Sam,2,Private room,65,0,0.11,65
17382,Scott,2,Entire home/apt,130,0,0.08,130
17384,Liz,2,Entire home/apt,111,0,0.05,111
17385,Eugene,3,Private room,48,0,0.17,48
17386,David,2,Private room,65,300,1.28,365
17387,Brian,1,Private room,75,0,0.46,75
17389,Haley,1,Private room,99,0,0.28,99
17390,Amy,2,Entire home/apt,225,0,0.08,225
17391,Ljubenka,3,Private room,65,68,0.28,133
17392,David,1,Private room,51,220,0.25,271
17393,Jennifer,2,Entire home/apt,175,0,0.14,175
17394,Alejandra,1,Private room,120,0,0.06,120
17395,Lisa,1,Private room,49,0,0.33,49
17397,Brian,4,Entire home/apt,71,34,3.24,105
17399,Faisal,1,Entire home/apt,119,0,0.03,119
17401,Emmanuel,1,Entire home/apt,185,114,4.07,299
17402,Sam & Emily,2,Entire home/apt,115,294,6.23,409
17405,Sarah,1,Private room,50,0,0.03,50
17406,Mas,2,Private room,80,0,0.6,80
17407,Hugh,1,Entire home/apt,95,0,0.06,95
17409,Paulette,3,Private room,40,352,5.12,392
17410,Chris,1,Shared room,30,0,0.27,30
17411,Amanda,1,Entire home/apt,225,0,0.03,225
17412,Yuan,2,Private room,65,0,0.34,65
17414,Alejandra,3,Entire home/apt,125,3,0.33,128
17415,Maggie,2,Entire home/apt,89,0,0.39,89
17416,Host,1,Entire home/apt,300,310,0.06,610
17417,N-And-A,2,Entire home/apt,200,298,1.41,498
17418,Josh,1,Entire home/apt,200,0,0.47,200
17419,Ramses,1,Entire home/apt,129,0,0.31,129
17420,Barbara,1,Entire home/apt,495,285,1.51,780
17421,Beatrice,1,Private room,125,121,0.42,246
17422,Tiz,2,Entire home/apt,185,77,2.58,262
17423,Samantha,1,Private room,92,0,0.11,92
17425,Joy And Mike,2,Entire home/apt,120,0,0.06,120
17427,Anmarie,2,Entire home/apt,80,97,2.86,177
17429,Alex,1,Entire home/apt,85,0,0.08,85
17430,Eric,2,Private room,55,0,0.31,55
17431,Fred,2,Private room,82,0,0.15,82
17432,Rafael,1,Entire home/apt,150,0,0.49,150
17433,Euni,1,Entire home/apt,250,0,0.08,250
17434,Sue,2,Entire home/apt,150,0,0.08,150
17435,Bryan,2,Entire home/apt,121,0,0.12,121
17436,Elena,3,Entire home/apt,350,0,0.03,350
17438,Michel,2,Private room,45,85,0.7,130
17440,Akash,2,Private room,200,364,0.15,564
17441,Anita,2,Entire home/apt,120,53,1.36,173
17442,Alex,1,Entire home/apt,175,238,3.31,413
17443,Sergey,5,Entire home/apt,120,310,2.26,430
17444,Dana,2,Private room,49,0,0.06,49
17445,Masha,1,Entire home/apt,250,0,0.11,250
17446,Adrian,1,Entire home/apt,250,0,0.08,250
17447,L.,2,Entire home/apt,110,0,0.03,110
17448,Timothy + Gina,2,Entire home/apt,199,23,0.88,222
17449,Anna,1,Entire home/apt,350,301,0.34,651
17450,Jillian,1,Entire home/apt,124,0,0.03,124
17451,Raquel,2,Entire home/apt,175,0,0.29,175
17453,Halle,2,Entire home/apt,295,0,0.44,295
17454,Meghan,1,Entire home/apt,210,0,0.03,210
17455,Claire,1,Entire home/apt,125,0,0.08,125
17457,Terrie,2,Entire home/apt,118,33,3.21,151
17459,Callie And Sean,2,Private room,53,348,3.3,401
17460,Brett,1,Entire home/apt,200,0,0.3,200
17461,Shirley,3,Private room,40,251,0.52,291
17463,Inna,2,Shared room,50,0,0.46,50
17464,Ned,1,Private room,135,336,1.2,471
17465,Fabian,3,Private room,61,0,1.77,61
17466,Kay,1,Shared room,42,343,1.41,385
17467,Anna,3,Private room,69,152,1.4,221
17468,Theodore,1,Entire home/apt,105,0,0.08,105
17469,Yana,2,Entire home/apt,150,236,4.84,386
17470,George,1,Entire home/apt,240,188,0.75,428
17471,Gordon,1,Entire home/apt,140,75,0.39,215
17472,Sha,2,Entire home/apt,90,262,3.08,352
17473,Garron,1,Entire home/apt,199,0,0.03,199
17474,Sarah,1,Private room,65,0,0.05,65
17475,Han,1,Private room,70,180,6.0,250
17476,Shirley,3,Private room,60,152,2.34,212
17477,T,1,Private room,69,187,0.27,256
17478,Jonathan,1,Entire home/apt,250,216,2.03,466
17479,Han,1,Private room,70,161,6.74,231
17480,Marina,1,Entire home/apt,175,0,0.23,175
17481,Deep,1,Private room,110,0,0.33,110
17482,Ryan,3,Private room,50,0,0.08,50
17483,Jennifer,1,Private room,75,84,4.34,159
17484,Christian,2,Private room,55,281,0.52,336
17485,Alexandre,1,Private room,75,0,0.03,75
17487,Patricia,2,Entire home/apt,90,64,1.47,154
17488,Jonathan,1,Private room,70,0,0.22,70
17489,Kyler,2,Entire home/apt,140,0,0.14,140
17490,Alyssa,1,Entire home/apt,200,123,3.41,323
17491,Opeyemi,1,Entire home/apt,120,0,0.8,120
17492,Andrew,2,Private room,85,258,3.35,343
17494,William,1,Entire home/apt,200,0,0.03,200
17495,Lyoka,2,Entire home/apt,225,364,0.08,589
17497,Xavier,1,Entire home/apt,230,0,0.25,230
17499,Lauren,3,Private room,35,0,0.06,35
17500,Andre,2,Private room,95,189,0.58,284
17501,Mary,2,Private room,48,333,3.88,381
17502,Sahul,2,Private room,50,0,0.08,50
17503,Yi,1,Private room,48,0,0.11,48
17504,Shirley,3,Private room,55,65,1.33,120
17506,Shirley,3,Private room,50,160,1.57,210
17507,Shirley,3,Private room,40,120,1.67,160
17508,Maria,3,Private room,60,364,0.38,424
17509,Shirley,3,Private room,40,96,1.45,136
17511,Jan,1,Entire home/apt,135,84,0.88,219
17512,Anna,1,Entire home/apt,150,0,0.06,150
17513,Nichole,1,Entire home/apt,100,27,0.17,127
17514,Marie And Alec,2,Private room,45,189,0.26,234
17515,Miki,1,Private room,55,0,1.93,55
17516,Brian,1,Private room,80,0,0.06,80
17517,Alex,2,Private room,60,343,2.78,403
17518,Sayed,1,Entire home/apt,399,0,0.03,399
17519,Joanna,1,Entire home/apt,150,82,0.55,232
17521,Patrick,3,Entire home/apt,125,274,0.35,399
17522,Eddie,3,Entire home/apt,75,314,1.55,389
17523,Ken,2,Entire home/apt,202,365,0.04,567
17526,Loreto,2,Private room,45,0,0.18,45
17528,Matt,2,Private room,102,0,0.14,102
17529,Ryan,2,Entire home/apt,55,0,1.07,55
17530,Frances,1,Entire home/apt,155,0,0.21,155
17532,Kate,1,Entire home/apt,95,0,0.06,95
17533,Itzchack,2,Entire home/apt,525,327,0.14,852
17535,Edgar,2,Private room,45,224,2.27,269
17537,Shira,1,Entire home/apt,150,212,0.3,362
17538,Jana,2,Private room,59,0,0.03,59
17539,Sarah,3,Private room,75,81,0.22,156
17540,Alicia,2,Private room,69,16,1.8,85
17541,Vanessa,2,Private room,300,0,0.06,300
17542,Sara,1,Private room,60,0,0.3,60
17543,Ade,2,Private room,50,0,0.03,50
17544,Adam,2,Entire home/apt,150,0,0.06,150
17545,Maxine,3,Private room,85,89,0.14,174
17546,Armen,1,Entire home/apt,210,327,0.39,537
17547,Sarah,1,Private room,55,0,0.08,55
17551,Lisa,2,Private room,65,0,0.28,65
17552,Yakup,2,Private room,50,0,0.3,50
17554,Tavish,2,Private room,40,0,0.03,40
17555,Robert,2,Entire home/apt,250,0,0.27,250
17556,Dilini,2,Private room,33,0,0.17,33
17557,Ming,2,Private room,46,80,3.51,126
17559,Azoil,2,Entire home/apt,76,0,0.03,76
17560,Enrique,1,Private room,70,0,0.03,70
17562,Kimberly,2,Entire home/apt,129,80,1.2,209
17564,Matt & Crutch,2,Private room,58,82,2.2,140
17566,Jason,1,Entire home/apt,76,31,0.76,107
17567,Serdar,3,Private room,35,247,0.47,282
17568,Shirley,3,Private room,40,134,0.84,174
17569,Ken,1,Entire home/apt,195,45,0.06,240
17570,Abby,1,Private room,80,0,0.03,80
17571,Joyell,2,Private room,44,61,4.52,105
17572,Maritza,2,Entire home/apt,95,43,0.31,138
17574,Liliana,3,Private room,55,278,1.19,333
17576,Emma,1,Private room,40,0,0.03,40
17577,Cristy,3,Entire home/apt,200,363,0.52,563
17578,Amira,1,Private room,39,53,0.05,92
17579,Caroline,2,Entire home/apt,700,88,0.06,788
17580,Christina,2,Entire home/apt,45,0,0.22,45
17581,Ben,2,Entire home/apt,140,0,0.22,140
17582,Judy,2,Entire home/apt,99,93,1.57,192
17583,Jason,1,Private room,175,308,3.3,483
17585,Offer,2,Entire home/apt,75,0,0.06,75
17586,Martha,3,Private room,50,218,2.21,268
17588,Ioannis,1,Entire home/apt,100,20,0.5,120
17589,MG & Larry,1,Entire home/apt,200,5,0.61,205
17590,Kesina,1,Entire home/apt,80,0,0.09,80
17591,David,2,Private room,60,0,0.08,60
17592,Summer,2,Entire home/apt,119,0,0.11,119
17593,Helen,1,Private room,69,287,1.57,356
17594,Andrew,2,Entire home/apt,400,0,0.03,400
17595,Anna,2,Private room,95,158,1.33,253
17596,Chaima,2,Private room,45,0,0.03,45
17597,Kazumi,3,Private room,73,282,2.11,355
17598,Jeanine,1,Private room,123,0,0.1,123
17599,Emilie,1,Entire home/apt,130,0,0.15,130
17600,Fawn,1,Entire home/apt,325,349,0.84,674
17601,Terry,1,Entire home/apt,95,0,0.09,95
17604,Oleg,1,Entire home/apt,165,0,0.96,165
17605,Ella,1,Entire home/apt,250,0,0.03,250
17606,Deepti,1,Entire home/apt,130,0,0.92,130
17607,Frédérique,1,Entire home/apt,200,53,1.4,253
17608,Michael,1,Private room,70,0,0.38,70
17609,Jennie,2,Entire home/apt,105,291,0.84,396
17610,Nellie,2,Entire home/apt,150,0,0.06,150
17612,Amy,2,Entire home/apt,105,0,0.03,105
17613,Art,1,Private room,100,190,1.62,290
17614,Shivani,1,Entire home/apt,150,0,0.14,150
17616,Rob,1,Private room,65,149,1.04,214
17617,Raanan,1,Entire home/apt,125,150,0.24,275
17618,Jimmy,1,Entire home/apt,140,27,0.25,167
17619,Yasir,1,Entire home/apt,300,0,0.03,300
17620,Julia,3,Private room,90,1,0.9,91
17621,Adrian,3,Private room,30,0,1.57,30
17622,Angelika,2,Entire home/apt,109,51,3.22,160
17625,Christina,2,Entire home/apt,120,0,0.06,120
17626,Jesse,2,Entire home/apt,125,0,0.09,125
17629,Vernise,4,Private room,50,280,0.23,330
17630,Stephanie,1,Entire home/apt,200,0,0.16,200
17631,Casey,1,Private room,74,188,0.05,262
17632,Ryan,2,Private room,100,0,0.23,100
17633,Donald,4,Private room,52,0,1.78,52
17634,Waybridge,1,Entire home/apt,135,24,0.8,159
17637,B,1,Entire home/apt,165,0,0.08,165
17638,Scott,2,Private room,75,0,0.17,75
17639,Benjamin,2,Private room,155,0,0.09,155
17640,Irma,2,Entire home/apt,144,0,0.39,144
17641,Luqian,2,Private room,25,0,0.06,25
17643,Joshua,1,Private room,97,201,0.09,298
17644,Sergio,1,Private room,150,178,0.55,328
17645,Fay,2,Private room,65,270,0.42,335
17646,Martin & Hande,2,Entire home/apt,99,57,3.94,156
17647,Maisha,1,Entire home/apt,100,0,0.06,100
17648,Paula,2,Entire home/apt,250,347,0.92,597
17650,Ken,1,Entire home/apt,169,0,0.05,169
17651,Han,1,Private room,70,184,5.98,254
17655,Eric,1,Private room,105,76,5.79,181
17657,Vincent,1,Private room,65,0,1.27,65
17658,Kristen,1,Private room,50,0,1.52,50
17659,Kila,2,Private room,69,320,1.55,389
17660,Matt,1,Entire home/apt,110,266,1.8,376
17662,Susan,2,Entire home/apt,249,0,0.76,249
17663,Florencia,2,Private room,57,0,0.39,57
17664,Host,1,Entire home/apt,150,275,0.32,425
17665,Joseph,1,Entire home/apt,3800,180,0.06,3980
17666,Dean,3,Entire home/apt,99,0,0.06,99
17668,Krisztián,2,Entire home/apt,370,0,0.14,370
17670,Eric,1,Entire home/apt,147,0,0.17,147
17672,Mingmar,3,Entire home/apt,87,332,4.45,419
17674,Lori,2,Private room,46,0,0.56,46
17675,Eugene,1,Private room,110,128,1.88,238
17676,Eugene,1,Private room,100,133,2.24,233
17677,Yang,1,Entire home/apt,110,0,0.91,110
17678,Gordon,1,Entire home/apt,140,68,0.39,208
17679,Amanda,2,Private room,55,0,0.08,55
17680,Alicia,2,Private room,130,89,0.55,219
17681,Scott,3,Entire home/apt,125,0,0.03,125
17682,Amaya,2,Private room,73,94,2.68,167
17683,Kara,1,Entire home/apt,479,185,0.24,664
17685,Emmie,2,Private room,41,0,0.03,41
17686,Cody,1,Private room,85,29,3.37,114
17687,Sarah,2,Entire home/apt,175,12,0.13,187
17688,Kendall,1,Entire home/apt,350,0,0.17,350
17690,Jacob,1,Entire home/apt,89,0,0.18,89
17691,Mor,1,Entire home/apt,450,287,3.02,737
17692,Erin,2,Entire home/apt,10000,0,0.16,10000
17693,Troy,1,Private room,113,197,0.39,310
17694,Roei,2,Entire home/apt,300,345,0.08,645
17695,Jessica,2,Private room,38,0,0.08,38
17696,Douglas,2,Entire home/apt,220,0,0.11,220
17698,Natalie,1,Entire home/apt,120,0,0.08,120
17699,Colin,1,Private room,99,0,0.03,99
17700,Vikas,2,Entire home/apt,115,137,9.61,252
17702,J.A.,3,Entire home/apt,150,0,0.12,150
17703,John,3,Private room,38,212,0.89,250
17704,Daniel And Christianne,2,Entire home/apt,62,33,2.36,95
17705,Janet,1,Private room,120,0,0.14,120
17706,Arash,2,Private room,60,0,0.06,60
17707,Leigh,1,Private room,195,170,1.19,365
17708,Justin,1,Private room,69,106,0.54,175
17710,Fanny,2,Entire home/apt,138,71,2.74,209
17712,Julien,2,Entire home/apt,120,0,0.58,120
17713,Jose,2,Private room,41,0,1.16,41
17715,Hattie,2,Private room,35,0,0.03,35
17716,Tal,1,Entire home/apt,250,0,0.03,250
17717,Andy,2,Entire home/apt,215,0,0.31,215
17718,Rob,3,Entire home/apt,115,89,1.77,204
17720,Inna,1,Entire home/apt,129,299,0.35,428
17722,Constanza,3,Entire home/apt,200,0,0.03,200
17723,Autumn,2,Private room,79,362,0.75,441
17724,Lisa,1,Entire home/apt,160,179,3.52,339
17725,Claudia,2,Entire home/apt,130,0,0.03,130
17726,Dashiell,1,Entire home/apt,70,0,0.19,70
17727,John,3,Private room,32,342,0.32,374
17728,Josephine,3,Private room,37,305,3.18,342
17729,Sinida,2,Private room,55,102,2.43,157
17730,Dani,1,Entire home/apt,250,0,0.28,250
17731,Alison,2,Entire home/apt,75,0,0.17,75
17733,Emine Gozde,2,Private room,42,0,0.03,42
17734,Alex And Maya,1,Entire home/apt,155,232,3.79,387
17735,Lou,4,Private room,22,42,0.39,64
17736,Whitney,2,Entire home/apt,125,0,0.12,125
17737,Razia,1,Entire home/apt,99,296,2.16,395
17738,Aris,2,Private room,60,0,0.83,60
17739,Joanna,1,Private room,45,0,0.08,45
17740,Oliver,1,Private room,130,0,0.17,130
17741,Abbey,1,Private room,40,0,0.03,40
17742,Cody,1,Private room,95,0,0.45,95
17745,Anais,1,Entire home/apt,140,0,0.03,140
17746,Priscila,3,Private room,70,24,2.6,94
17747,Adam,1,Entire home/apt,250,0,0.03,250
17748,Alex And Zeena,1,Private room,85,355,1.6,440
17749,Alex And Zeena,1,Private room,85,360,2.26,445
17750,George Steven,1,Entire home/apt,106,242,0.41,348
17751,Vanessa,3,Entire home/apt,90,0,0.14,90
17752,Roman,1,Entire home/apt,129,193,4.39,322
17753,Stephanie,3,Private room,100,0,0.32,100
17756,Shelley,1,Entire home/apt,100,0,0.11,100
17758,Naief,2,Entire home/apt,120,15,1.46,135
17759,Shlomit,3,Private room,75,157,0.61,232
17760,Marco,1,Entire home/apt,140,0,0.28,140
17761,Cristina,2,Private room,55,0,0.06,55
17763,Ainslie And John,2,Private room,85,136,4.44,221
17765,Chantelle,1,Entire home/apt,219,217,1.58,436
17766,Heather,2,Entire home/apt,185,0,0.25,185
17767,Lili,3,Entire home/apt,70,0,0.26,70
17768,Martin,2,Entire home/apt,100,107,2.41,207
17769,G. Matthew,1,Private room,69,65,3.44,134
17770,Hadass,2,Private room,40,97,2.88,137
17771,Lucilu,3,Private room,55,31,9.3,86
17772,Jasna,2,Entire home/apt,150,0,0.28,150
17774,Talor,2,Private room,45,0,0.09,45
17775,Fredrik,1,Entire home/apt,280,0,0.07,280
17776,Alessandro,1,Private room,120,0,1.87,120
17777,Mary,3,Private room,90,173,0.03,263
17778,Audrey,2,Entire home/apt,225,0,0.29,225
17779,Corporate Housing,1,Entire home/apt,159,364,0.12,523
17780,Alex,1,Entire home/apt,650,0,0.03,650
17781,Joel,1,Entire home/apt,275,146,3.44,421
17782,Maya,2,Entire home/apt,325,92,2.21,417
17783,Elaine,2,Entire home/apt,359,0,0.23,359
17784,Swati,3,Entire home/apt,99,282,3.96,381
17785,Nicole,1,Entire home/apt,108,0,0.03,108
17786,Kaitlin,2,Private room,67,0,0.4,67
17787,Ashley,2,Private room,25,0,0.06,25
17789,Peter,3,Entire home/apt,125,0,0.31,125
17790,Agata,1,Entire home/apt,124,336,0.79,460
17793,Sherice,2,Private room,55,0,0.03,55
17795,William,2,Entire home/apt,200,0,0.03,200
17796,Jeannine,2,Entire home/apt,200,167,0.91,367
17798,Johnny,1,Entire home/apt,175,16,0.08,191
17799,James & Shaun,1,Private room,88,165,4.24,253
17800,Jay,2,Private room,57,311,0.2,368
17802,Corporate Housing,1,Entire home/apt,133,342,0.29,475
17803,Nickesha,3,Private room,55,365,0.81,420
17804,Corporate Housing,1,Entire home/apt,125,157,0.21,282
17805,Gabriel,2,Entire home/apt,80,0,0.11,80
17806,Nicolas,2,Private room,70,0,0.08,70
17807,Aurora,4,Entire home/apt,120,327,0.2,447
17808,Jason,1,Private room,150,316,3.29,466
17809,Anthony,2,Entire home/apt,90,0,0.14,90
17810,Johnny,2,Entire home/apt,115,14,0.4,129
17812,Tory,1,Private room,51,0,0.25,51
17814,Oliver,1,Private room,105,0,0.09,105
17815,Gordon,1,Entire home/apt,225,321,0.22,546
17816,Sonia,1,Private room,89,0,2.24,89
17817,Claudia,3,Private room,61,281,0.69,342
17818,Victor,1,Shared room,70,103,6.36,173
17819,G. Matthew,1,Private room,69,72,2.09,141
17820,Diane,1,Private room,79,125,4.43,204
17821,Lydia,2,Entire home/apt,83,37,0.43,120
17822,Adam,2,Private room,160,0,0.03,160
17823,Stacey Rae,2,Shared room,40,0,0.15,40
17824,Cheno,2,Private room,50,0,0.06,50
17825,G. Matthew,1,Private room,45,101,2.79,146
17826,Irene,2,Private room,85,0,0.03,85
17827,Andrew,2,Entire home/apt,100,31,2.82,131
17828,Anthony,2,Private room,57,356,2.28,413
17830,Jeffrey,2,Private room,53,0,0.17,53
17831,John,3,Private room,38,278,0.55,316
17833,Christine,2,Entire home/apt,139,0,0.06,139
17834,Lorna,2,Entire home/apt,150,154,1.46,304
17835,Ann,2,Entire home/apt,280,0,0.33,280
17836,Joe,1,Entire home/apt,90,0,0.14,90
17837,Amy,3,Private room,50,53,1.68,103
17840,Carmen,1,Private room,150,87,0.03,237
17841,S,1,Entire home/apt,155,34,2.18,189
17842,Matthew,1,Private room,109,2,0.72,111
17843,Mileaka,2,Entire home/apt,150,0,0.39,150
17844,Jim,2,Entire home/apt,130,101,2.94,231
17845,M,1,Entire home/apt,275,0,0.06,275
17846,Thomas,2,Entire home/apt,100,0,0.05,100
17849,Ezgi,1,Entire home/apt,215,0,0.06,215
17850,Juan,1,Private room,40,0,0.06,40
17851,Nancy,2,Private room,103,0,0.03,103
17852,Kristen,2,Private room,50,0,0.11,50
17854,Jorge,2,Private room,54,0,0.12,54
17855,Shunan,1,Shared room,79,0,0.03,79
17856,J.,2,Private room,50,162,4.73,212
17858,Louisa,2,Private room,59,99,0.8,158
17861,Sarah,2,Private room,85,0,0.03,85
17862,Virgilio,2,Entire home/apt,185,26,4.77,211
17863,Sarah,2,Entire home/apt,85,0,0.06,85
17864,Negra,3,Entire home/apt,135,168,3.8,303
17865,Horacio,3,Entire home/apt,85,284,1.65,369
17866,Steven,1,Entire home/apt,150,0,0.06,150
17867,Eric,2,Entire home/apt,75,0,0.08,75
17868,Carol Ann,1,Entire home/apt,150,226,2.43,376
17869,Alexandria,1,Entire home/apt,150,0,0.06,150
17870,Jared,3,Entire home/apt,199,365,0.2,564
17872,Joelle,3,Private room,88,0,0.3,88
17873,Chapman,1,Private room,99,0,1.74,99
17874,Brandi,1,Private room,75,0,0.08,75
17875,Jeniffer,1,Entire home/apt,107,332,0.24,439
17877,Boram,2,Entire home/apt,89,0,0.25,89
17878,Leslie,1,Entire home/apt,210,311,2.1,521
17880,Kevin,2,Private room,57,60,0.64,117
17882,JesAnn,2,Private room,50,8,0.63,58
17883,Miles,1,Entire home/apt,150,13,0.29,163
17884,Christina,2,Private room,29,193,0.38,222
17885,Andrew,2,Entire home/apt,100,0,0.03,100
17886,Bridge,1,Entire home/apt,152,332,0.05,484
17889,Tamara,2,Private room,45,365,1.27,410
17890,Johno,2,Private room,49,355,1.15,404
17891,Konstantin,2,Private room,45,94,0.19,139
17894,Shaquana,1,Entire home/apt,122,8,1.13,130
17895,Charlotte,1,Entire home/apt,64,0,0.03,64
17896,Wayne,1,Entire home/apt,135,0,0.34,135
17897,Carly,2,Private room,33,0,0.31,33
17899,Caroline,1,Private room,320,0,0.18,320
17901,Mona,1,Entire home/apt,130,188,0.45,318
17902,Amanda,1,Private room,95,0,0.19,95
17905,Laura,3,Entire home/apt,150,261,0.2,411
17906,Will,1,Entire home/apt,350,0,0.03,350
17907,Jeniffer,1,Entire home/apt,120,322,0.19,442
17908,Marta,1,Private room,250,229,4.25,479
17909,Matthew,2,Entire home/apt,106,0,0.85,106
17910,Jason,3,Entire home/apt,65,201,0.17,266
17911,Mi,2,Entire home/apt,175,154,3.36,329
17912,Mike,2,Entire home/apt,360,175,0.26,535
17913,Allegra,2,Entire home/apt,119,140,5.37,259
17915,Elissa,2,Entire home/apt,189,255,3.18,444
17916,Deirdre,2,Private room,68,245,3.8,313
17917,Sabrina,1,Entire home/apt,100,0,0.09,100
17918,Clayton,1,Private room,40,171,0.09,211
17921,Shirley,2,Private room,100,365,0.75,465
17922,Kathryn & Tobias,1,Private room,165,88,0.25,253
17924,Priya,2,Private room,40,0,0.06,40
17925,Melani,1,Entire home/apt,175,310,0.06,485
17926,Jowelle,1,Entire home/apt,99,228,2.29,327
17927,Marisha,2,Private room,50,0,1.31,50
17928,Alida,3,Private room,70,188,0.07,258
17929,Michael,3,Entire home/apt,85,0,0.11,85
17930,Fahmida,4,Private room,50,26,0.4,76
17931,Weimin,3,Private room,69,0,0.17,69
17932,Ivan,2,Private room,54,19,4.11,73
17933,Tess,1,Private room,38,0,0.06,38
17935,Elizabeth,2,Private room,41,0,0.06,41
17936,Tov,2,Entire home/apt,199,20,1.96,219
17937,Goerge,1,Entire home/apt,235,134,0.68,369
17938,Brian And Rachel,2,Entire home/apt,240,217,4.04,457
17939,Joelle,3,Private room,70,0,0.36,70
17940,Ryan,1,Entire home/apt,250,0,0.05,250
17941,Mara,2,Entire home/apt,91,0,0.13,91
17942,Luis,1,Private room,125,181,0.38,306
17943,Ivan,2,Private room,55,24,4.1,79
17944,Nacho,2,Private room,75,50,0.56,125
17945,Kathy,2,Private room,44,42,1.24,86
17946,Abigail,1,Private room,90,0,0.06,90
17947,Makiko,2,Entire home/apt,100,0,2.1,100
17948,Elizabeth,1,Private room,170,143,0.61,313
17949,Julia,2,Entire home/apt,140,93,0.28,233
17950,Brian,2,Entire home/apt,199,0,0.06,199
17951,Jeremy & Laura,1,Entire home/apt,156,189,0.09,345
17952,Jeremy & Laura,1,Entire home/apt,170,0,0.1,170
17953,Amanda,1,Entire home/apt,110,5,0.73,115
17954,Summer,1,Entire home/apt,115,0,0.37,115
17955,Sandra,1,Private room,70,95,0.43,165
17956,Todd,1,Private room,250,34,1.59,284
17957,Host,1,Entire home/apt,200,96,0.28,296
17959,Brett,2,Private room,82,0,0.7,82
17960,Kelly,2,Entire home/apt,85,0,0.03,85
17961,Fernando,3,Entire home/apt,69,105,5.13,174
17962,Stephen,3,Entire home/apt,150,264,1.84,414
17963,Miles,1,Entire home/apt,150,39,5.27,189
17966,Samantha,3,Private room,90,0,0.23,90
17968,Rich,1,Entire home/apt,159,0,0.35,159
17969,Kelsye,2,Entire home/apt,280,335,1.24,615
17970,Brooke,1,Entire home/apt,325,0,0.11,325
17971,Valeria,1,Entire home/apt,120,8,0.17,128
17972,Jill,1,Private room,61,180,0.1,241
17973,Rose,2,Entire home/apt,80,365,0.42,445
17974,Laetitia,1,Private room,90,0,0.42,90
17976,Joseph,1,Entire home/apt,178,0,2.07,178
17978,Remy,2,Entire home/apt,119,18,1.82,137
17979,Rohan,2,Private room,30,0,0.03,30
17981,Jackie,1,Private room,100,112,2.26,212
17982,Markus,2,Entire home/apt,100,0,0.06,100
17983,Ryley,1,Entire home/apt,250,328,0.09,578
17984,Scott,2,Private room,30,0,0.03,30
17985,Emma,1,Entire home/apt,240,0,0.14,240
17986,Maba,2,Private room,60,0,4.1,60
17987,Maba,2,Private room,65,185,4.17,250
17988,Maba,2,Entire home/apt,140,234,3.82,374
17989,Scott,1,Entire home/apt,265,5,0.55,270
17991,Sam,1,Private room,145,90,0.25,235
17992,Kenneth,1,Entire home/apt,100,0,0.03,100
17994,Linda,3,Entire home/apt,105,38,0.81,143
17995,Jj,2,Private room,85,0,0.03,85
17996,Nikita,1,Entire home/apt,150,0,0.14,150
17997,Haffro,1,Private room,100,157,0.14,257
18000,Este,2,Entire home/apt,75,0,0.03,75
18001,Lila,2,Private room,60,0,1.52,60
18002,Scott,2,Private room,80,308,1.4,388
18003,Alina,2,Entire home/apt,137,221,2.76,358
18004,Alon,1,Entire home/apt,79,308,0.36,387
18005,Miho And Justin,2,Private room,120,130,2.57,250
18006,Olivia,1,Entire home/apt,220,0,0.03,220
18007,Olivia & Fadia,1,Entire home/apt,300,172,4.39,472
18011,Elena,1,Private room,90,0,0.28,90
18012,Aleksandra,2,Private room,48,14,2.02,62
18013,Ericka,2,Entire home/apt,179,1,0.45,180
18014,Santiago,2,Private room,58,0,0.1,58
18016,Thiago,1,Entire home/apt,49,279,3.88,328
18017,Erica,2,Entire home/apt,110,0,0.17,110
18018,Benjamin,1,Entire home/apt,190,0,0.26,190
18019,Sita,3,Entire home/apt,450,290,0.42,740
18020,Pedro,1,Private room,69,322,1.81,391
18021,Chelsea,1,Entire home/apt,250,90,1.9,340
18023,Charly,1,Entire home/apt,249,237,2.82,486
18024,Seamus,1,Entire home/apt,125,0,0.06,125
18026,Carolyn,3,Private room,60,78,2.18,138
18027,Thomas,1,Entire home/apt,179,41,0.9,220
18029,Christina,1,Entire home/apt,155,8,0.83,163
18030,Alvina,3,Private room,65,76,0.34,141
18031,Nick,1,Entire home/apt,499,30,3.24,529
18032,Myles,1,Entire home/apt,250,130,0.06,380
18033,Philip,2,Entire home/apt,120,27,0.33,147
18034,Chris,2,Private room,50,302,1.78,352
18035,Cornelia,2,Private room,48,0,0.06,48
18036,Jourdain,2,Private room,45,339,0.15,384
18037,Kait,2,Private room,50,0,1.67,50
18038,Sasha,2,Private room,75,0,0.47,75
18039,Perry,2,Private room,65,0,0.03,65
18040,Evelyn,1,Private room,90,0,0.84,90
18042,Natalie,2,Private room,80,281,0.06,361
18044,Nick,2,Private room,43,0,0.19,43
18045,Maya,3,Private room,32,161,11.4,193
18046,Philip And Kerstin,2,Shared room,39,0,0.34,39
18048,Elisa,1,Private room,75,0,0.17,75
18049,Andrew,2,Entire home/apt,130,0,0.12,130
18050,Jocelyn,2,Private room,85,83,0.1,168
18052,Brooke,2,Entire home/apt,95,29,1.1,124
18053,Shilpa,2,Private room,90,84,0.73,174
18054,Dory,2,Private room,45,0,0.45,45
18055,Amadeus,4,Private room,60,364,0.22,424
18056,Inna,1,Entire home/apt,119,339,0.38,458
18057,Brendan,1,Entire home/apt,150,8,0.37,158
18058,Catalina,1,Entire home/apt,295,128,0.78,423
18060,Shriya,2,Private room,130,0,0.11,130
18061,Nir,1,Private room,70,0,0.03,70
18062,Gladys,3,Entire home/apt,71,173,4.34,244
18063,Carolyn,2,Shared room,75,0,0.04,75
18064,Ellen,3,Entire home/apt,85,52,2.08,137
18065,Joy,2,Private room,67,365,0.84,432
18066,Catherine,1,Entire home/apt,75,0,0.14,75
18067,Luis,3,Entire home/apt,79,320,2.32,399
18068,Yi,3,Entire home/apt,72,124,7.1,196
18069,Elka,1,Entire home/apt,153,0,0.03,153
18070,Rachel,3,Private room,60,160,0.27,220
18071,Angie,1,Entire home/apt,150,0,1.69,150
18072,April,1,Entire home/apt,142,118,0.71,260
18073,John,3,Private room,55,0,1.9,55
18074,Helen,2,Entire home/apt,249,0,0.66,249
18075,Chloe,2,Entire home/apt,111,170,2.06,281
18076,Diana,1,Entire home/apt,179,0,0.38,179
18077,The Mahogany Suite(Studio Apartment,2,Private room,65,290,0.71,355
18078,Rachel,1,Private room,63,59,3.06,122
18079,Paul,1,Private room,90,0,0.03,90
18080,Rachel,1,Entire home/apt,143,0,0.03,143
18081,Wanda,1,Private room,85,306,0.28,391
18082,Jennifer,1,Private room,67,45,2.5,112
18083,Randy,2,Private room,45,305,2.5,350
18085,Stephanie,2,Entire home/apt,150,0,0.26,150
18086,Laura,1,Entire home/apt,175,310,0.08,485
18087,Anna,3,Private room,90,350,2.35,440
18089,Nikki,2,Entire home/apt,100,0,0.09,100
18090,Dion,2,Private room,53,54,2.39,107
18092,Alan,2,Entire home/apt,250,98,2.23,348
18094,Emine,2,Private room,85,0,0.09,85
18095,Shuchi,2,Private room,45,0,0.03,45
18096,James,1,Entire home/apt,65,0,0.03,65
18097,Gino,2,Entire home/apt,160,314,1.63,474
18102,Doug,1,Private room,100,0,0.31,100
18103,Tianna,1,Private room,74,0,0.22,74
18104,Carina,1,Private room,50,1,1.11,51
18105,Krys,3,Entire home/apt,75,14,5.87,89
18106,Ike,1,Entire home/apt,150,0,0.08,150
18107,David,2,Private room,30,0,0.03,30
18108,Jane,1,Entire home/apt,200,0,0.28,200
18109,Tiffany,2,Private room,67,126,2.94,193
18110,Ivana,2,Entire home/apt,153,31,0.48,184
18112,Doug,2,Private room,98,211,1.78,309
18114,Amanda,1,Entire home/apt,215,316,1.42,531
18115,Anthony,3,Private room,60,0,0.03,60
18116,Maxime,1,Private room,100,0,0.34,100
18117,Mara,2,Entire home/apt,131,96,0.76,227
18118,Medina,3,Entire home/apt,120,71,6.62,191
18119,Gina,3,Private room,75,0,0.46,75
18120,Alon,1,Entire home/apt,79,201,0.42,280
18121,Carlos,1,Private room,120,197,1.53,317
18122,Helen,1,Entire home/apt,228,0,0.03,228
18123,Jon,1,Private room,85,0,0.06,85
18124,Oliver,1,Entire home/apt,115,196,0.69,311
18125,Joshua,2,Entire home/apt,130,0,2.17,130
18126,Marushka,1,Entire home/apt,109,0,0.75,109
18128,Auralís,2,Entire home/apt,200,0,0.37,200
18130,Alis,2,Entire home/apt,180,82,1.22,262
18131,Petya,3,Shared room,35,280,0.05,315
18132,Aurore And Jamila,2,Entire home/apt,140,330,0.49,470
18133,Alicia,1,Private room,110,301,2.35,411
18134,Charis,3,Entire home/apt,75,0,0.14,75
18135,Shanthony,2,Private room,50,0,0.06,50
18136,Warren,2,Private room,89,365,0.04,454
18137,Corporate Housing,1,Entire home/apt,175,363,0.16,538
18140,Alexandre,2,Entire home/apt,150,0,0.53,150
18141,Ryan,3,Entire home/apt,96,0,0.03,96
18143,Jennifer,1,Entire home/apt,210,242,0.32,452
18144,Rhonycs,1,Entire home/apt,221,270,2.24,491
18145,Jeremy & Angela,2,Entire home/apt,150,114,1.93,264
18146,Laura,1,Entire home/apt,350,16,0.47,366
18147,Jazmin,1,Private room,65,34,1.3,99
18148,Claire,2,Entire home/apt,325,126,2.45,451
18149,Derek,1,Entire home/apt,407,120,0.34,527
18150,Kate,1,Private room,60,0,0.11,60
18151,Andy,2,Private room,91,250,0.03,341
18152,Jessica,2,Private room,41,0,0.06,41
18153,Ken,1,Entire home/apt,215,357,0.05,572
18154,Pete,2,Private room,57,0,0.03,57
18155,Julie,2,Private room,65,0,0.31,65
18156,Sam And Britt,2,Entire home/apt,149,256,4.27,405
18157,Ramazan,3,Private room,70,365,0.66,435
18158,Olga,1,Entire home/apt,290,256,1.67,546
18159,Dijana,1,Private room,70,66,1.74,136
18160,Dasha,2,Private room,90,0,0.28,90
18161,Cha,1,Entire home/apt,150,0,0.06,150
18162,Ryan,1,Private room,100,0,0.03,100
18164,Ilona,2,Entire home/apt,224,353,0.08,577
18168,Paul,3,Entire home/apt,125,0,0.03,125
18169,Thorill,2,Entire home/apt,49,264,2.17,313
18170,Jerome,1,Entire home/apt,700,179,0.68,879
18171,Avery,2,Entire home/apt,650,0,0.08,650
18172,Alexandra,1,Entire home/apt,150,83,1.61,233
18173,Xenia,2,Private room,50,20,1.34,70
18174,Oonamaria,2,Private room,55,0,0.2,55
18175,Paul,2,Entire home/apt,90,0,0.1,90
18178,Stella,1,Entire home/apt,349,0,0.17,349
18180,Carlota And Jessica,2,Entire home/apt,100,251,4.29,351
18181,Cesar,1,Entire home/apt,115,0,0.23,115
18182,Karen,1,Entire home/apt,150,58,3.45,208
18184,Brooklyn&   Breakfast    -Len-,2,Private room,55,281,2.98,336
18185,Daljit,3,Private room,49,21,2.94,70
18186,Rachel,1,Private room,95,90,1.27,185
18187,David,3,Private room,75,335,1.64,410
18188,Torell,2,Shared room,45,311,0.29,356
18190,John,1,Entire home/apt,199,68,0.62,267
18191,Viktoria,1,Entire home/apt,195,190,3.21,385
18192,Lan,1,Entire home/apt,349,72,1.08,421
18193,Gaspard,1,Entire home/apt,270,11,3.21,281
18196,Sami,2,Entire home/apt,159,0,0.03,159
18197,Jeremy & Laura,1,Entire home/apt,196,280,0.03,476
18198,Daniel,1,Shared room,103,0,0.08,103
18199,Mina,2,Private room,92,341,0.52,433
18200,Ceri,1,Entire home/apt,150,0,1.04,150
18201,J. Cobb,1,Entire home/apt,294,105,4.19,399
18202,Aksa,1,Entire home/apt,110,40,1.05,150
18203,Maria,4,Entire home/apt,76,34,1.15,110
18204,Franco,2,Entire home/apt,180,82,3.34,262
18205,Nepreil,3,Entire home/apt,100,361,1.34,461
18207,Craig,2,Entire home/apt,120,0,0.09,120
18208,Melina,1,Private room,90,0,0.42,90
18209,Richard,2,Entire home/apt,130,0,2.34,130
18210,Candy,2,Entire home/apt,84,211,2.39,295
18211,Clyde,2,Private room,50,140,2.77,190
18212,Laverne & David,3,Entire home/apt,76,35,4.39,111
18213,Jared,1,Entire home/apt,316,348,2.19,664
18214,Kimberly,3,Entire home/apt,115,265,0.91,380
18215,Patty,2,Entire home/apt,325,0,0.06,325
18216,Benedetta,2,Entire home/apt,160,69,3.72,229
18217,Carol,2,Private room,47,51,1.12,98
18218,Rami,1,Entire home/apt,200,0,0.26,200
18219,Eytan,2,Entire home/apt,200,9,0.26,209
18220,Curtis,2,Private room,75,359,0.35,434
18221,Clara,2,Private room,39,186,0.38,225
18222,Sameer,1,Entire home/apt,300,358,0.1,658
18223,Elizabeth,1,Entire home/apt,489,328,0.22,817
18224,Linda,3,Entire home/apt,150,364,0.08,514
18225,Sophia,3,Entire home/apt,65,335,4.67,400
18226,Viviana,2,Entire home/apt,120,136,3.98,256
18227,Steven,1,Private room,80,0,3.34,80
18228,Anne,2,Private room,53,1,1.15,54
18229,Andra,1,Entire home/apt,200,0,0.48,200
18230,Marisha,2,Private room,50,0,2.81,50
18231,Megan,1,Entire home/apt,150,69,0.36,219
18232,Randi,1,Private room,120,266,4.47,386
18233,Jackie,1,Private room,175,242,1.18,417
18234,Andres,1,Entire home/apt,49,36,0.32,85
18235,Nickesha,3,Private room,59,180,0.29,239
18236,Mollie,3,Private room,79,64,0.39,143
18237,Sun-Young,1,Entire home/apt,195,0,0.41,195
18238,Susan,2,Entire home/apt,249,239,2.87,488
18239,Sho-Boo Of Sho-Boo Suite,2,Private room,53,337,1.19,390
18240,Marc,1,Private room,189,0,0.67,189
18241,Yvette,2,Private room,60,357,1.07,417
18242,Will & Clara,3,Entire home/apt,135,345,2.11,480
18243,Francisca,4,Private room,75,350,3.18,425
18245,Lilly,3,Entire home/apt,120,115,0.37,235
18246,Emily Rose,1,Private room,100,0,0.17,100
18247,Jamis,2,Private room,95,56,1.73,151
18248,Adam,1,Entire home/apt,185,0,0.06,185
18249,Nicole,1,Entire home/apt,99,0,0.45,99
18250,Fabio,2,Entire home/apt,180,326,2.72,506
18251,Nick,1,Entire home/apt,350,137,0.7,487
18252,Melody,1,Private room,69,0,0.12,69
18253,Melissa & Rondie,2,Private room,50,250,1.15,300
18254,Charles,3,Entire home/apt,144,293,3.18,437
18255,Madi,2,Entire home/apt,85,0,0.25,85
18256,Dionne,1,Entire home/apt,100,1,1.04,101
18257,Pipi,1,Entire home/apt,240,271,1.54,511
18258,Julie,2,Entire home/apt,125,0,0.09,125
18259,Richard,1,Entire home/apt,165,0,0.65,165
18260,Martha,3,Entire home/apt,145,321,2.56,466
18262,Saba,2,Private room,65,0,0.03,65
18263,Hai-Hsin,2,Private room,60,0,1.49,60
18264,Aimee,3,Entire home/apt,122,255,3.65,377
18266,Chadanut,2,Private room,42,148,2.69,190
18267,Abeni,2,Private room,55,179,0.54,234
18268,Genevieve,2,Entire home/apt,115,0,0.21,115
18269,David,2,Entire home/apt,95,0,0.25,95
18270,Joe & Jay,2,Entire home/apt,113,167,4.71,280
18271,Kristy,1,Entire home/apt,185,329,0.28,514
18272,Edyta,3,Private room,34,365,0.41,399
18273,Regina,1,Private room,80,323,2.53,403
18274,Kristine,2,Shared room,50,60,1.54,110
18275,Ricardo,1,Private room,55,66,2.53,121
18276,Jenya,1,Entire home/apt,110,0,0.06,110
18277,Stephanie,1,Private room,115,157,1.84,272
18278,Chuck,1,Entire home/apt,239,212,0.49,451
18279,Bekah,3,Private room,63,0,0.31,63
18280,Michael,1,Entire home/apt,295,81,1.29,376
18282,Veronica,2,Private room,125,0,1.59,125
18283,Chondra,4,Entire home/apt,175,36,0.92,211
18284,Victor,1,Shared room,90,14,0.28,104
18285,Josh,2,Private room,75,0,0.09,75
18286,Kostas,3,Entire home/apt,99,283,4.38,382
18287,Orianna,1,Private room,118,0,0.29,118
18288,Talia,1,Private room,75,0,1.46,75
18289,Luca,1,Entire home/apt,105,0,0.68,105
18290,Manny & Gemma,2,Private room,56,163,1.96,219
18291,Cynthia,2,Private room,125,0,0.69,125
18292,Abby,1,Private room,80,275,0.23,355
18293,Liza,4,Entire home/apt,110,42,0.2,152
18294,Natalie,2,Private room,75,250,0.69,325
18295,Megan,3,Private room,60,27,0.42,87
18296,Raul,3,Private room,55,252,0.63,307
18297,Jacob,1,Private room,60,0,0.06,60
18298,Oran,2,Private room,200,89,0.25,289
18299,Naseef,1,Private room,49,0,0.37,49
18300,Gloria,3,Entire home/apt,200,346,2.68,546
18301,Michael,2,Private room,40,273,2.45,313
18303,Cass,2,Entire home/apt,75,41,0.35,116
18304,Madelyn,2,Private room,45,5,0.68,50
18305,George Steven,1,Entire home/apt,245,245,0.37,490
18306,Josefina,2,Entire home/apt,120,89,1.06,209
18307,Tyler,2,Private room,51,358,0.22,409
18308,Pamela,2,Private room,83,307,3.46,390
18309,Heather,2,Private room,55,0,0.03,55
18310,Rui,1,Private room,85,18,1.32,103
18311,CRNY Monthly Rentals,1,Entire home/apt,109,134,0.15,243
18312,Jason,2,Private room,85,0,0.23,85
18313,Jeremy & Laura,1,Entire home/apt,179,345,0.06,524
18314,Joshua,1,Private room,95,238,0.2,333
18315,Anthony,2,Entire home/apt,95,0,1.34,95
18316,Ariel,2,Entire home/apt,170,32,2.48,202
18317,Jules,3,Entire home/apt,110,56,2.14,166
18318,Laura,2,Entire home/apt,111,0,0.08,111
18319,Rameera,2,Private room,125,87,0.03,212
18321,Oscar,1,Private room,54,15,2.01,69
18322,J.D. & Stephanie,2,Private room,79,152,1.11,231
18323,Brian,2,Private room,80,8,4.68,88
18324,Erik,2,Private room,89,0,4.72,89
18325,Brandon,1,Entire home/apt,175,0,0.03,175
18326,Jasmin,2,Private room,85,270,5.3,355
18327,Mimie,4,Private room,38,24,0.23,62
18328,Antonio,2,Private room,38,0,2.73,38
18329,Antonio,2,Private room,29,18,1.78,47
18330,Eleanor,2,Private room,45,0,0.14,45
18331,Rory,1,Entire home/apt,229,67,0.09,296
18332,Alejandra,2,Entire home/apt,147,0,1.34,147
18333,Wenqin,3,Private room,35,342,1.72,377
18335,Marjorie,2,Entire home/apt,154,269,4.11,423
18336,Mark And Annunziata,1,Entire home/apt,250,273,0.09,523
18337,Lauren,2,Entire home/apt,150,6,0.29,156
18338,Daniel,2,Private room,65,0,0.17,65
18339,Zev,1,Entire home/apt,250,229,5.07,479
18340,Cindy,2,Entire home/apt,99,216,2.16,315
18341,Kristin,2,Private room,45,0,0.11,45
18342,Victoria,1,Private room,105,0,0.53,105
18343,Ruben,2,Private room,45,60,2.89,105
18344,Biljana,1,Entire home/apt,180,0,0.47,180
18345,June,3,Entire home/apt,130,252,3.19,382
18347,Mihaela,3,Entire home/apt,77,198,2.69,275
18348,Sharon,2,Private room,450,364,0.03,814
18349,Sheila & Tony,1,Private room,85,64,4.09,149
18350,Ben,2,Private room,67,141,2.75,208
18351,Yuliang,3,Private room,58,0,2.22,58
18352,Laura,2,Private room,149,363,0.56,512
18353,Loren,1,Entire home/apt,150,0,0.84,150
18354,Stacey-Ann,2,Private room,80,189,0.42,269
18355,Maverick,3,Private room,80,288,0.43,368
18356,Henry,1,Entire home/apt,2500,364,0.13,2864
18357,Kerry,1,Entire home/apt,130,0,0.32,130
18358,Anastasia & Jeremy,2,Entire home/apt,150,0,0.06,150
18359,Adora,1,Entire home/apt,180,0,1.05,180
18360,Tiffani,1,Entire home/apt,125,0,1.05,125
18361,David,1,Private room,150,0,0.26,150
18362,Sky,1,Private room,89,332,0.1,421
18363,Alexa,2,Shared room,42,0,0.12,42
18364,Johnny,2,Private room,40,0,0.14,40
18365,Zach,2,Private room,70,155,2.04,225
18366,Jamil,2,Entire home/apt,200,364,0.4,564
18367,Kayleen,1,Private room,64,0,0.03,64
18368,Lee-Ann,2,Private room,75,341,0.45,416
18369,Tasha,2,Entire home/apt,180,57,2.0,237
18371,Jocelyn & Jake,1,Private room,139,52,3.91,191
18372,Michelle & Heddy,1,Private room,149,70,3.5,219
18373,Mike,2,Private room,85,19,3.09,104
18374,Faiza,2,Private room,92,364,0.06,456
18375,Carrie,1,Entire home/apt,129,0,0.29,129
18376,Lauren,1,Entire home/apt,150,0,0.03,150
18377,Adrien,1,Private room,125,188,0.7,313
18378,Alessandra,1,Private room,100,0,0.32,100
18379,Lena,1,Entire home/apt,198,4,0.43,202
18380,Kara,1,Entire home/apt,239,365,0.05,604
18382,John,1,Entire home/apt,215,245,2.16,460
18383,Andria,2,Entire home/apt,100,31,2.5,131
18384,Joshua,1,Entire home/apt,180,2,0.06,182
18385,Barry,1,Entire home/apt,150,328,0.24,478
18386,Chin,3,Entire home/apt,199,302,4.8,501
18387,Lisa,2,Private room,99,155,0.76,254
18388,Ursula,3,Private room,40,127,2.32,167
18389,Nicolas,1,Entire home/apt,199,343,0.91,542
18390,Chikie,1,Private room,69,0,2.26,69
18392,Edyta,2,Entire home/apt,110,301,0.12,411
18393,Mia,5,Entire home/apt,100,363,0.57,463
18395,Jeremy & Laura,1,Entire home/apt,310,294,0.04,604
18396,Jasmin,2,Private room,110,293,5.89,403
18397,"Nykaz, Llc",3,Entire home/apt,165,86,1.08,251
18398,Mendy,2,Private room,85,49,1.56,134
18399,Tanya,2,Private room,65,82,0.44,147
18400,Gal,1,Entire home/apt,149,281,0.06,430
18401,ResortShare5,1,Entire home/apt,252,327,0.49,579
18402,Alex,1,Private room,130,229,0.06,359
18404,Matthew,3,Private room,75,159,2.42,234
18405,Chloe,2,Private room,75,0,0.14,75
18406,Jenny,2,Entire home/apt,125,71,2.01,196
18407,Bruce,1,Entire home/apt,650,363,0.42,1013
18408,Caroline,2,Entire home/apt,115,255,3.78,370
18409,Bella,2,Private room,90,0,0.82,90
18410,Alexis,1,Entire home/apt,249,266,2.03,515
18411,Phil,2,Entire home/apt,140,0,0.26,140
18412,Maud,1,Entire home/apt,795,340,0.8,1135
18413,Veronica,3,Shared room,27,364,0.71,391
18414,Michael,3,Entire home/apt,105,208,1.48,313
18415,Yinny,2,Private room,30,211,0.66,241
18417,Yinny,2,Private room,65,337,0.55,402
18418,Yinny,2,Private room,65,290,1.22,355
18419,Lane,3,Private room,55,56,0.03,111
18421,Caroline,3,Entire home/apt,100,322,2.52,422
18423,Sezer,2,Entire home/apt,73,0,0.06,73
18424,Karen,1,Entire home/apt,289,243,2.09,532
18425,Susan,2,Private room,75,162,0.29,237
18426,Hypha,2,Private room,100,179,0.05,279
18427,Szilvia & Akos,2,Entire home/apt,120,0,0.09,120
18428,Mark,3,Private room,45,216,0.66,261
18430,Red,2,Entire home/apt,155,24,0.91,179
18431,Claudius,3,Entire home/apt,60,0,1.71,60
18433,Hannah,2,Shared room,30,78,0.43,108
18435,Jeremy & Laura,1,Entire home/apt,330,250,0.05,580
18436,Ricky & Diana,3,Entire home/apt,300,228,2.14,528
18437,Adrian,3,Private room,65,78,1.93,143
18438,Ashley,2,Entire home/apt,200,0,0.12,200
18439,Amy,2,Entire home/apt,85,0,0.2,85
18440,Joe,2,Entire home/apt,139,330,0.11,469
18441,Tonya,2,Entire home/apt,135,311,1.12,446
18443,Pascal,1,Entire home/apt,140,170,0.98,310
18444,Patricia,5,Entire home/apt,185,0,0.44,185
18445,Raul,3,Entire home/apt,74,90,0.2,164
18446,Margo,1,Entire home/apt,162,156,0.64,318
18447,Mateo,2,Entire home/apt,185,269,1.53,454
18448,Sharon,2,Shared room,400,364,0.06,764
18449,Rina,1,Entire home/apt,160,5,0.36,165
18450,Nathalia,1,Entire home/apt,98,343,0.82,441
18451,Melina,1,Private room,95,0,0.66,95
18452,Ronit,2,Entire home/apt,59,288,0.27,347
18453,Alexandra,1,Entire home/apt,200,4,0.64,204
18454,Sam,2,Entire home/apt,200,0,0.06,200
18455,Max,2,Entire home/apt,100,1,0.75,101
18456,Kiev,1,Entire home/apt,499,0,2.04,499
18457,J.Y.,1,Entire home/apt,189,206,4.72,395
18458,Alan,3,Private room,185,0,0.71,185
18459,Owen,1,Private room,79,0,0.8,79
18460,Brinton,1,Private room,149,337,2.43,486
18462,Rory,1,Private room,105,0,0.12,105
18463,Giuseppe,2,Private room,45,220,0.15,265
18464,TiffanyJoy,2,Entire home/apt,125,197,1.1,322
18465,Ahmed,2,Private room,95,249,0.06,344
18467,Eric,1,Private room,30,0,0.03,30
18468,Francesca,1,Private room,175,365,0.21,540
18469,Aurelien,2,Entire home/apt,149,2,0.83,151
18470,Kara,1,Entire home/apt,189,364,1.0,553
18471,Taran Pal,1,Private room,95,0,0.03,95
18472,Avantika,1,Shared room,61,0,0.15,61
18474,Megan,1,Shared room,80,0,1.05,80
18475,Tyler,2,Private room,99,0,0.13,99
18476,Shauna,1,Private room,84,0,0.03,84
18477,Asaf,2,Entire home/apt,125,281,0.55,406
18479,A.J.,2,Entire home/apt,107,284,2.34,391
18480,Joan,1,Entire home/apt,190,188,0.28,378
18481,Melanie,2,Entire home/apt,125,0,0.68,125
18482,Florentino,3,Private room,45,0,1.11,45
18484,Danielle,1,Entire home/apt,174,8,0.28,182
18485,Michael,1,Entire home/apt,170,1,3.61,171
18486,Josh,1,Entire home/apt,200,0,0.06,200
18487,Katherine,1,Entire home/apt,250,0,0.12,250
18488,Peter,1,Private room,95,0,0.26,95
18489,Jorge,1,Private room,250,89,1.94,339
18490,Fahmida,4,Private room,80,220,0.06,300
18491,Avantika,1,Entire home/apt,160,0,0.06,160
18492,Michael,2,Private room,45,0,0.03,45
18493,Sebastian,1,Entire home/apt,70,0,0.03,70
18494,Fatou,2,Private room,75,319,0.63,394
18495,Christine,2,Private room,35,0,0.06,35
18496,Sean,2,Entire home/apt,200,364,0.6,564
18497,Lucy And Devin,2,Entire home/apt,95,11,0.38,106
18498,Rebecca,2,Entire home/apt,250,0,0.12,250
18499,Sueann,5,Entire home/apt,275,313,0.83,588
18500,Benny,2,Private room,70,33,2.57,103
18501,Byungdo,3,Private room,30,0,0.03,30
18502,Jason,1,Entire home/apt,289,365,0.53,654
18503,Jennie,1,Entire home/apt,375,7,0.98,382
18504,Maria,1,Entire home/apt,129,21,5.63,150
18506,Austin,2,Private room,81,35,0.29,116
18507,Chris,1,Private room,75,0,0.12,75
18508,Miguel,1,Entire home/apt,250,358,0.13,608
18509,Anne,1,Private room,99,29,1.21,128
18510,Anne,1,Entire home/apt,225,96,0.58,321
18511,Goran,1,Private room,106,19,1.84,125
18512,Perin,2,Private room,55,72,1.16,127
18514,Shaun,1,Entire home/apt,279,0,0.15,279
18515,Dominic,1,Entire home/apt,94,0,0.31,94
18516,Li-Ann,2,Entire home/apt,220,19,0.39,239
18517,Robert,2,Entire home/apt,110,48,2.26,158
18518,Maria,5,Entire home/apt,275,127,0.7,402
18519,Andrew,1,Entire home/apt,999,0,0.03,999
18520,Theodore,1,Private room,125,310,1.06,435
18521,Adam,2,Private room,90,83,0.15,173
18522,Elisabeth,1,Entire home/apt,122,0,0.42,122
18523,Neida,1,Private room,60,37,2.59,97
18524,Ella,2,Entire home/apt,99,39,5.43,138
18525,Ming,2,Private room,48,21,2.6,69
18526,Corporate Housing,1,Entire home/apt,159,280,0.25,439
18527,Corporate Housing,1,Entire home/apt,117,312,0.22,429
18528,Chasity,2,Private room,45,0,0.34,45
18529,Nicole,1,Private room,100,20,2.02,120
18530,Tina,3,Private room,40,30,0.73,70
18531,Jamie J.,1,Entire home/apt,175,188,0.8,363
18532,Doe2930,1,Private room,40,18,0.9,58
18533,Iquane,2,Entire home/apt,85,59,3.25,144
18534,Agnese,2,Private room,100,0,0.17,100
18535,Angelica,1,Entire home/apt,195,188,0.49,383
18536,Shanise,2,Shared room,65,0,0.09,65
18537,Gary,2,Entire home/apt,250,324,1.89,574
18538,Jim,2,Entire home/apt,170,96,3.51,266
18539,Ana,1,Entire home/apt,440,87,0.05,527
18540,Eric,2,Private room,58,3,3.06,61
18541,Gea,2,Private room,45,343,0.14,388
18542,Casey,1,Private room,65,0,0.72,65
18543,Michelle,2,Entire home/apt,299,261,1.02,560
18544,Eric,1,Private room,100,363,0.11,463
18545,Gilbert,1,Private room,99,50,0.41,149
18546,Rafael,1,Private room,120,0,0.06,120
18547,Brinton,1,Entire home/apt,149,220,2.51,369
18548,Chana & Chike,2,Entire home/apt,150,271,4.5,421
18549,B,3,Entire home/apt,100,0,0.03,100
18550,Jackie,3,Private room,60,363,0.03,423
18551,Amy,1,Entire home/apt,153,0,2.42,153
18552,Mikey,2,Private room,50,0,0.44,50
18553,Amir,2,Entire home/apt,172,7,0.58,179
18554,A,3,Entire home/apt,109,316,5.07,425
18555,Lea,1,Entire home/apt,180,344,2.9,524
18556,Johannes,1,Private room,60,57,1.59,117
18557,Joshua,2,Entire home/apt,175,0,0.32,175
18558,Josefina,3,Private room,98,88,0.03,186
18560,CRNY Monthly Rentals,1,Entire home/apt,199,148,0.07,347
18561,Labib,1,Private room,75,0,0.03,75
18562,Passang,3,Entire home/apt,125,214,3.53,339
18566,Mei,2,Private room,100,74,2.78,174
18567,Alice,1,Entire home/apt,225,364,0.47,589
18568,Ozgur,1,Private room,120,0,0.09,120
18569,Matias,2,Entire home/apt,295,309,2.27,604
18570,Trevor,1,Entire home/apt,160,3,0.6,163
18571,Colin,2,Private room,40,0,0.06,40
18573,Alyson,1,Private room,110,345,1.16,455
18574,The Mahogany Suite(Studio Apartment,2,Private room,43,345,0.93,388
18575,Lalla,2,Private room,50,0,1.71,50
18576,Safiyah,2,Entire home/apt,85,89,0.54,174
18577,Rocky,1,Private room,56,56,2.38,112
18578,Alex,2,Private room,73,0,3.94,73
18579,Ryan,1,Private room,175,19,1.06,194
18580,Annette C,2,Private room,49,308,3.1,357
18582,ResortShare5,1,Entire home/apt,672,268,0.87,940
18583,Paulette,3,Private room,44,357,1.03,401
18584,Ashley,2,Private room,130,299,0.45,429
18585,Jorge,2,Entire home/apt,132,260,2.69,392
18586,Jessica,3,Private room,55,0,2.14,55
18587,Josh,1,Entire home/apt,250,0,0.37,250
18588,Patrick,1,Entire home/apt,300,61,0.7,361
18589,Kent,2,Private room,35,0,1.0,35
18590,Richard,1,Private room,100,62,1.37,162
18591,Elem,1,Entire home/apt,175,343,0.14,518
18592,Han,1,Private room,75,179,5.89,254
18594,Pearl,3,Private room,60,355,1.23,415
18595,Sarah,2,Private room,47,4,1.71,51
18596,William,1,Entire home/apt,200,0,0.29,200
18597,Kaitlyn,2,Private room,60,153,4.56,213
18598,Amy,3,Private room,50,79,0.91,129
18599,Marcus,2,Entire home/apt,100,0,0.06,100
18600,Abe,2,Entire home/apt,80,219,0.26,299
18601,Gene,1,Private room,125,143,2.63,268
18602,Shruti,1,Entire home/apt,125,0,0.91,125
18603,Tristan,2,Shared room,78,0,1.38,78
18604,Nika,3,Private room,75,337,2.63,412
18605,Melissa,3,Entire home/apt,150,134,4.13,284
18606,Raymond,1,Private room,100,2,4.77,102
18609,Angelika,2,Entire home/apt,145,178,3.83,323
18610,Julia,1,Entire home/apt,180,203,0.67,383
18611,Samuel,2,Shared room,99,0,0.03,99
18612,Itay,2,Private room,120,68,4.54,188
18614,Wendell,1,Private room,90,38,2.47,128
18615,Laurel,2,Private room,99,332,0.16,431
18616,Ashli,2,Private room,55,0,0.09,55
18617,Alan,2,Private room,55,232,2.45,287
18618,Anna,2,Private room,80,0,0.51,80
18619,Alan,2,Private room,40,284,2.53,324
18620,Corporate Housing,1,Entire home/apt,133,4,0.15,137
18621,Corporate Housing,1,Entire home/apt,175,138,0.21,313
18622,Shay & Anat,2,Entire home/apt,163,255,1.08,418
18623,Sara,1,Entire home/apt,250,0,0.2,250
18624,Jason,3,Entire home/apt,117,241,0.23,358
18625,Jeremy & Laura,1,Entire home/apt,295,250,0.06,545
18626,Milton,1,Private room,105,0,1.09,105
18627,Jovanni & Natasha,4,Private room,59,0,0.21,59
18628,Waldy,1,Private room,60,300,2.39,360
18629,Shanie,3,Entire home/apt,49,63,3.01,112
18630,Declan,2,Entire home/apt,141,159,0.96,300
18631,Via,2,Private room,59,332,0.38,391
18632,Henry,1,Entire home/apt,3000,365,0.24,3365
18633,Alan,2,Private room,50,312,2.79,362
18634,Laura,1,Private room,41,6,0.75,47
18635,Kara,1,Entire home/apt,399,185,0.1,584
18636,Haley,2,Entire home/apt,189,83,0.03,272
18637,Sarah,2,Private room,48,70,1.95,118
18638,Tuan-Phi,2,Entire home/apt,49,0,0.03,49
18639,Mustafa,1,Entire home/apt,175,0,0.06,175
18640,Tracie,2,Private room,55,17,0.12,72
18641,Laura,1,Private room,53,0,0.16,53
18642,Theodora,2,Private room,80,0,0.12,80
18643,Roberto,1,Entire home/apt,150,31,0.86,181
18644,Zhur,3,Private room,67,337,0.23,404
18645,Jason,2,Private room,80,0,0.06,80
18646,Valentina,2,Private room,78,247,1.01,325
18647,Summer,3,Private room,50,0,0.46,50
18648,Valentina,2,Entire home/apt,120,57,1.73,177
18649,Dee,2,Private room,75,0,0.17,75
18650,Jessica,2,Private room,60,0,0.09,60
18651,Nathaniel,2,Private room,75,0,0.03,75
18652,Rodney,2,Entire home/apt,99,345,0.89,444
18653,Lin,1,Private room,100,6,0.47,106
18654,Fayth,1,Private room,95,0,0.26,95
18655,Corporate Housing,1,Entire home/apt,200,311,0.21,511
18656,Jared,3,Entire home/apt,249,365,0.18,614
18657,Marie,1,Private room,33,0,0.26,33
18658,Christina,1,Private room,80,215,2.69,295
18659,Brigid,2,Entire home/apt,160,0,0.12,160
18660,Angelo,2,Private room,50,28,2.08,78
18661,Amey,3,Private room,50,0,0.21,50
18662,Sogol,2,Entire home/apt,100,0,0.03,100
18663,Silvia,2,Private room,33,323,2.92,356
18664,Shirley,2,Private room,100,365,0.46,465
18667,James,2,Entire home/apt,60,0,0.05,60
18668,Krzysztof,2,Entire home/apt,89,144,0.34,233
18669,Max,1,Private room,97,134,2.8,231
18670,Aziz,1,Entire home/apt,164,0,0.23,164
18671,Stat,2,Private room,57,365,0.03,422
18672,Deborah,3,Entire home/apt,66,180,2.71,246
18674,Roy & Rita,1,Entire home/apt,199,54,0.58,253
18675,Ari,2,Private room,52,104,1.65,156
18676,Daniel,2,Private room,70,0,0.18,70
18677,Talia,2,Entire home/apt,170,0,0.5,170
18678,Jacob,2,Private room,62,0,0.22,62
18679,Cranston,1,Entire home/apt,200,89,2.23,289
18680,Kenny,1,Private room,75,0,0.09,75
18681,Jerald,1,Entire home/apt,200,51,0.94,251
18682,Tiffany,2,Entire home/apt,160,0,0.52,160
18683,Ermanno,1,Private room,100,32,0.21,132
18684,Barbara,2,Private room,100,58,3.65,158
18685,Cal,1,Private room,58,0,0.03,58
18687,Nicolette,2,Private room,120,149,0.23,269
18688,Chris,3,Entire home/apt,95,259,2.6,354
18689,Aziz,2,Entire home/apt,150,0,0.06,150
18690,Allen,2,Entire home/apt,150,35,4.24,185
18691,Tanya,2,Entire home/apt,95,188,0.3,283
18692,Jeremy & Laura,1,Entire home/apt,250,319,0.03,569
18693,Scott,2,Private room,37,0,0.03,37
18694,Bradley,2,Private room,75,88,0.12,163
18695,Carlos,2,Private room,67,60,2.51,127
18696,Kat,2,Private room,59,189,0.2,248
18697,Chris & Jayma,2,Entire home/apt,227,250,0.06,477
18698,Russell,1,Entire home/apt,160,2,0.28,162
18699,Eddie & Lois,5,Entire home/apt,125,362,2.82,487
18700,Dario,1,Private room,50,0,0.41,50
18701,Nelly,2,Entire home/apt,80,0,2.42,80
18702,Eric,2,Entire home/apt,225,136,3.23,361
18703,Michael,1,Private room,180,57,9.24,237
18704,Krzysztof,2,Entire home/apt,109,176,0.2,285
18705,Maurice,1,Private room,100,34,2.5,134
18706,Krzysztof,2,Entire home/apt,79,136,0.35,215
18707,Juan,3,Private room,105,0,0.26,105
18708,Daniel,1,Entire home/apt,125,35,3.21,160
18709,Zhur,3,Private room,47,152,1.13,199
18710,Oates,2,Private room,60,0,0.55,60
18711,Chris,1,Entire home/apt,120,0,0.17,120
18712,Mj,1,Entire home/apt,195,134,2.59,329
18713,Yudum,3,Private room,60,34,1.22,94
18714,Colleen,1,Private room,99,0,0.15,99
18715,Justin,1,Entire home/apt,300,0,0.32,300
18716,Sol,2,Entire home/apt,250,178,1.79,428
18717,Elizabeth,1,Entire home/apt,105,0,0.52,105
18719,Luffy,3,Shared room,27,365,0.48,392
18720,Chip,1,Private room,65,225,0.21,290
18721,Leslie,3,Private room,42,52,0.18,94
18722,Tianna,1,Private room,100,0,0.03,100
18723,Amy,1,Private room,120,89,0.35,209
18724,Zi Ying,1,Entire home/apt,199,11,0.56,210
18725,Ruth,1,Private room,85,2,1.46,87
18726,Sunshine,2,Entire home/apt,135,206,3.12,341
18727,Gino,2,Shared room,50,0,0.03,50
18728,Sidney,2,Private room,120,313,2.53,433
18729,Maria,2,Entire home/apt,160,0,0.06,160
18730,Amy,1,Private room,120,89,0.75,209
18731,Amy,1,Private room,120,89,0.71,209
18732,Amy,1,Shared room,100,82,1.48,182
18734,Mathieu,2,Private room,72,0,0.06,72
18736,Dee,2,Private room,72,365,3.13,437
18737,Robert,1,Entire home/apt,200,0,0.12,200
18738,Elena,2,Private room,48,0,0.32,48
18739,Richard,2,Entire home/apt,95,0,0.79,95
18740,Meghan,1,Entire home/apt,800,173,0.14,973
18741,Sandra,1,Private room,49,0,0.03,49
18742,Mallary,2,Private room,65,0,1.38,65
18743,Scott,1,Private room,129,89,0.76,218
18744,Kaitlyn,2,Private room,113,37,0.78,150
18745,Harvey,3,Entire home/apt,100,342,5.81,442
18746,Michael,2,Entire home/apt,175,282,0.85,457
18747,Lenissima,2,Entire home/apt,575,179,0.19,754
18748,Jefferson,2,Entire home/apt,135,0,0.17,135
18749,Leah,1,Private room,200,333,1.2,533
18750,Valerie,2,Entire home/apt,152,321,4.13,473
18751,Nicholas,3,Entire home/apt,140,298,3.34,438
18752,Wilson,2,Entire home/apt,800,364,0.04,1164
18753,Caroline,1,Private room,95,49,2.94,144
18754,Krzysztof,2,Entire home/apt,80,152,0.26,232
18755,Eyal,1,Entire home/apt,215,200,2.59,415
18756,Remy,2,Entire home/apt,140,7,2.4,147
18757,John,1,Entire home/apt,110,35,0.26,145
18758,Nichole,1,Entire home/apt,100,0,0.26,100
18759,Elana,2,Private room,100,0,0.06,100
18760,Macushla,2,Entire home/apt,94,0,0.14,94
18761,Vicky,3,Private room,76,112,0.97,188
18762,Eliana,3,Entire home/apt,150,329,1.48,479
18763,Jackie,1,Entire home/apt,195,344,1.41,539
18764,David,1,Private room,49,284,0.15,333
18765,Rhondella,1,Entire home/apt,500,361,0.15,861
18766,Zach,2,Private room,45,0,0.03,45
18767,Amy,3,Private room,50,78,1.56,128
18768,Floor,1,Entire home/apt,295,0,0.09,295
18769,Christopher,2,Private room,65,0,0.09,65
18770,Gina,1,Entire home/apt,90,73,2.32,163
18771,Irie,1,Private room,71,305,0.18,376
18772,Alex,2,Entire home/apt,155,333,0.56,488
18773,Zack,3,Private room,40,0,0.17,40
18774,Jason,2,Entire home/apt,50,0,0.12,50
18775,Trey,2,Private room,50,0,0.26,50
18776,Kara,1,Entire home/apt,199,189,0.05,388
18777,Stephanie,2,Entire home/apt,136,255,2.84,391
18778,Krzysztof,2,Entire home/apt,80,97,0.32,177
18779,Hillary,1,Private room,65,0,0.04,65
18780,Phyllis,2,Entire home/apt,200,20,0.15,220
18781,Landon,2,Entire home/apt,148,0,0.49,148
18782,Harriet,1,Private room,100,0,0.29,100
18783,Annika,2,Private room,90,0,0.15,90
18784,Alicia,2,Entire home/apt,239,11,0.29,250
18785,Erin,1,Entire home/apt,150,14,1.42,164
18786,Tamar,1,Entire home/apt,300,8,0.64,308
18787,Mor,1,Entire home/apt,125,0,0.09,125
18788,Ali,1,Private room,60,0,0.59,60
18789,Heidi,1,Entire home/apt,200,89,0.73,289
18790,Chris,3,Private room,50,280,0.06,330
18792,Sidney,2,Private room,100,307,3.95,407
18793,Vytaute,3,Entire home/apt,50,65,3.21,115
18795,Josh,2,Private room,50,0,2.57,50
18796,Meg,1,Entire home/apt,198,8,0.64,206
18798,Nancy,3,Entire home/apt,200,131,0.71,331
18799,Kathleen,2,Private room,55,42,0.81,97
18800,Tanya,5,Private room,80,308,1.1,388
18801,S.,1,Entire home/apt,165,0,0.06,165
18802,Barbara,1,Entire home/apt,415,22,1.68,437
18804,Th,1,Entire home/apt,235,0,0.09,235
18805,Julia,3,Private room,99,284,0.93,383
18806,Val,1,Entire home/apt,180,5,0.53,185
18807,Stephen,2,Entire home/apt,180,179,0.23,359
18808,Lio & Kim And Yotam,2,Entire home/apt,100,69,0.12,169
18809,Matthew,2,Private room,88,0,0.23,88
18810,Manny & Gemma,2,Private room,56,44,4.49,100
18811,Evan,2,Entire home/apt,98,9,0.66,107
18812,Loretta,2,Entire home/apt,93,3,1.42,96
18813,Rachel,1,Private room,60,136,2.13,196
18814,Andres&Ine,2,Entire home/apt,250,30,1.2,280
18815,Jason,2,Entire home/apt,225,0,1.51,225
18816,Nichole,2,Entire home/apt,400,90,0.06,490
18817,Gracelyn,2,Entire home/apt,130,0,0.15,130
18818,Logan,2,Entire home/apt,249,38,1.27,287
18819,Caroline,2,Entire home/apt,85,355,1.24,440
18820,Eduardo,4,Private room,30,38,1.68,68
18821,Sharon,2,Private room,60,163,5.92,223
18822,Sidney,2,Private room,80,286,2.9,366
18823,Lisa,1,Private room,129,61,3.95,190
18824,Phillip,2,Shared room,250,83,1.09,333
18825,David,1,Private room,110,280,0.76,390
18827,Sasha,2,Private room,75,0,0.23,75
18828,Kara,1,Entire home/apt,199,365,0.08,564
18829,Esi,1,Entire home/apt,129,0,1.96,129
18830,Toby,1,Private room,75,0,0.09,75
18831,Odi,3,Entire home/apt,105,13,1.42,118
18832,Lucia,4,Private room,49,0,0.73,49
18833,Abdul Fattah,2,Private room,215,0,0.1,215
18834,KaLisa & Christian,1,Entire home/apt,85,0,0.18,85
18835,Julia,2,Entire home/apt,102,38,1.3,140
18836,Tara,4,Private room,85,0,0.47,85
18837,Shawn,2,Private room,25,0,0.03,25
18839,Sydney,1,Private room,41,0,1.67,41
18840,Lauren,2,Entire home/apt,280,0,0.14,280
18841,Thomas,1,Entire home/apt,165,0,0.03,165
18842,Adam,1,Private room,40,102,4.75,142
18843,Aimee,1,Private room,120,81,0.59,201
18844,Vicky,1,Private room,60,0,0.12,60
18845,Ann,2,Private room,70,109,5.06,179
18846,Steve,1,Entire home/apt,130,188,0.29,318
18848,Brian,2,Private room,80,0,0.12,80
18849,Dennis,2,Entire home/apt,145,0,2.87,145
18850,Abby,1,Entire home/apt,260,0,0.23,260
18851,Giorgia,2,Entire home/apt,86,17,1.62,103
18852,Kim,1,Entire home/apt,219,0,0.16,219
18853,Gracelyn,2,Private room,90,0,0.11,90
18854,Gilles,1,Private room,70,0,0.09,70
18857,Jack,1,Private room,85,1,2.54,86
18858,Joseph,3,Entire home/apt,125,0,0.06,125
18859,Derek,2,Private room,60,0,0.57,60
18860,David,1,Entire home/apt,225,27,2.47,252
18861,Natasha,2,Entire home/apt,100,327,4.78,427
18862,Saif,2,Entire home/apt,218,226,3.41,444
18863,Ivia,2,Entire home/apt,200,194,0.22,394
18864,Ricardo,1,Private room,55,270,3.34,325
18865,Daniela,2,Private room,90,4,0.5,94
18866,Lidia,2,Entire home/apt,105,269,0.77,374
18867,George,1,Entire home/apt,195,285,0.92,480
18869,Dana,2,Entire home/apt,150,363,0.41,513
18872,Ciro,1,Entire home/apt,185,0,0.06,185
18873,Josh,2,Private room,50,291,1.91,341
18874,Jonathan,2,Private room,70,15,1.66,85
18875,Adrian,3,Entire home/apt,180,351,1.32,531
18876,Nickesha,3,Private room,65,174,2.16,239
18877,Eliahu,1,Private room,69,345,3.09,414
18878,Ren,3,Entire home/apt,500,0,0.09,500
18879,Brooklyn&   Breakfast    -Len-,2,Private room,40,309,4.91,349
18880,Clif,3,Entire home/apt,85,142,0.92,227
18881,Mary Catherine,1,Entire home/apt,250,312,0.15,562
18882,Michelle,1,Entire home/apt,69,42,5.22,111
18883,Iryna,1,Entire home/apt,270,255,2.06,525
18884,Jazzy,3,Private room,53,358,0.06,411
18885,Peter & Nora,2,Entire home/apt,100,166,2.12,266
18886,Adriana,3,Private room,52,249,0.43,301
18887,Vie,4,Entire home/apt,299,358,0.18,657
18888,Jeremy & Laura,1,Entire home/apt,175,311,0.04,486
18889,Maria,4,Private room,43,88,0.3,131
18890,Beryl,2,Private room,50,365,1.03,415
18892,Donna,2,Private room,70,364,3.19,434
18893,Jaye (And Spike),2,Private room,78,30,2.44,108
18894,Beryl,2,Private room,50,266,1.26,316
18895,Mor,1,Entire home/apt,200,364,0.17,564
18896,S.A.,2,Private room,60,89,2.24,149
18897,Saralena,1,Entire home/apt,150,58,0.23,208
18898,Elvin,3,Private room,75,164,6.19,239
18899,Roselle,2,Entire home/apt,150,101,3.61,251
18900,Bianca,1,Private room,129,27,2.87,156
18901,Lisa,1,Entire home/apt,220,207,0.7,427
18903,Joe,2,Entire home/apt,105,6,0.21,111
18904,Anna,2,Private room,125,164,2.88,289
18905,ResortShare5,1,Private room,378,285,0.05,663
18906,Blake,3,Private room,61,0,0.44,61
18908,Nadia,2,Private room,75,0,0.29,75
18909,Zoë,1,Private room,80,0,0.06,80
18911,Jody,2,Entire home/apt,259,155,4.58,414
18912,Lucy,3,Entire home/apt,70,331,0.49,401
18913,Hanley,2,Private room,60,0,0.03,60
18914,Anu-Raga,3,Private room,65,18,1.09,83
18915,Ethan,1,Entire home/apt,180,0,0.3,180
18916,Zachary,2,Entire home/apt,180,74,3.74,254
18917,Mark,3,Private room,45,238,0.44,283
18918,Pamela,1,Private room,112,0,0.04,112
18919,Shelley,1,Entire home/apt,168,32,4.08,200
18921,Erin,2,Entire home/apt,130,0,0.38,130
18923,Corporate Housing,1,Entire home/apt,142,66,0.24,208
18924,Jacob,1,Entire home/apt,199,0,0.19,199
18925,Joy,1,Private room,60,5,0.15,65
18927,Jessica,1,Private room,85,0,0.6,85
18928,Desi,1,Private room,99,246,3.72,345
18929,Trista,2,Shared room,37,362,0.35,399
18930,Deanna,2,Private room,40,0,0.03,40
18931,Andrew,2,Private room,45,80,2.92,125
18932,Arthur,1,Entire home/apt,77,1,0.56,78
18933,Vivian,1,Private room,55,215,0.09,270
18934,Nixie & Hai,3,Private room,60,347,3.07,407
18936,Ryan,2,Entire home/apt,40,10,0.24,50
18937,Karlene,3,Private room,68,359,0.47,427
18938,Vanessa,2,Private room,85,0,0.03,85
18939,Nurcan,3,Private room,55,322,4.93,377
18940,Nurcan,3,Private room,45,308,3.93,353
18941,Nurcan,3,Private room,50,323,4.25,373
18942,Oliver,3,Entire home/apt,54,0,0.93,54
18943,Nickesha,3,Private room,70,365,3.65,435
18945,Michael,2,Entire home/apt,150,0,0.18,150
18946,Bill,1,Entire home/apt,249,17,0.71,266
18947,Yuichi,2,Entire home/apt,90,0,0.06,90
18948,Emanuel,1,Entire home/apt,584,179,2.62,763
18949,Jeremy & Laura,1,Private room,135,303,0.07,438
18950,Kimberly,2,Private room,55,83,1.25,138
18951,Ken,1,Entire home/apt,267,356,0.04,623
18952,Adam,1,Entire home/apt,350,175,2.5,525
18953,Jeffree,1,Entire home/apt,99,23,1.24,122
18954,Stat,3,Private room,40,354,0.04,394
18956,Stat,3,Private room,43,306,0.07,349
18957,Carla,2,Private room,45,159,1.24,204
18958,Leandro,2,Entire home/apt,88,0,0.24,88
18961,Natalia,2,Private room,40,0,0.15,40
18963,Katie,1,Private room,115,7,0.44,122
18965,David,3,Private room,65,353,1.2,418
18966,Anush,1,Private room,110,167,0.94,277
18968,David,1,Private room,47,342,0.31,389
18969,Todd,1,Private room,150,13,1.06,163
18970,Diana,2,Entire home/apt,249,0,1.46,249
18971,David,1,Entire home/apt,225,0,0.44,225
18972,Chris,2,Entire home/apt,195,93,3.77,288
18973,Samantha,3,Private room,90,10,0.18,100
18974,Grisula,1,Private room,64,272,2.9,336
18975,Alex,1,Entire home/apt,750,281,1.24,1031
18978,Yosef And Chava,2,Entire home/apt,105,0,0.12,105
18979,Liam,1,Entire home/apt,215,0,0.48,215
18981,Jeanie,1,Private room,79,238,0.78,317
18982,Tamara,3,Entire home/apt,155,309,2.86,464
18983,Kimberly,2,Private room,99,90,0.61,189
18984,Stat,2,Private room,57,216,0.05,273
18985,Felipe,1,Private room,140,0,3.09,140
18986,Eddie & Lois,5,Private room,69,355,1.8,424
18988,Joseph,2,Private room,95,0,0.85,95
18989,Elias,2,Entire home/apt,150,5,0.37,155
18990,Greg,1,Private room,110,60,5.87,170
18991,Nina,1,Entire home/apt,175,326,0.16,501
18992,Risha,2,Entire home/apt,85,244,3.91,329
18993,Panthea,4,Entire home/apt,76,0,0.71,76
18994,Bryan,1,Entire home/apt,399,364,0.03,763
18995,Lynne,3,Private room,79,179,0.16,258
18996,Alina,2,Private room,41,189,0.16,230
18997,Andre,2,Private room,85,189,0.09,274
18998,Andre,2,Private room,120,340,0.23,460
18999,Nickesha,3,Private room,65,180,2.87,245
19000,Russell,2,Private room,54,136,4.98,190
19001,Rebecca,2,Private room,60,14,0.06,74
19003,Susan,2,Entire home/apt,250,7,0.57,257
19004,Pavle,2,Entire home/apt,125,20,0.3,145
19005,Rishab,1,Private room,80,0,0.03,80
19006,Toyce,1,Entire home/apt,105,0,0.09,105
19007,Karen,2,Private room,60,181,1.0,241
19008,Lourdes,3,Private room,239,135,0.52,374
19009,Charles,2,Entire home/apt,200,0,0.24,200
19010,Sandrine,1,Entire home/apt,250,158,0.03,408
19011,Sarah,1,Entire home/apt,200,28,2.33,228
19012,Theresa,2,Private room,75,302,0.4,377
19013,Cory,1,Entire home/apt,225,0,0.06,225
19014,Shane,1,Private room,110,89,1.21,199
19015,Glenn,3,Private room,75,67,0.68,142
19016,Pablo,4,Private room,40,179,0.1,219
19017,Joshua,2,Entire home/apt,100,0,0.76,100
19018,Ian,2,Private room,55,0,0.09,55
19019,Greg,1,Entire home/apt,185,0,0.03,185
19021,Karen,1,Entire home/apt,165,157,1.7,322
19022,Philippe,2,Entire home/apt,188,30,0.74,218
19023,Elaine,2,Entire home/apt,140,275,1.88,415
19024,Lydia,3,Entire home/apt,115,66,0.15,181
19025,Whit,2,Entire home/apt,150,35,0.48,185
19026,Migdalia,1,Entire home/apt,300,110,2.05,410
19027,Maya,1,Private room,132,364,0.57,496
19028,Eric,1,Private room,95,74,2.33,169
19029,Maya,1,Private room,85,364,0.17,449
19030,Glory,2,Private room,65,156,0.41,221
19031,Alex,2,Entire home/apt,150,55,2.01,205
19032,Juliet,2,Private room,100,0,0.42,100
19033,Shachar,1,Private room,119,124,0.36,243
19034,Clark,1,Entire home/apt,200,82,4.99,282
19035,Mark Winston,2,Entire home/apt,90,32,6.61,122
19036,Dalibel,1,Entire home/apt,163,0,0.27,163
19037,Carol,2,Private room,68,139,3.17,207
19038,Steven,2,Entire home/apt,100,61,1.72,161
19039,Kyle,1,Entire home/apt,169,365,0.15,534
19042,Bridget,3,Private room,70,232,1.77,302
19043,Melissa,3,Private room,90,331,1.28,421
19044,Caitlin,1,Private room,100,62,2.2,162
19045,Leticia,2,Private room,65,290,0.69,355
19046,Juliana,1,Entire home/apt,110,277,0.34,387
19047,Ali,3,Private room,46,0,0.03,46
19048,Amaru,2,Private room,40,54,2.64,94
19049,Maria,2,Private room,80,88,0.58,168
19050,Sharan,1,Entire home/apt,249,0,0.03,249
19051,Alex,1,Private room,110,0,0.26,110
19052,Nathaniel,3,Private room,48,158,2.9,206
19053,Jazzy,2,Private room,50,3,2.3,53
19054,Sunshine,2,Entire home/apt,135,247,2.01,382
19055,Yenpo,3,Private room,59,95,0.27,154
19056,Pamela,1,Private room,149,0,0.71,149
19057,Maryna,2,Shared room,35,343,1.01,378
19058,Silvia,2,Entire home/apt,85,356,0.97,441
19059,Erica,1,Entire home/apt,120,42,0.39,162
19062,Yochi,1,Private room,180,90,6.07,270
19063,Julie,1,Entire home/apt,299,335,3.11,634
19064,Aviva,2,Private room,60,341,0.05,401
19065,Beck,2,Private room,45,0,0.06,45
19066,Jesse,2,Private room,50,90,1.44,140
19068,Pete,2,Entire home/apt,151,188,0.41,339
19070,Ephraim,1,Entire home/apt,160,118,3.04,278
19071,Kevin,2,Private room,55,0,1.52,55
19072,Nuan,1,Private room,120,82,0.63,202
19073,Wynpoints,1,Private room,699,365,0.12,1064
19074,Nichole,2,Private room,65,364,0.06,429
19075,Arin,2,Private room,130,146,3.2,276
19076,Julian,2,Private room,70,0,0.45,70
19077,Michael,1,Entire home/apt,67,331,0.15,398
19078,Mitch,2,Entire home/apt,130,330,2.15,460
19079,Corporate Housing,1,Entire home/apt,117,317,0.3,434
19080,Jennifer,2,Entire home/apt,98,0,0.17,98
19081,Thomas,2,Entire home/apt,120,0,0.09,120
19082,Masahiro,2,Private room,75,56,2.14,131
19084,Norma-Ester-,2,Private room,60,52,0.74,112
19085,Jonathan,1,Private room,40,316,0.57,356
19087,Norma-Ester-,2,Private room,60,294,1.05,354
19089,Michael,1,Shared room,95,179,0.21,274
19090,Kristin,1,Entire home/apt,124,0,0.03,124
19092,Ekaterina,2,Private room,90,0,0.03,90
19093,Norma-Ester-,2,Private room,70,325,0.73,395
19094,Tony & Grace,5,Entire home/apt,150,336,0.78,486
19095,Madison,1,Entire home/apt,93,0,1.28,93
19096,James,3,Private room,80,188,0.15,268
19097,Michelle,3,Private room,76,178,0.68,254
19098,Sol,2,Entire home/apt,113,365,0.18,478
19099,Chen,2,Entire home/apt,130,0,0.03,130
19100,Wanhsuan,1,Entire home/apt,160,168,0.19,328
19101,Frank,1,Private room,89,0,0.09,89
19102,Dillon,2,Private room,50,0,0.17,50
19103,Erik,1,Entire home/apt,150,0,0.13,150
19104,Catherine,2,Entire home/apt,125,87,0.34,212
19105,Pamela,3,Private room,85,180,1.41,265
19106,Stephen,2,Private room,45,0,0.13,45
19108,Lawrence,2,Entire home/apt,170,78,2.99,248
19109,G,2,Entire home/apt,85,36,1.12,121
19110,ResortShare5,1,Entire home/apt,462,299,0.1,761
19111,ResortShare5,1,Private room,198,333,0.89,531
19112,ResortShare5,1,Entire home/apt,198,263,0.51,461
19113,Josefina,3,Private room,43,283,2.08,326
19114,Lynne,3,Private room,65,179,0.12,244
19115,Chitra,2,Private room,41,0,0.24,41
19116,Jeff,1,Private room,89,0,0.03,89
19117,Lucey,2,Private room,80,47,3.14,127
19119,Valerie,1,Private room,80,118,0.29,198
19120,Monika,3,Private room,75,57,2.61,132
19121,Wynpoints,1,Private room,749,365,0.15,1114
19122,Wynpoints,1,Private room,799,365,0.09,1164
19123,Wynpoints,1,Private room,599,365,0.24,964
19124,Laura,2,Private room,75,311,0.54,386
19125,Rosa,1,Private room,79,0,0.21,79
19126,Wynpoints,1,Private room,699,365,0.09,1064
19127,Wynpoints,1,Private room,499,365,0.36,864
19128,Chantal,2,Entire home/apt,175,162,2.23,337
19129,Tony & Grace,5,Private room,110,337,0.63,447
19131,Christen,2,Private room,50,86,1.61,136
19132,Glory,2,Private room,50,211,0.45,261
19133,Julia,1,Entire home/apt,150,29,1.13,179
19134,Ben,2,Private room,50,0,0.15,50
19135,Wynpoints,1,Private room,799,365,0.06,1164
19136,Wynpoints,1,Private room,499,365,0.21,864
19137,Karen,1,Entire home/apt,189,30,4.09,219
19138,Wynpoints,1,Private room,649,365,0.39,1014
19139,Wynpoints,1,Private room,799,365,0.09,1164
19140,Andrew,1,Entire home/apt,275,0,0.15,275
19141,Angela,1,Private room,100,83,1.36,183
19142,Maimouna,1,Entire home/apt,70,50,0.76,120
19144,Walter,2,Entire home/apt,95,193,2.42,288
19145,D&N,1,Entire home/apt,140,154,4.07,294
19146,Na,1,Private room,75,51,9.39,126
19148,Edward,1,Private room,65,10,1.34,75
19155,Andrea,1,Private room,33,44,0.16,77
19156,Nina,2,Entire home/apt,350,179,0.58,529
19161,Olivier,1,Entire home/apt,200,139,0.28,339
19162,Stewart,1,Entire home/apt,214,17,0.48,231
19163,Carla,2,Private room,40,185,0.63,225
19164,Stephany,2,Private room,39,174,3.09,213
19165,Mario,1,Private room,75,271,1.61,346
19166,Heroni,1,Private room,100,0,0.36,100
19167,Yukee,1,Private room,49,326,1.83,375
19168,Aitan,2,Entire home/apt,185,269,3.25,454
19169,Nathan,2,Private room,100,0,0.27,100
19170,Nicola,2,Entire home/apt,130,0,0.24,130
19171,Cristina,1,Entire home/apt,375,110,0.51,485
19172,Paolo,1,Private room,69,359,0.03,428
19173,Christine,2,Private room,125,136,0.88,261
19174,Aracelis,2,Private room,85,279,0.93,364
19175,Brian & Jonathan,1,Private room,59,203,1.51,262
19176,Andy,1,Entire home/apt,110,0,0.06,110
19177,Peter,2,Entire home/apt,250,0,0.18,250
19178,Matthew,1,Entire home/apt,175,0,0.31,175
19179,Amanda,2,Private room,99,89,1.13,188
19180,Rebecca,1,Entire home/apt,175,0,0.61,175
19181,Johari,2,Private room,38,0,0.15,38
19182,Jovanni & Natasha,4,Private room,77,0,0.29,77
19183,Gaia&Pietro,1,Entire home/apt,850,262,1.04,1112
19185,Christiane,1,Entire home/apt,128,0,0.19,128
19186,Miss Dy,3,Entire home/apt,49,102,12.84,151
19188,Chaim,2,Entire home/apt,83,0,0.04,83
19189,Fely,2,Private room,80,0,0.09,80
19190,Ken,2,Entire home/apt,400,265,3.53,665
19191,Abc,1,Entire home/apt,450,165,0.38,615
19192,Leslie,2,Private room,80,0,0.06,80
19193,Haru,1,Private room,82,14,2.76,96
19194,Sasha,4,Private room,68,87,0.19,155
19195,Joyce,1,Entire home/apt,200,49,3.19,249
19196,Tim & Rachel,2,Entire home/apt,75,232,3.29,307
19197,Lindsay,1,Private room,120,0,0.55,120
19198,Vacation Generation,1,Entire home/apt,125,0,0.34,125
19201,Zia,3,Entire home/apt,110,8,0.27,118
19202,David,2,Entire home/apt,349,0,0.16,349
19203,Lauren,1,Private room,85,0,0.16,85
19204,Mike,2,Private room,66,0,0.09,66
19205,Iwona,3,Private room,75,8,1.33,83
19206,Caroline,2,Entire home/apt,144,0,0.96,144
19207,Raymond,1,Entire home/apt,550,88,0.17,638
19208,Gabriel,1,Private room,110,0,0.15,110
19209,Jasmine,2,Private room,51,351,1.35,402
19210,Maria,1,Private room,118,0,0.08,118
19211,Tony & Grace,5,Private room,70,336,1.84,406
19212,Maria,1,Private room,118,0,0.17,118
19215,Anu,2,Entire home/apt,135,5,0.66,140
19216,ResortShare5,1,Private room,252,324,0.09,576
19217,Sam,1,Entire home/apt,300,364,0.69,664
19218,Daljit,3,Private room,49,20,3.2,69
19219,Belkis,4,Private room,40,328,1.94,368
19220,Tracy,2,Private room,65,0,0.03,65
19221,Kevin,2,Entire home/apt,160,0,0.03,160
19223,Diana,1,Private room,60,60,1.79,120
19224,Airamis,4,Private room,35,0,3.48,35
19225,Patricia,2,Private room,125,288,0.46,413
19226,Jean Victor,2,Entire home/apt,105,189,0.24,294
19227,Lauren,2,Entire home/apt,150,0,0.12,150
19228,Daniel,1,Private room,73,38,0.48,111
19229,Andre,2,Private room,95,189,0.15,284
19230,Andre,2,Private room,75,311,0.39,386
19231,Juan Eduardo,1,Entire home/apt,120,0,0.25,120
19233,Yasir,1,Entire home/apt,199,0,0.03,199
19234,Chadine,3,Private room,60,0,0.1,60
19235,Malik,2,Private room,88,67,2.45,155
19236,Henry,1,Entire home/apt,1000,365,0.51,1365
19237,Nauman,1,Entire home/apt,179,0,0.09,179
19238,Matt,1,Entire home/apt,120,0,0.12,120
19239,Giovanni,3,Private room,50,153,6.91,203
19240,Rahul,1,Private room,110,0,0.21,110
19241,Benjamin,2,Entire home/apt,390,321,4.11,711
19242,Wynpoints,1,Private room,269,365,0.24,634
19244,Daniel,1,Private room,65,365,0.9,430
19245,Rémi,1,Entire home/apt,150,32,0.39,182
19246,Ritchie,2,Private room,45,0,0.21,45
19247,Joanna,3,Private room,105,70,0.33,175
19248,Pamela,3,Private room,55,365,2.12,420
19249,Mag,3,Entire home/apt,105,316,2.75,421
19251,Clyde,2,Private room,75,335,1.95,410
19252,Patrick,2,Private room,38,0,0.35,38
19253,Eean,4,Private room,50,342,0.76,392
19254,Satomi,2,Private room,70,292,0.45,362
19255,Jose,3,Private room,85,364,1.26,449
19256,Luis,3,Private room,70,76,2.28,146
19257,Andrea,1,Private room,85,89,0.24,174
19258,J.P.,2,Entire home/apt,180,54,0.21,234
19259,Chelsea,1,Entire home/apt,600,96,0.5,696
19260,Lauren,1,Private room,75,14,0.35,89
19262,Chima,3,Private room,47,56,0.06,103
19263,Gisele,2,Entire home/apt,300,16,0.18,316
19264,Frank,3,Entire home/apt,150,76,0.61,226
19265,Michael,1,Entire home/apt,225,9,1.63,234
19266,Huong,3,Entire home/apt,149,66,0.15,215
19267,Raymond,1,Private room,100,233,4.6,333
19269,Steven,4,Private room,59,340,0.4,399
19270,Henry,1,Entire home/apt,2000,365,0.12,2365
19271,Arthur,2,Private room,77,315,0.3,392
19273,Joy,1,Entire home/apt,245,0,1.34,245
19274,Sarah & JC,1,Private room,50,155,0.23,205
19275,Ben,1,Private room,120,0,0.16,120
19276,Danny,1,Private room,55,0,0.05,55
19277,Jessica,2,Private room,110,267,3.13,377
19278,Mark,2,Private room,150,0,0.38,150
19279,Mark,2,Private room,71,0,0.73,71
19280,J.J.,1,Entire home/apt,300,0,0.21,300
19281,Gabriella,1,Entire home/apt,90,58,0.35,148
19282,Alexandra,2,Private room,65,0,0.09,65
19283,Alex,2,Entire home/apt,408,267,2.68,675
19284,Kristina,1,Private room,78,1,2.18,79
19285,Brett,2,Entire home/apt,95,338,1.57,433
19286,Michelle,1,Private room,99,123,2.63,222
19287,Caro & Allen,1,Private room,77,115,2.87,192
19288,Sophie,1,Entire home/apt,120,7,0.13,127
19289,Ted,2,Entire home/apt,125,13,2.78,138
19290,Eduardo,1,Private room,90,0,0.09,90
19291,Caribnb Hazel,2,Private room,86,324,1.64,410
19292,Patricio,3,Private room,99,176,1.41,275
19293,Jenny,1,Private room,115,275,2.55,390
19294,Marva,2,Private room,32,0,0.03,32
19296,Judith,1,Private room,100,0,0.09,100
19298,Max,2,Entire home/apt,95,141,0.6,236
19299,Jennifer,1,Entire home/apt,183,271,5.21,454
19300,Pardis,2,Entire home/apt,150,152,3.38,302
19301,Stephanie,2,Private room,75,0,0.06,75
19302,Gabriel,2,Entire home/apt,150,258,2.45,408
19304,Diane,1,Private room,1500,188,0.18,1688
19305,Jessica,2,Entire home/apt,500,106,0.16,606
19306,Jay,1,Entire home/apt,100,0,2.37,100
19307,Iwona,3,Private room,70,8,0.9,78
19308,Nathan,1,Private room,99,0,0.33,99
19309,Chary,2,Entire home/apt,80,0,0.17,80
19310,Christopher,2,Private room,79,173,1.12,252
19311,Josephine,1,Private room,80,0,0.33,80
19312,Jessica,1,Entire home/apt,200,101,3.5,301
19313,Alana,2,Entire home/apt,100,4,3.26,104
19314,Jasmine,1,Entire home/apt,200,66,1.32,266
19315,Lana,1,Private room,95,0,0.15,95
19316,Chezi,2,Entire home/apt,135,35,0.6,170
19318,Lori,1,Private room,85,8,4.3,93
19320,Ignani,1,Entire home/apt,275,41,1.14,316
19321,Kateryna,2,Private room,80,52,5.42,132
19322,Nan,1,Private room,108,0,0.03,108
19323,Georges,1,Private room,110,26,2.83,136
19324,Robin,3,Private room,95,50,1.71,145
19325,Elisa,2,Private room,95,5,0.73,100
19326,Noelky,2,Entire home/apt,160,220,3.91,380
19327,Sajad,1,Private room,50,0,0.85,50
19328,Una,2,Private room,45,364,0.42,409
19330,Pauline,2,Private room,101,12,2.74,113
19331,Joe,1,Entire home/apt,174,0,0.44,174
19332,Patrick,2,Private room,90,341,0.06,431
19333,Axel,2,Private room,65,60,2.08,125
19334,Andrew,3,Entire home/apt,94,48,2.96,142
19335,Lei,2,Private room,39,62,2.01,101
19336,Lei,2,Private room,39,1,0.54,40
19337,Yahaira,1,Private room,65,266,3.63,331
19338,Justin,1,Private room,100,0,0.56,100
19339,Steven,2,Entire home/apt,100,2,0.72,102
19340,Louise,1,Private room,100,0,0.41,100
19341,Shapel,3,Private room,29,0,2.2,29
19342,Genevieve,2,Entire home/apt,150,93,0.12,243
19343,Sean,2,Private room,110,2,0.12,112
19344,Mash,3,Entire home/apt,80,0,0.03,80
19346,Arthur,3,Private room,37,48,0.98,85
19347,Viki,2,Entire home/apt,175,206,3.92,381
19348,Jenny,1,Entire home/apt,375,285,1.54,660
19349,Sawyer,1,Entire home/apt,249,0,0.55,249
19350,Tony,1,Private room,80,0,0.45,80
19351,Alexey,2,Private room,90,52,2.88,142
19352,Nick,2,Private room,90,0,0.03,90
19353,Luke,2,Entire home/apt,250,230,3.62,480
19355,Javier,1,Entire home/apt,180,70,4.17,250
19356,Cathy,2,Entire home/apt,95,0,0.22,95
19357,Laurence,1,Private room,205,363,0.91,568
19358,Sara,2,Private room,87,361,0.36,448
19360,Letty,1,Private room,69,163,3.81,232
19361,Emily,1,Entire home/apt,125,0,0.05,125
19362,Melih,3,Shared room,30,206,0.43,236
19363,Joseph,2,Entire home/apt,150,0,1.83,150
19364,Ana,1,Private room,98,126,1.27,224
19365,Ignani,1,Private room,130,59,3.79,189
19366,Ting,3,Entire home/apt,122,84,1.06,206
19367,Alexandra,2,Shared room,40,17,1.45,57
19368,Katya,2,Private room,29,206,0.1,235
19369,Rosalia,4,Entire home/apt,100,83,5.16,183
19370,Sasha,2,Private room,90,0,0.03,90
19371,Xenios,3,Private room,99,0,0.16,99
19373,Darris,1,Private room,49,26,1.68,75
19374,Enrique,1,Private room,80,129,0.51,209
19375,Liliana,4,Private room,60,363,0.07,423
19376,Thelma,5,Private room,79,355,0.64,434
19377,Anna,1,Entire home/apt,145,0,3.07,145
19379,Katrin,2,Entire home/apt,138,83,2.27,221
19380,Jp,1,Private room,90,242,2.62,332
19381,Blanca,2,Entire home/apt,95,186,0.17,281
19382,Sugeiry,1,Shared room,65,0,0.81,65
19383,Nicole,2,Entire home/apt,90,0,0.54,90
19384,Renette,2,Entire home/apt,130,147,1.28,277
19385,Igor,2,Private room,70,72,1.45,142
19387,Gabe,2,Private room,100,0,0.21,100
19388,Nelya,2,Shared room,40,89,0.78,129
19389,George,3,Private room,33,86,0.77,119
19390,Tamicka,3,Private room,39,0,1.94,39
19392,Aleisha,1,Private room,75,358,0.57,433
19395,Martin,2,Entire home/apt,70,146,2.2,216
19396,Ben,2,Entire home/apt,250,3,0.49,253
19397,Michael,2,Private room,65,0,5.88,65
19398,Chavisa,2,Private room,40,0,0.62,40
19399,Michael,2,Private room,50,0,5.65,50
19400,Ben,3,Entire home/apt,78,0,0.16,78
19401,Michael,2,Private room,50,0,5.17,50
19402,Lidia,3,Private room,72,365,0.49,437
19403,Lidia,3,Private room,108,356,1.18,464
19404,Lidia,3,Private room,108,29,0.36,137
19405,Ayesha,2,Entire home/apt,170,8,0.64,178
19406,Amy,2,Entire home/apt,125,68,3.69,193
19407,Leo,1,Entire home/apt,149,76,2.69,225
19408,Alisha,2,Entire home/apt,125,0,0.38,125
19409,Anela,2,Entire home/apt,70,192,2.59,262
19410,Ally,1,Entire home/apt,120,0,0.4,120
19411,Alex,2,Private room,149,0,0.13,149
19413,Elise,1,Private room,150,112,2.34,262
19414,Coco,1,Private room,250,0,0.24,250
19415,Peter,1,Entire home/apt,375,296,0.33,671
19416,Inna,1,Entire home/apt,95,338,0.38,433
19417,Gal,1,Entire home/apt,129,326,0.06,455
19418,Luca,2,Private room,80,0,0.2,80
19419,Karen,2,Private room,45,77,1.36,122
19420,Petya,1,Private room,53,249,0.06,302
19421,Corporate Housing,1,Entire home/apt,125,342,0.36,467
19423,Connie,2,Private room,65,0,0.09,65
19428,Eva,1,Private room,99,35,0.09,134
19430,Bluebird,1,Entire home/apt,748,365,0.08,1113
19431,Sean,2,Private room,45,131,3.3,176
19432,Wendy,1,Entire home/apt,190,104,2.58,294
19433,Vincent,3,Entire home/apt,80,143,6.13,223
19436,Fabe,2,Entire home/apt,99,365,0.12,464
19437,Shai,1,Entire home/apt,229,137,0.27,366
19438,Gennady + Laura,2,Entire home/apt,55,215,2.82,270
19439,Grand,1,Private room,189,365,0.12,554
19440,Leatha,2,Entire home/apt,449,347,2.47,796
19441,Jeremy & Laura,1,Entire home/apt,202,327,0.11,529
19442,Claire,1,Entire home/apt,250,147,1.42,397
19444,Manuel,1,Private room,52,0,0.49,52
19445,Lucia,4,Entire home/apt,120,260,0.85,380
19446,Mike,1,Private room,90,0,1.84,90
19447,Leo,2,Private room,74,131,0.48,205
19448,Nicole,1,Entire home/apt,75,0,0.53,75
19450,Kelly,2,Entire home/apt,147,0,2.58,147
19451,Camila,2,Private room,50,0,0.09,50
19452,Amanda Brooke,1,Entire home/apt,250,0,0.03,250
19453,Kristy,1,Private room,40,0,0.16,40
19454,Michael,1,Entire home/apt,200,1,1.24,201
19455,Ward,2,Private room,80,133,3.5,213
19457,Victor,1,Shared room,65,0,0.24,65
19458,Albert,2,Private room,70,297,0.91,367
19459,Raymond,2,Entire home/apt,150,0,3.26,150
19460,Tristan,1,Entire home/apt,135,0,0.67,135
19461,Kartika,3,Private room,51,296,3.05,347
19462,Sam,1,Entire home/apt,335,263,1.89,598
19463,Martha,2,Entire home/apt,198,241,1.36,439
19464,Ryan,1,Private room,120,0,0.09,120
19465,Lei,2,Private room,39,101,0.98,140
19467,Mirtha,3,Entire home/apt,87,0,1.11,87
19468,Ashley,2,Entire home/apt,145,218,4.41,363
19469,Susan,5,Private room,80,358,0.22,438
19470,Caroline & Georg,2,Private room,90,0,0.09,90
19471,Crystal,2,Entire home/apt,125,347,0.95,472
19472,Kobby,2,Private room,75,145,0.15,220
19473,Brit,1,Entire home/apt,140,0,1.32,140
19474,Sean,2,Private room,2000,0,0.16,2000
19475,Alida,3,Private room,75,173,0.12,248
19476,Laura,1,Entire home/apt,150,267,0.21,417
19478,Michael,2,Private room,61,0,5.47,61
19479,Kim,2,Entire home/apt,160,68,3.0,228
19480,Cam,2,Private room,69,0,0.33,69
19481,Lara & David,2,Private room,199,0,0.66,199
19482,Brian,2,Entire home/apt,95,0,0.41,95
19483,Armelle,2,Private room,120,179,0.1,299
19484,Pascal,1,Entire home/apt,200,152,2.12,352
19485,Paul,2,Entire home/apt,190,5,0.57,195
19486,Ayami,1,Private room,65,0,0.03,65
19487,Antoine,2,Entire home/apt,160,48,2.05,208
19488,Max,1,Entire home/apt,235,151,2.33,386
19489,Finely,3,Private room,35,0,0.18,35
19490,Ariel,2,Private room,65,0,0.55,65
19492,Lisa,3,Private room,55,2,0.61,57
19493,Jill,2,Private room,50,0,0.07,50
19494,Christine,1,Entire home/apt,100,0,0.03,100
19495,Grand,1,Entire home/apt,195,351,0.06,546
19496,Michelle,2,Entire home/apt,100,25,3.02,125
19497,Katie,2,Entire home/apt,185,0,0.06,185
19498,Susan,2,Entire home/apt,135,0,0.37,135
19499,Antonia,1,Entire home/apt,175,63,0.82,238
19500,Justin,2,Entire home/apt,345,9,0.41,354
19501,Ches,2,Entire home/apt,275,276,3.14,551
19502,Denise,1,Private room,230,87,0.17,317
19503,Darren,2,Private room,85,221,0.8,306
19504,Sarah,2,Entire home/apt,130,89,0.39,219
19505,Joanne,3,Entire home/apt,79,105,1.35,184
19506,Lauren,1,Private room,110,0,0.03,110
19507,Pamela,3,Private room,63,363,1.91,426
19508,Barry,4,Private room,35,34,4.66,69
19509,Marie-Line,2,Private room,100,126,3.97,226
19510,Ryan,1,Private room,120,83,3.25,203
19512,Tiffany,2,Entire home/apt,90,201,1.61,291
19513,Fernanda,1,Entire home/apt,350,0,0.06,350
19514,Andrew,2,Entire home/apt,140,234,0.42,374
19515,Cici,1,Private room,90,20,0.3,110
19517,Catherine,2,Entire home/apt,110,0,0.35,110
19519,Tara,2,Private room,40,0,0.06,40
19520,Amy,2,Entire home/apt,200,0,0.09,200
19521,Chadine,3,Private room,60,158,0.16,218
19522,Emily,2,Entire home/apt,155,98,1.71,253
19523,Heather,2,Private room,75,0,0.03,75
19524,Tamicka,3,Private room,47,0,1.95,47
19525,Eva Maria,2,Entire home/apt,139,284,4.64,423
19526,Hurriyet Aydın /,2,Private room,39,146,1.03,185
19527,Mei,2,Private room,79,45,2.24,124
19528,Anna,2,Private room,95,163,2.44,258
19529,Kessy-Ann,2,Entire home/apt,93,86,6.35,179
19530,Bharat,2,Private room,71,0,0.36,71
19531,Mary,2,Entire home/apt,88,0,0.62,88
19532,David,2,Private room,55,247,1.27,302
19533,Kristen,1,Entire home/apt,115,0,0.16,115
19534,Jp,2,Entire home/apt,75,6,0.78,81
19535,Debbie,1,Entire home/apt,135,99,0.22,234
19536,Seth,1,Entire home/apt,209,16,4.8,225
19537,Chad & Noel,1,Entire home/apt,185,215,4.59,400
19539,Jennifer & Inam,2,Private room,48,136,0.24,184
19541,H,1,Private room,78,44,2.68,122
19543,Ana,1,Entire home/apt,129,74,2.32,203
19544,(Mary) Haiy,2,Entire home/apt,126,295,5.81,421
19545,Nikki,2,Entire home/apt,229,0,0.25,229
19546,Rose,1,Private room,110,0,0.22,110
19547,Janna,1,Entire home/apt,170,0,0.16,170
19548,Yorgos,3,Private room,55,53,3.29,108
19550,Marcus,2,Entire home/apt,200,166,0.29,366
19552,Shy,1,Entire home/apt,140,0,0.03,140
19554,Ian,1,Entire home/apt,210,211,6.4,421
19555,Sylvette,3,Private room,65,0,0.5,65
19556,Robin,1,Entire home/apt,186,77,3.42,263
19557,William M.,2,Entire home/apt,100,0,1.69,100
19558,Susan,2,Entire home/apt,250,35,1.07,285
19559,Flavia,2,Private room,89,0,0.03,89
19562,Kaya,1,Entire home/apt,180,0,0.37,180
19563,Maria,3,Private room,50,215,2.52,265
19564,Michelle,2,Entire home/apt,160,0,0.93,160
19566,Laila,1,Entire home/apt,145,177,0.23,322
19567,Lauren & Anthony,2,Entire home/apt,119,14,4.68,133
19568,Bill,3,Private room,49,0,0.37,49
19569,Hilary,2,Entire home/apt,300,310,0.06,610
19570,Ignani,1,Private room,140,44,2.05,184
19572,Viki,2,Entire home/apt,199,230,3.78,429
19573,Inez,2,Entire home/apt,125,78,2.8,203
19575,Anna,3,Entire home/apt,95,345,0.23,440
19576,Jeanne & Sara,2,Private room,60,0,2.85,60
19577,Diane And Ward,1,Entire home/apt,249,1,1.75,250
19578,Adam,2,Entire home/apt,160,0,0.09,160
19579,Alberto,1,Entire home/apt,175,12,1.04,187
19580,Tarirai,1,Private room,40,39,1.9,79
19582,Misha,2,Entire home/apt,79,0,1.64,79
19583,Blake,1,Entire home/apt,236,0,0.71,236
19584,Malin,1,Private room,120,0,0.03,120
19585,Eric,2,Entire home/apt,120,232,3.6,352
19586,Ubi,2,Private room,54,70,4.03,124
19587,Lyles,3,Private room,56,80,0.4,136
19588,Rachel,1,Private room,60,0,0.25,60
19589,Lisa,2,Private room,90,338,2.31,428
19590,Nkoli,2,Entire home/apt,260,88,0.11,348
19591,Tammy,1,Entire home/apt,125,0,0.26,125
19592,Israel,3,Private room,65,66,0.15,131
19593,Sophie,2,Entire home/apt,120,164,0.29,284
19594,Kajsa,2,Private room,55,0,0.09,55
19595,Rosy,2,Entire home/apt,130,0,0.21,130
19596,Tracy,3,Private room,96,343,2.3,439
19597,Tim,2,Private room,109,326,6.97,435
19598,Tim,2,Private room,99,352,6.71,451
19599,Gonzalo,2,Private room,55,0,0.13,55
19600,Olive,1,Entire home/apt,300,73,1.83,373
19602,Jennifer,1,Private room,155,0,0.04,155
19603,Sasha,1,Entire home/apt,133,5,0.72,138
19604,Dave + Suzanne,2,Entire home/apt,180,0,0.15,180
19605,Eleanor & Kameon,2,Entire home/apt,135,0,0.29,135
19606,Grand,1,Private room,179,337,0.13,516
19607,Wangari,1,Entire home/apt,100,0,0.06,100
19608,Aydin,1,Private room,100,4,0.52,104
19609,Anthony,2,Private room,45,250,0.06,295
19610,James,1,Entire home/apt,250,3,0.37,253
19612,Jessica,2,Private room,350,244,0.64,594
19613,Crystal,1,Private room,95,0,0.68,95
19614,Rory,1,Entire home/apt,218,305,1.85,523
19615,Gretchen,2,Entire home/apt,176,197,2.52,373
19616,Sonia,1,Private room,89,0,0.1,89
19617,Lili,1,Entire home/apt,160,147,3.17,307
19618,Chloe,2,Private room,89,0,0.07,89
19619,Beverly,4,Entire home/apt,79,5,0.57,84
19620,Riley,1,Private room,70,73,1.94,143
19622,Tanya,2,Entire home/apt,150,179,0.09,329
19623,Jane,2,Private room,63,342,0.28,405
19624,Juan P,2,Private room,63,0,0.62,63
19625,Jessica And Danny,3,Private room,55,0,0.15,55
19626,Sara,2,Private room,90,0,0.09,90
19627,Natalie,2,Entire home/apt,164,0,0.03,164
19628,Gerardo,3,Private room,40,300,3.63,340
19629,Megan & Matt,2,Entire home/apt,250,0,0.11,250
19630,Myko,1,Private room,95,272,1.4,367
19631,Myko,1,Private room,90,246,1.9,336
19632,Yoseph & Malky,2,Private room,111,156,2.28,267
19633,Lydia,2,Entire home/apt,120,85,1.82,205
19634,Mariam,2,Entire home/apt,95,14,1.81,109
19635,Michele,1,Entire home/apt,175,0,0.19,175
19636,Agnes,1,Entire home/apt,100,11,0.54,111
19637,Hyggens,2,Entire home/apt,100,298,0.44,398
19638,Claire,2,Private room,49,0,0.53,49
19639,Frank W,2,Entire home/apt,116,314,6.55,430
19640,Nissim,1,Entire home/apt,265,0,0.06,265
19641,Fatima,1,Private room,333,62,1.27,395
19642,Linnette,1,Private room,100,188,0.66,288
19644,Jeremy & Laura,1,Entire home/apt,155,309,0.03,464
19645,Megan,2,Private room,65,35,0.39,100
19647,Simone,1,Private room,125,110,2.03,235
19648,Naveen,2,Private room,70,188,0.38,258
19649,The Wrights,2,Private room,59,40,6.01,99
19650,Suri,2,Private room,89,281,0.1,370
19651,The Wrights,2,Private room,59,57,5.26,116
19652,Priscilla,1,Entire home/apt,150,0,0.08,150
19653,Wynpoints,1,Private room,369,365,0.25,734
19654,Kat,2,Private room,55,0,0.03,55
19656,Sophia And Shannon,2,Private room,45,0,0.13,45
19657,Alphanso,3,Private room,55,349,0.13,404
19658,Alphanso,3,Private room,55,355,0.37,410
19659,Seyhan,1,Entire home/apt,196,268,0.2,464
19660,Brett,2,Private room,69,36,2.93,105
19661,Victoria,1,Private room,65,46,1.5,111
19662,Severine,1,Private room,100,66,0.5,166
19663,Nathan,1,Private room,92,152,4.29,244
19664,Anna,2,Entire home/apt,365,112,2.44,477
19665,Liz,2,Entire home/apt,136,0,0.3,136
19666,Roman,1,Entire home/apt,300,16,0.53,316
19667,Tim,2,Entire home/apt,175,18,0.2,193
19668,Francisca,4,Private room,80,365,2.37,445
19669,Jose,2,Entire home/apt,90,210,0.05,300
19670,Sophia,2,Entire home/apt,150,220,0.41,370
19671,Moustafa,1,Private room,119,365,3.61,484
19674,Teddie,2,Entire home/apt,450,60,0.49,510
19675,Alvaro,2,Entire home/apt,200,0,0.03,200
19676,Kim & Rupert,2,Entire home/apt,99,0,2.98,99
19677,Alexandra,1,Entire home/apt,270,0,0.1,270
19678,Jeremy & Laura,1,Entire home/apt,190,331,0.13,521
19679,Ken,1,Entire home/apt,205,365,0.05,570
19680,Coco,2,Private room,39,192,1.21,231
19681,Jay,1,Entire home/apt,499,280,2.13,779
19682,Kara,1,Entire home/apt,275,365,0.08,640
19683,Belinda,2,Private room,80,34,0.9,114
19684,Phenix,1,Entire home/apt,1500,365,0.12,1865
19685,Craig,2,Private room,105,62,4.52,167
19687,Matthew,2,Entire home/apt,150,0,0.36,150
19688,D M,2,Private room,70,35,3.71,105
19689,Harry,1,Entire home/apt,150,0,0.03,150
19690,Will & Kim,2,Entire home/apt,146,79,3.11,225
19691,Dorothy,1,Private room,99,92,2.79,191
19692,Misha,2,Entire home/apt,125,0,0.03,125
19693,Elizabeth,2,Private room,125,310,2.78,435
19694,Timothy,2,Entire home/apt,182,254,2.82,436
19695,Gabriela,2,Private room,55,311,0.52,366
19696,Thomas,2,Entire home/apt,255,33,0.52,288
19697,Laura,1,Entire home/apt,160,281,0.54,441
19698,Laura,1,Entire home/apt,160,345,0.52,505
19699,Lindsay,1,Private room,75,0,0.06,75
19700,Catherine,2,Entire home/apt,125,55,0.23,180
19702,Juan Carlos,2,Private room,80,350,1.0,430
19703,Karline,1,Entire home/apt,125,88,1.82,213
19704,Gabriela,2,Private room,54,0,5.09,54
19705,Luke,2,Entire home/apt,170,1,4.6,171
19706,Alexandra,3,Entire home/apt,115,3,4.43,118
19707,Eric,2,Private room,65,0,0.22,65
19708,Isabel,1,Private room,50,0,0.03,50
19710,Ken,1,Entire home/apt,229,364,0.12,593
19712,Edna + Isaiah,2,Entire home/apt,139,257,6.64,396
19713,Marie,2,Private room,300,80,0.26,380
19714,Iwona,2,Entire home/apt,85,0,0.16,85
19715,Jared,3,Private room,139,365,0.12,504
19716,Maureen,2,Entire home/apt,83,311,0.22,394
19718,Gabriela,2,Private room,49,0,4.72,49
19719,Pierre,1,Entire home/apt,120,40,1.75,160
19720,The Wrights,2,Private room,79,21,5.14,100
19721,Agnes,3,Private room,60,96,0.28,156
19722,Chris,1,Private room,175,180,0.19,355
19723,Rodney,1,Private room,75,157,0.05,232
19724,Mike,3,Private room,50,0,0.4,50
19725,Nathan,1,Private room,80,42,3.51,122
19726,Ji,1,Private room,110,87,0.03,197
19728,Christopher,1,Private room,67,7,0.49,74
19729,Michella,5,Entire home/apt,70,291,2.56,361
19730,Luz Dary,3,Private room,70,0,1.61,70
19731,Jen And Lev,2,Entire home/apt,153,277,2.07,430
19732,Joanna,2,Entire home/apt,350,21,0.69,371
19734,Cesar,2,Entire home/apt,90,50,0.07,140
19735,Guisela,1,Entire home/apt,178,0,0.71,178
19737,Kara,1,Entire home/apt,369,345,0.06,714
19738,Yuxi,3,Private room,40,0,0.23,40
19739,Masoud,2,Entire home/apt,160,270,3.9,430
19743,Ryan,2,Private room,99,364,0.16,463
19745,Maria,3,Private room,45,266,0.68,311
19746,J,2,Shared room,28,118,4.56,146
19747,Sara,1,Entire home/apt,159,351,1.31,510
19748,Kylie,2,Entire home/apt,250,70,1.32,320
19749,Rachel,1,Private room,85,6,1.2,91
19750,Ha,1,Entire home/apt,160,229,2.38,389
19752,Chérie,2,Private room,49,53,2.42,102
19753,Mark & Will,1,Private room,69,125,4.74,194
19754,Austin,2,Entire home/apt,200,15,2.0,215
19755,Lynn,2,Private room,62,0,0.19,62
19756,Haley,1,Entire home/apt,400,364,0.54,764
19757,Jamie,2,Private room,80,0,2.15,80
19758,Matthew,3,Entire home/apt,105,1,0.12,106
19759,Maura,2,Entire home/apt,87,0,0.3,87
19760,Dorion,2,Entire home/apt,99,46,3.93,145
19762,Guillermo,2,Entire home/apt,109,212,3.31,321
19763,Tiffany,1,Private room,75,0,0.26,75
19764,Michelle,1,Entire home/apt,175,88,0.6,263
19765,Robert,1,Entire home/apt,289,0,0.13,289
19766,Caroline & Georg,2,Entire home/apt,209,11,0.72,220
19767,Tim,2,Entire home/apt,75,322,2.61,397
19768,Susy,2,Private room,35,349,3.26,384
19769,Corporate Housing,1,Entire home/apt,117,311,0.75,428
19770,Giedre & Andre,2,Entire home/apt,80,7,6.54,87
19771,Courtney,1,Entire home/apt,250,52,0.35,302
19772,Golden&Mavy,1,Private room,50,365,0.14,415
19773,Nathan,2,Private room,70,19,0.6,89
19774,Silvana,2,Entire home/apt,150,0,0.59,150
19775,Nina,1,Entire home/apt,145,0,0.06,145
19776,Calixto,1,Entire home/apt,221,0,0.13,221
19777,Sira,2,Entire home/apt,142,80,3.8,222
19778,Edward,5,Entire home/apt,65,40,1.95,105
19779,Allison,3,Entire home/apt,110,191,2.13,301
19780,Amanda,1,Private room,80,7,0.31,87
19781,Susy,2,Private room,35,325,1.41,360
19782,Yolanda,1,Entire home/apt,150,5,1.13,155
19784,Ducrot,2,Entire home/apt,150,102,0.6,252
19785,Vadzim,2,Private room,47,0,0.26,47
19786,Kevin,3,Entire home/apt,85,0,2.13,85
19787,Tanya,2,Entire home/apt,100,77,2.78,177
19788,Oscar,3,Private room,40,59,1.37,99
19789,Daisy,2,Entire home/apt,85,0,0.03,85
19790,Tashi,3,Entire home/apt,99,1,5.3,100
19791,Rony,4,Entire home/apt,105,278,1.68,383
19792,Peter,2,Private room,33,277,3.69,310
19793,Maria,2,Private room,50,293,2.35,343
19794,Kevin,1,Entire home/apt,295,0,0.49,295
19795,Pauline,2,Private room,72,215,4.79,287
19796,Davis & Coco,1,Entire home/apt,300,36,1.79,336
19797,Audrey,2,Private room,48,304,0.78,352
19798,Hebert,3,Private room,55,0,2.91,55
19799,Shani & Emily,2,Private room,100,0,2.95,100
19800,Aubrey,2,Entire home/apt,180,18,0.16,198
19801,Paula,2,Entire home/apt,300,180,1.11,480
19802,Alyssa,1,Entire home/apt,2000,364,0.38,2364
19803,Alyssa,1,Entire home/apt,1020,365,0.39,1385
19804,Baron,2,Private room,53,188,1.9,241
19805,Ben,2,Entire home/apt,160,290,0.04,450
19806,Francis,1,Private room,143,365,0.26,508
19807,Jacob,1,Private room,164,209,4.74,373
19808,Jacob,1,Private room,164,221,4.82,385
19809,Jenima,2,Private room,48,20,2.38,68
19811,Kary,1,Private room,70,203,6.45,273
19812,Gail,3,Entire home/apt,159,299,0.97,458
19813,Helena,2,Private room,89,0,0.8,89
19814,AGood,3,Entire home/apt,100,8,4.12,108
19815,Yoko,1,Private room,60,0,0.88,60
19816,Segun,2,Private room,42,364,0.41,406
19817,Diana,2,Private room,57,307,0.66,364
19818,Hannah,2,Private room,43,0,0.03,43
19819,Dorothy,1,Private room,99,88,2.51,187
19820,Eugenie,2,Private room,105,0,1.21,105
19822,Anthony,1,Private room,65,179,0.1,244
19823,Jeniffer,1,Entire home/apt,125,323,0.19,448
19824,Chris,1,Entire home/apt,265,16,0.52,281
19825,Caroline,1,Private room,100,0,0.03,100
19826,William,2,Private room,38,0,0.03,38
19827,Anabelle,3,Private room,88,0,0.22,88
19828,Luis,1,Private room,60,98,1.31,158
19829,Alex,2,Entire home/apt,159,0,0.99,159
19830,V.Stephan,1,Private room,65,0,1.31,65
19831,Elena,2,Private room,700,87,0.03,787
19832,Rylee,1,Entire home/apt,150,0,0.03,150
19833,Patrick,2,Private room,50,0,0.12,50
19834,Bianca,2,Private room,70,0,0.03,70
19835,Theo,2,Private room,225,0,0.13,225
19836,Nora,1,Private room,61,20,0.79,81
19837,Shannon,3,Private room,120,352,1.03,472
19839,Ale,2,Entire home/apt,63,344,1.71,407
19840,Jed,2,Private room,65,179,2.26,244
19841,Tong,2,Shared room,25,0,2.02,25
19842,Alan,3,Entire home/apt,143,7,0.22,150
19843,Forrest,1,Entire home/apt,197,13,1.46,210
19844,Aline,2,Private room,89,173,2.7,262
19845,Martha,2,Entire home/apt,158,264,1.92,422
19846,Risa,1,Entire home/apt,125,0,0.38,125
19847,Emanuele,1,Entire home/apt,250,0,0.22,250
19848,Nora,1,Private room,119,207,3.65,326
19849,Lina,1,Private room,128,171,2.21,299
19850,Ed,2,Entire home/apt,169,64,1.4,233
19851,Arthur,1,Private room,115,137,1.94,252
19852,Julian,3,Private room,70,172,1.5,242
19853,Grand,1,Private room,115,88,0.08,203
19854,Andrea,1,Private room,100,0,0.19,100
19855,Josh,2,Private room,50,262,2.83,312
19856,Siobhan,1,Entire home/apt,200,0,0.09,200
19857,Ro,1,Entire home/apt,220,0,0.27,220
19858,Daniel,1,Private room,45,0,0.94,45
19859,Ny,1,Entire home/apt,203,0,0.42,203
19860,Vanessa,1,Entire home/apt,180,87,3.01,267
19861,Max,4,Private room,40,0,0.03,40
19863,Aryanna,2,Entire home/apt,130,81,3.47,211
19864,Akshay,1,Entire home/apt,190,0,0.16,190
19865,Alexa,2,Private room,58,0,0.2,58
19866,Lidia,2,Entire home/apt,150,0,0.05,150
19868,Michael,1,Entire home/apt,180,0,1.48,180
19869,Jennifer,2,Entire home/apt,250,2,1.68,252
19870,Aurora And John,2,Entire home/apt,150,0,0.46,150
19871,Corporate Housing,1,Entire home/apt,125,342,0.38,467
19872,Jessy,2,Private room,49,37,0.32,86
19873,Dylana,2,Private room,40,78,2.99,118
19874,Sophie,3,Private room,40,162,2.82,202
19875,Charles,1,Entire home/apt,130,39,1.02,169
19876,Kevin,2,Private room,900,83,0.09,983
19877,Alex,1,Private room,85,44,1.51,129
19878,Nidhi,1,Private room,110,0,0.25,110
19879,Jay,1,Private room,119,76,0.25,195
19880,Wendy,1,Private room,60,97,0.73,157
19881,Sarah,1,Entire home/apt,110,0,0.82,110
19883,Kerry,2,Private room,50,107,2.44,157
19884,Regina,2,Entire home/apt,110,0,1.52,110
19885,Hector,1,Entire home/apt,180,259,4.55,439
19886,Rachel,3,Private room,75,197,0.27,272
19887,Asaf,3,Entire home/apt,105,335,0.39,440
19888,David,3,Entire home/apt,105,352,0.69,457
19889,Mike,1,Entire home/apt,300,179,0.6,479
19890,Marc,2,Private room,60,7,2.35,67
19891,Dominique,3,Entire home/apt,100,201,2.74,301
19892,Dr. Shirin,3,Private room,120,361,2.39,481
19894,Pamela,2,Private room,45,361,1.47,406
19895,Ali Nicole,1,Entire home/apt,255,5,2.04,260
19896,Pamela,2,Private room,40,352,1.34,392
19898,Amy,1,Entire home/apt,240,211,0.48,451
19899,Jon,5,Entire home/apt,100,36,0.06,136
19900,Cg,2,Entire home/apt,110,248,2.76,358
19901,Helen And Alfred,2,Entire home/apt,185,262,3.28,447
19902,Melanie,1,Entire home/apt,147,4,1.32,151
19903,Rachel,2,Private room,65,0,0.12,65
19904,Tiffanie,1,Entire home/apt,200,11,0.81,211
19905,Ami,2,Entire home/apt,950,323,0.62,1273
19907,William,2,Private room,200,83,0.36,283
19908,Eugene,1,Entire home/apt,100,0,0.1,100
19910,Yukiko,3,Private room,45,52,1.13,97
19911,Kaka,3,Private room,75,0,3.78,75
19913,Lucy,2,Private room,40,318,0.22,358
19914,Tn,3,Entire home/apt,74,0,0.89,74
19915,Nayamkah,2,Entire home/apt,100,0,0.16,100
19916,Jamin,2,Entire home/apt,95,131,2.39,226
19917,Roger,3,Private room,59,73,0.83,132
19918,Ayo,2,Entire home/apt,180,237,2.35,417
19920,Chaehyun,1,Entire home/apt,160,0,0.28,160
19921,Jehanne,2,Entire home/apt,139,0,0.07,139
19922,Tong,2,Shared room,19,120,2.4,139
19923,Adriana,1,Entire home/apt,375,335,0.73,710
19924,Gee,1,Entire home/apt,135,0,1.4,135
19926,Kyle,2,Entire home/apt,169,84,2.54,253
19928,Jaimie,1,Entire home/apt,200,0,0.07,200
19929,Tessa,2,Entire home/apt,115,0,0.1,115
19930,Rebecca,2,Entire home/apt,45,0,0.03,45
19931,Rex,1,Entire home/apt,400,26,0.38,426
19932,Dr. Shirin,3,Private room,65,365,1.48,430
19933,Tong,2,Private room,39,0,0.07,39
19934,El Haj,1,Private room,80,339,0.28,419
19935,Siobhan,1,Private room,85,14,3.07,99
19936,Kylia,1,Private room,150,0,0.97,150
19938,Bianca,3,Private room,120,351,0.05,471
19939,Abeer,3,Entire home/apt,100,157,0.13,257
19940,Kristin,1,Private room,75,62,0.88,137
19941,Max,2,Private room,91,85,0.55,176
19942,Jochen,1,Private room,150,0,0.07,150
19943,Freddi,2,Private room,46,0,0.91,46
19944,Madeline,2,Private room,65,12,0.93,77
19945,Shani,1,Entire home/apt,500,362,0.16,862
19946,Cristina And Sasha,2,Private room,45,201,4.93,246
19948,Nicole & Omari,2,Entire home/apt,155,59,3.96,214
19949,David,2,Entire home/apt,149,0,0.26,149
19950,Ashley,2,Private room,60,0,0.16,60
19951,Kara,1,Private room,42,53,0.1,95
19952,ResortShare5,1,Private room,198,329,0.75,527
19953,Luca And Kameko,1,Private room,45,164,0.25,209
19954,Linda,2,Entire home/apt,130,13,0.1,143
19955,Kim,2,Private room,44,45,1.24,89
19956,Ira,1,Entire home/apt,250,4,0.19,254
19957,Luca And Kameko,1,Private room,50,151,0.16,201
19958,Nilu,2,Entire home/apt,195,62,1.25,257
19959,Luca And Kameko,1,Private room,45,175,0.23,220
19960,Jane,2,Private room,37,0,0.13,37
19961,Umut&Deniz,1,Private room,78,341,1.45,419
19962,Brittany & Matt,1,Entire home/apt,80,0,0.13,80
19964,Umut&Deniz,1,Private room,78,365,0.23,443
19965,Massimo,1,Private room,35,0,0.12,35
19968,Ariana,2,Private room,33,0,0.03,33
19969,Sebastien,1,Entire home/apt,129,0,0.03,129
19970,Marina,5,Private room,49,0,0.53,49
19971,Dali,1,Private room,103,0,0.06,103
19972,Samuel,1,Entire home/apt,150,194,3.33,344
19973,Angelica,2,Private room,41,0,0.28,41
19974,Fayth,1,Private room,76,0,0.13,76
19975,Kathryn,2,Entire home/apt,120,298,0.31,418
19976,Tingting,1,Entire home/apt,167,0,0.09,167
19977,Matt,3,Entire home/apt,95,0,0.63,95
19978,Cristina And Sasha,2,Private room,35,169,4.63,204
19979,C.D.,1,Shared room,99,365,0.26,464
19980,George,1,Entire home/apt,150,63,2.57,213
19981,Juan,1,Private room,65,0,0.34,65
19982,Erin & Marla,2,Entire home/apt,150,0,0.09,150
19983,Eva,3,Entire home/apt,76,0,0.29,76
19984,ResortShare5,1,Entire home/apt,198,322,1.19,520
19986,Alex,3,Entire home/apt,110,0,0.19,110
19990,Claudia,1,Entire home/apt,265,3,0.45,268
19991,Quentin,1,Entire home/apt,110,0,0.06,110
19992,Susan,2,Private room,70,53,3.59,123
19993,Antonio,2,Entire home/apt,220,0,0.03,220
19994,Lina,2,Entire home/apt,80,0,0.24,80
19995,Esther,1,Private room,55,4,0.37,59
19996,Scott,1,Entire home/apt,115,35,0.12,150
19997,Elisia,1,Entire home/apt,265,297,3.55,562
19998,Pablo,1,Entire home/apt,228,103,0.51,331
19999,Ignacio,2,Private room,50,0,0.06,50
20000,Devin T.,1,Entire home/apt,280,12,2.29,292
20001,M,3,Private room,75,7,0.28,82
20002,Tony,2,Entire home/apt,120,0,0.16,120
20003,Marina,1,Entire home/apt,250,0,0.07,250
20005,Monica,3,Private room,70,0,0.16,70
20006,Chuck,1,Entire home/apt,135,86,3.58,221
20007,CZ Casa,1,Private room,110,158,5.87,268
20008,Nick,2,Entire home/apt,149,329,3.75,478
20009,Nathaniel,2,Shared room,22,160,1.28,182
20010,Suzie And Ryan,2,Private room,49,90,0.59,139
20011,Chayla,1,Private room,899,365,0.06,1264
20012,Paloma,1,Private room,40,0,0.22,40
20013,Sonia,2,Entire home/apt,70,40,1.94,110
20014,Chana,2,Entire home/apt,340,63,0.4,403
20015,Cristina,2,Entire home/apt,75,93,0.7,168
20017,Manny Lucas,1,Private room,90,0,0.19,90
20019,Samuel,2,Private room,49,35,2.74,84
20020,Anna,3,Private room,95,118,1.96,213
20021,Travis,1,Entire home/apt,155,0,0.28,155
20022,James,2,Shared room,40,0,0.53,40
20023,Montana,2,Private room,47,4,0.74,51
20025,Azure,1,Entire home/apt,700,302,1.27,1002
20026,Jasmine,1,Private room,109,0,0.18,109
20027,ResortShare5,1,Entire home/apt,198,246,0.88,444
20028,Kevin,1,Entire home/apt,149,0,0.25,149
20029,Jd,3,Entire home/apt,101,0,0.28,101
20030,Amanda,1,Entire home/apt,150,0,0.03,150
20031,Michael,1,Entire home/apt,135,0,0.1,135
20033,Phillip,1,Private room,80,0,0.6,80
20034,Maayan,2,Entire home/apt,84,155,2.88,239
20035,Nepreil,3,Entire home/apt,99,365,1.71,464
20036,Oliver,1,Private room,100,0,0.09,100
20037,Tamara,2,Shared room,50,364,0.74,414
20038,Raymond,1,Entire home/apt,175,160,0.14,335
20039,Louise,2,Private room,60,0,0.03,60
20040,Sara,2,Entire home/apt,170,64,0.06,234
20041,Mark,2,Entire home/apt,170,37,6.9,207
20042,Eric,2,Entire home/apt,75,0,0.09,75
20044,Matthew,1,Entire home/apt,130,0,0.1,130
20045,Rafael,1,Private room,88,0,0.1,88
20046,Ridhima,1,Private room,110,0,0.5,110
20047,Ray,1,Private room,200,90,0.09,290
20049,Bradley And Ana,1,Entire home/apt,100,12,1.28,112
20050,Susan,1,Entire home/apt,190,27,0.73,217
20051,Olenka,3,Entire home/apt,86,149,2.55,235
20052,Marc,2,Private room,75,0,0.11,75
20054,Ashfia & Amir,2,Entire home/apt,145,0,0.13,145
20055,Evguenia,4,Private room,75,365,0.32,440
20056,Nikki,2,Private room,200,189,0.09,389
20057,Ariel,2,Entire home/apt,86,0,0.06,86
20058,Kennedy,1,Entire home/apt,160,273,1.56,433
20059,Martial Loft,2,Private room,59,0,0.46,59
20060,Michelle,1,Entire home/apt,280,0,0.03,280
20061,Natasha,1,Entire home/apt,89,4,0.57,93
20063,Kristine,2,Entire home/apt,100,6,0.29,106
20064,Jessica,2,Entire home/apt,75,0,0.16,75
20065,Marina,2,Entire home/apt,100,0,0.03,100
20066,Rob,1,Private room,95,0,0.03,95
20067,Felipe,2,Private room,50,249,0.31,299
20068,Jason,1,Entire home/apt,599,54,0.33,653
20069,Juan Pablo & Andrea,3,Private room,44,3,0.27,47
20070,David,1,Private room,80,79,0.1,159
20071,Chelsea,1,Private room,65,0,0.26,65
20072,Tor,2,Entire home/apt,98,168,0.96,266
20073,Marni,1,Entire home/apt,131,11,0.49,142
20075,Ercio,2,Private room,70,0,0.61,70
20076,Steve,2,Private room,35,0,0.07,35
20077,Richard,2,Entire home/apt,200,310,0.17,510
20078,Amarjit S,5,Private room,34,316,1.69,350
20079,Brent,3,Entire home/apt,100,167,1.57,267
20080,Cecily,2,Private room,85,90,1.15,175
20081,Elijah,1,Entire home/apt,120,0,0.28,120
20082,Kris,3,Private room,37,363,0.33,400
20083,Nicole,2,Private room,34,70,3.14,104
20084,Corporate Housing,1,Entire home/apt,175,126,0.04,301
20085,Pilar,2,Entire home/apt,150,0,0.41,150
20086,Niki,3,Private room,48,113,1.72,161
20087,Jerry,2,Private room,73,121,0.36,194
20088,Larissa,1,Private room,85,0,0.51,85
20089,Jerry,2,Private room,69,292,1.14,361
20090,Ariana,1,Entire home/apt,170,36,1.14,206
20091,Jerry,2,Private room,66,324,0.8,390
20092,Louise,1,Entire home/apt,200,0,0.03,200
20093,Chayla,1,Private room,799,365,0.03,1164
20094,Chayla,1,Private room,1599,365,0.08,1964
20095,Amarjit S,5,Private room,34,347,1.39,381
20097,Kate,1,Private room,69,217,1.5,286
20098,Ebone,2,Entire home/apt,73,0,0.16,73
20100,Naama,1,Entire home/apt,150,25,0.1,175
20101,Amardeep,5,Private room,33,322,0.83,355
20102,Amardeep,5,Private room,32,342,1.2,374
20103,Amardeep,5,Private room,35,323,0.34,358
20104,Chayla,1,Private room,649,365,0.03,1014
20105,Amardeep,5,Private room,32,312,0.87,344
20106,Maiko,3,Private room,85,306,1.86,391
20107,Chayla,1,Private room,699,365,0.03,1064
20108,Chayla,1,Private room,799,365,0.03,1164
20109,Bea,2,Entire home/apt,290,0,0.1,290
20110,Greg And Amy,2,Entire home/apt,145,5,1.36,150
20111,Roxana,1,Entire home/apt,199,0,1.67,199
20112,Francisco,1,Entire home/apt,200,291,1.31,491
20113,Alex,1,Entire home/apt,181,173,5.08,354
20114,Paloma,2,Private room,75,0,0.05,75
20115,Anna,2,Entire home/apt,130,0,0.03,130
20116,Celeste,3,Entire home/apt,125,157,0.52,282
20118,Alex,1,Entire home/apt,250,0,0.33,250
20119,Sohel,1,Entire home/apt,175,66,0.29,241
20120,Dawn,2,Private room,59,342,0.27,401
20121,Andrea,2,Entire home/apt,180,1,2.02,181
20123,Joyce,2,Shared room,40,3,0.13,43
20124,Ash,1,Entire home/apt,156,0,0.13,156
20125,Betsy,1,Entire home/apt,500,91,0.13,591
20126,Sharon,1,Private room,65,5,5.54,70
20127,Michael,1,Entire home/apt,68,338,0.25,406
20128,Paolo,1,Private room,60,0,0.04,60
20129,Sebastian,1,Entire home/apt,150,127,0.3,277
20130,Zoe,2,Entire home/apt,265,281,1.2,546
20131,Andres,1,Entire home/apt,279,0,0.1,279
20132,Elias,5,Private room,105,89,0.39,194
20133,Nicole,1,Entire home/apt,110,47,1.92,157
20134,Georgia & Robin,2,Entire home/apt,130,0,0.33,130
20135,Christina,1,Entire home/apt,500,0,0.03,500
20136,Faye,5,Private room,34,159,0.78,193
20137,Meghan,2,Private room,75,0,1.95,75
20138,Anima,1,Private room,49,0,0.04,49
20139,Joseph,2,Private room,65,89,0.7,154
20140,Tj,2,Private room,65,40,0.26,105
20141,Ramsay,2,Entire home/apt,300,352,0.09,652
20142,Elena,1,Private room,100,14,1.21,114
20143,Sehai,2,Private room,55,6,0.03,61
20144,Ronald,2,Private room,70,29,0.87,99
20145,Cyril,2,Private room,49,0,0.53,49
20146,Hannah,2,Private room,50,79,0.36,129
20147,Ben,2,Entire home/apt,158,37,0.26,195
20149,Danielle,2,Private room,120,0,0.03,120
20150,Tk,1,Private room,44,18,1.43,62
20151,Roy,2,Entire home/apt,150,80,0.62,230
20152,Laurent,2,Entire home/apt,209,201,0.23,410
20153,Chi,1,Entire home/apt,200,36,0.06,236
20154,Amara,2,Private room,30,0,0.03,30
20155,Mattie,1,Private room,80,8,0.32,88
20156,Lynne,3,Private room,135,0,0.03,135
20157,Travis & Melissa,2,Entire home/apt,250,0,1.72,250
20158,Jay R.,1,Private room,100,66,0.18,166
20159,Cesar & Nadia,2,Private room,50,0,0.95,50
20160,Phoebe,1,Private room,110,102,4.37,212
20161,Sophie,3,Private room,30,142,3.36,172
20162,Chris,2,Entire home/apt,160,0,0.35,160
20163,Adrianne,1,Entire home/apt,295,16,1.4,311
20164,Chayla,1,Private room,699,365,0.06,1064
20165,Sasha,2,Private room,60,0,0.23,60
20166,Belkis,4,Private room,45,318,0.98,363
20167,Eric,2,Private room,29,145,3.07,174
20168,Aleksandra,1,Private room,80,31,0.6,111
20169,Saygin,1,Entire home/apt,265,155,3.53,420
20170,Jeffrey,1,Entire home/apt,225,0,0.38,225
20171,Brendan,1,Entire home/apt,210,0,0.13,210
20172,Bobbi,1,Entire home/apt,220,92,1.81,312
20173,Yesenia,4,Private room,68,39,0.07,107
20174,Camilla,2,Entire home/apt,135,0,0.2,135
20175,Jeffrey,1,Entire home/apt,130,21,4.21,151
20179,Maxime,1,Entire home/apt,400,180,0.1,580
20180,Stephen,2,Entire home/apt,200,230,2.3,430
20181,Margareth,2,Entire home/apt,76,310,0.27,386
20182,Yossi,2,Entire home/apt,200,0,0.29,200
20183,Daria,2,Shared room,25,332,0.32,357
20185,Chayla,1,Private room,799,365,0.03,1164
20186,Irem,2,Private room,45,0,1.01,45
20188,Julia,1,Private room,176,17,3.9,193
20189,Carmen,2,Private room,85,19,0.23,104
20190,Debbie,2,Private room,21,0,0.15,21
20191,Josephine,2,Entire home/apt,129,82,2.34,211
20194,Julia,1,Private room,113,12,4.21,125
20195,Russell,2,Entire home/apt,199,0,0.03,199
20196,David & Elaine,4,Entire home/apt,86,171,2.76,257
20197,Fayth,3,Entire home/apt,95,212,0.29,307
20198,Joe,1,Private room,100,0,0.46,100
20199,Maria,1,Entire home/apt,199,0,0.1,199
20200,Julia,1,Private room,146,7,3.31,153
20201,Paul,2,Entire home/apt,150,228,2.33,378
20202,Laura,1,Private room,98,46,2.42,144
20203,Catherine,2,Entire home/apt,25,6,1.65,31
20204,Kristin,2,Entire home/apt,130,83,1.76,213
20205,Ryan,1,Entire home/apt,200,0,0.1,200
20206,Irisha,3,Entire home/apt,94,173,0.6,267
20207,Kumara,1,Entire home/apt,150,0,0.26,150
20208,Sebastian,2,Private room,85,8,0.13,93
20209,Mac,2,Private room,110,39,2.51,149
20210,Liad,1,Entire home/apt,60,86,3.94,146
20211,David,1,Private room,48,342,0.26,390
20212,Jian,1,Private room,110,0,0.03,110
20213,Alana,2,Private room,60,90,1.18,150
20214,Peter,2,Entire home/apt,72,1,3.13,73
20215,Jeremy,1,Entire home/apt,120,0,0.71,120
20216,Mark & Will,1,Private room,58,115,4.17,173
20217,Mary,1,Entire home/apt,150,0,0.08,150
20218,Joseph,3,Private room,40,0,0.64,40
20219,Claire,1,Entire home/apt,1200,354,1.64,1554
20220,Inna,1,Entire home/apt,89,261,0.4,350
20221,Charles-Hugo,2,Private room,55,0,0.1,55
20222,Courtney,3,Entire home/apt,150,0,0.07,150
20223,Tim,2,Private room,99,353,7.28,452
20224,Emmy,3,Private room,38,0,2.19,38
20225,Nina,1,Entire home/apt,500,365,0.73,865
20226,Corporate Housing,1,Entire home/apt,142,342,0.3,484
20227,Geo,1,Private room,114,324,1.28,438
20228,Andrew,2,Entire home/apt,175,313,0.81,488
20229,William,1,Entire home/apt,350,0,0.16,350
20230,Madi,1,Private room,60,0,0.03,60
20233,Benny,1,Private room,100,0,0.13,100
20234,Annie,2,Private room,60,0,0.72,60
20236,Brecht,1,Private room,85,9,0.51,94
20237,Azu,2,Private room,36,0,0.26,36
20238,Rod,1,Private room,150,272,1.79,422
20239,Fernando,1,Entire home/apt,330,317,3.94,647
20240,Jason,2,Private room,54,241,0.61,295
20242,Jason,2,Private room,53,360,0.63,413
20243,Avi,2,Entire home/apt,175,3,1.43,178
20244,Jason,2,Private room,48,240,0.71,288
20245,Jason,2,Private room,39,137,0.82,176
20246,Kevin,3,Private room,70,302,0.26,372
20247,Johari,2,Private room,29,51,0.42,80
20248,Rebecca,1,Entire home/apt,120,0,0.13,120
20249,Kim,3,Entire home/apt,125,348,1.85,473
20250,Tysun,1,Entire home/apt,100,80,2.1,180
20251,Ciprian,4,Private room,79,69,2.79,148
20252,Kristian & Di,2,Private room,70,275,0.15,345
20253,Miralva,2,Private room,95,0,0.46,95
20254,Kv,2,Entire home/apt,77,5,3.1,82
20255,Sandra,2,Private room,75,0,0.1,75
20257,Kirra,1,Private room,80,105,5.01,185
20258,Guy,3,Entire home/apt,120,135,2.55,255
20259,Sam,2,Entire home/apt,175,68,2.35,243
20261,James,2,Private room,114,0,0.09,114
20262,Andrea,2,Private room,93,34,1.11,127
20264,Kory,1,Entire home/apt,199,150,0.57,349
20267,Camille,2,Private room,58,0,0.03,58
20268,Evelyne,2,Entire home/apt,185,59,0.07,244
20269,Louise,1,Private room,90,0,0.22,90
20270,Maria,3,Private room,50,0,0.16,50
20271,Samer,1,Entire home/apt,189,0,0.03,189
20272,Thomas,2,Private room,50,0,0.17,50
20273,Sarah,1,Entire home/apt,240,7,0.17,247
20274,Jenima,2,Entire home/apt,131,0,0.73,131
20275,Marie,2,Private room,80,0,0.03,80
20276,Tracey,1,Entire home/apt,225,11,0.52,236
20277,CRNY Monthly Rentals,1,Entire home/apt,139,134,0.07,273
20278,Jared,3,Private room,109,356,0.17,465
20279,David,3,Entire home/apt,165,55,1.03,220
20280,Yandong,1,Private room,45,0,0.03,45
20281,Amy,2,Private room,50,5,1.14,55
20282,Allan,1,Entire home/apt,90,154,0.16,244
20283,Faye,5,Private room,55,88,0.22,143
20284,Siria,2,Entire home/apt,130,0,0.03,130
20286,Randi,2,Entire home/apt,150,3,1.11,153
20287,Ella,1,Private room,75,183,1.44,258
20288,Mei,3,Private room,30,142,0.99,172
20289,Benjamin,2,Entire home/apt,150,0,5.69,150
20290,Courtney,3,Private room,75,61,1.59,136
20292,Pablo,1,Entire home/apt,110,0,0.05,110
20293,Ignat,2,Private room,64,42,2.82,106
20294,Anthony,2,Entire home/apt,135,82,0.93,217
20295,Adam,2,Private room,55,0,0.26,55
20296,Daniel,2,Entire home/apt,165,0,0.12,165
20297,Geo,1,Private room,132,326,0.51,458
20300,Alec,2,Private room,169,364,1.09,533
20303,Roanne,1,Private room,77,90,0.98,167
20304,Alessandra,1,Entire home/apt,200,317,0.95,517
20305,Justin,2,Private room,85,69,2.22,154
20306,Jay,1,Entire home/apt,400,334,1.16,734
20307,Taha,1,Entire home/apt,200,206,8.18,406
20309,Julia,1,Private room,80,11,3.48,91
20311,Martina,2,Entire home/apt,108,0,0.1,108
20312,Rachel & Preston,1,Private room,75,0,0.1,75
20313,Kelcey,1,Entire home/apt,91,0,0.06,91
20314,Ilya,5,Entire home/apt,51,15,0.97,66
20315,Claudette,3,Private room,60,341,9.83,401
20316,Ming,1,Entire home/apt,120,188,0.03,308
20317,Joseph,2,Entire home/apt,110,0,0.03,110
20318,Dave,2,Entire home/apt,149,0,0.29,149
20319,Nicole,1,Entire home/apt,160,0,0.03,160
20320,Franny & Zooey,2,Entire home/apt,90,0,0.07,90
20321,Chelsea,2,Entire home/apt,250,72,2.15,322
20322,Olive,1,Entire home/apt,74,0,0.03,74
20323,Joshua,2,Entire home/apt,230,0,0.06,230
20324,Josh,2,Private room,90,0,0.09,90
20325,Kirsten,2,Entire home/apt,200,0,0.2,200
20326,Rachel,2,Private room,49,0,0.1,49
20329,Aude,2,Private room,47,12,0.07,59
20331,Carolina,3,Private room,250,1,0.51,251
20332,Romina,1,Entire home/apt,250,0,0.04,250
20333,Dania,2,Entire home/apt,360,0,0.06,360
20334,Olivia,1,Entire home/apt,200,352,1.12,552
20335,Jamie,2,Private room,50,0,0.04,50
20336,Huilin,3,Entire home/apt,85,56,3.15,141
20337,Melanie,2,Private room,40,0,0.08,40
20338,Felipe,1,Private room,85,12,0.65,97
20339,Ken,2,Private room,85,10,0.22,95
20340,Coco,3,Entire home/apt,239,266,0.55,505
20341,Peggy,2,Entire home/apt,700,89,0.24,789
20342,Harry,2,Private room,60,62,0.2,122
20343,Ana,3,Private room,87,343,0.1,430
20344,Mor,2,Private room,50,2,0.16,52
20345,Delphine,2,Private room,85,0,0.13,85
20346,Esther,2,Private room,80,5,0.39,85
20347,Kytzia,1,Private room,90,0,1.04,90
20348,Anna,3,Private room,69,156,0.81,225
20349,Ali And Amy,1,Entire home/apt,128,0,0.19,128
20350,Anna,3,Entire home/apt,200,152,1.65,352
20351,Katya,1,Entire home/apt,220,365,0.08,585
20352,Rachel,2,Private room,35,0,0.16,35
20355,Aissatou,2,Entire home/apt,135,0,0.07,135
20357,Cindy,2,Private room,150,0,0.07,150
20359,Diana,2,Private room,38,26,0.42,64
20360,Ploy,2,Private room,70,62,1.7,132
20361,Denise,1,Private room,350,0,0.03,350
20362,Janelle,1,Private room,50,0,0.03,50
20364,Victoria,3,Private room,95,0,0.09,95
20365,Ekaterina,1,Private room,80,58,0.28,138
20366,Veer,1,Entire home/apt,150,0,0.67,150
20367,Vivienne,2,Entire home/apt,53,32,0.74,85
20368,Lilia,1,Private room,54,332,0.31,386
20370,Jessica,3,Private room,53,0,0.29,53
20371,Christina,2,Entire home/apt,135,61,2.66,196
20372,Nikki,2,Entire home/apt,525,189,0.03,714
20373,Jackie,1,Private room,50,0,0.1,50
20375,Nikki,2,Private room,200,189,0.03,389
20376,John,1,Entire home/apt,99,0,0.09,99
20379,Cortney,2,Private room,80,10,0.13,90
20380,Michelle & Eddie,3,Entire home/apt,150,255,4.82,405
20381,Michelle & Eddie,3,Entire home/apt,120,249,4.36,369
20383,Benjamin,2,Entire home/apt,123,343,0.16,466
20384,Andrew,1,Entire home/apt,250,358,0.95,608
20385,Charley,1,Private room,100,135,0.55,235
20387,Carlos,1,Entire home/apt,250,295,1.14,545
20388,Jeniffer,1,Entire home/apt,98,145,0.32,243
20389,Calixto,4,Private room,60,364,0.1,424
20390,Lance,1,Entire home/apt,165,0,0.16,165
20391,Vincent,1,Private room,100,0,0.03,100
20392,Jesse,1,Private room,40,0,0.03,40
20393,Ava,2,Private room,37,2,3.0,39
20394,Sean,1,Private room,75,3,3.89,78
20395,Benny,2,Private room,39,79,0.29,118
20396,Ava,2,Private room,29,2,4.43,31
20397,Marie,2,Private room,80,0,0.07,80
20398,Gabrielle,1,Private room,100,0,0.62,100
20399,Claire,3,Private room,40,6,0.26,46
20400,Genesis,1,Private room,45,45,1.31,90
20401,Steven,2,Entire home/apt,55,243,1.73,298
20402,Bianca,4,Private room,30,0,0.35,30
20403,Danielle,3,Private room,48,341,16.22,389
20404,Suzie And Ryan,2,Private room,49,90,0.3,139
20405,Amy,2,Entire home/apt,135,159,0.48,294
20406,Ivy,1,Entire home/apt,200,19,0.26,219
20408,Katka,2,Entire home/apt,300,9,0.38,309
20409,Leah,2,Private room,70,0,0.03,70
20410,Scott,1,Entire home/apt,225,0,0.26,225
20411,Malcolm,2,Private room,80,353,0.7,433
20412,Douglas,2,Private room,50,0,0.35,50
20413,Brittney,2,Entire home/apt,110,48,3.02,158
20414,Jordan,1,Private room,54,0,0.03,54
20415,Ian & Wendy,2,Entire home/apt,125,0,0.72,125
20418,Eunice,2,Entire home/apt,115,91,1.53,206
20419,Stephanie,3,Private room,60,0,0.16,60
20420,Laura,2,Private room,30,26,1.95,56
20422,Eddie & Lois,5,Private room,55,61,0.96,116
20423,Paula,1,Private room,79,244,0.67,323
20425,Melinda,2,Entire home/apt,85,20,0.38,105
20426,Sasha,1,Private room,80,0,1.5,80
20427,Eddie & Lois,5,Private room,55,348,2.04,403
20428,Britt,1,Private room,66,55,2.49,121
20429,Ariella,2,Entire home/apt,135,0,0.46,135
20430,Pascale,2,Entire home/apt,140,5,1.66,145
20431,Lilia,1,Private room,52,326,0.13,378
20433,Shady,1,Entire home/apt,130,9,3.63,139
20434,Jacob,1,Entire home/apt,585,0,0.23,585
20435,Antonio,2,Private room,35,0,0.22,35
20436,Andrei,2,Private room,55,0,0.13,55
20437,Katarina,3,Entire home/apt,60,47,3.65,107
20438,Kraig,2,Private room,43,0,0.03,43
20439,Daria,2,Shared room,36,365,0.07,401
20440,Jessica,1,Entire home/apt,166,0,0.49,166
20441,Kristina,2,Private room,150,67,1.41,217
20443,Nise,1,Entire home/apt,250,220,1.98,470
20444,J,2,Shared room,28,133,4.02,161
20445,Gerard,2,Entire home/apt,179,198,1.92,377
20446,Don,1,Entire home/apt,97,0,0.14,97
20447,Jeremy,1,Private room,120,0,0.08,120
20448,Brian,2,Entire home/apt,350,129,0.55,479
20449,Kirsten,3,Private room,65,0,2.55,65
20450,Camilo,2,Private room,63,0,0.32,63
20451,Ben,1,Entire home/apt,151,0,0.14,151
20452,Monica,1,Private room,70,0,0.26,70
20454,Michael,1,Entire home/apt,198,0,0.32,198
20456,Armando,1,Private room,100,0,0.03,100
20457,Angelo,2,Entire home/apt,140,7,0.1,147
20458,Kim,2,Private room,49,0,1.96,49
20459,Chayla,1,Private room,799,365,0.1,1164
20460,Samuel,1,Private room,85,0,0.06,85
20461,Steven,1,Entire home/apt,250,36,1.18,286
20463,Sarah,1,Private room,100,0,0.06,100
20465,Yulia,1,Private room,55,0,0.23,55
20466,Daniel,1,Entire home/apt,65,0,0.08,65
20467,Tania & Juan,1,Entire home/apt,75,253,0.55,328
20469,Pierre,1,Entire home/apt,190,112,1.47,302
20470,Han,1,Private room,70,146,5.75,216
20471,Ben,1,Private room,85,56,2.36,141
20472,Jo & Savannah,2,Private room,57,0,4.93,57
20473,Monica,2,Shared room,25,0,0.1,25
20474,Graham And Ben,2,Private room,97,263,0.29,360
20475,Graham And Ben,2,Private room,80,342,0.48,422
20477,Maura,1,Entire home/apt,215,68,0.7,283
20478,Deborah,2,Entire home/apt,89,0,0.29,89
20479,Katie Graham,2,Private room,97,332,0.41,429
20480,Katie Graham,2,Private room,97,97,0.24,194
20483,David,1,Entire home/apt,350,346,1.2,696
20484,Sade,1,Entire home/apt,159,0,0.36,159
20485,Zdzislawa,2,Private room,150,0,1.23,150
20486,Christopher,2,Entire home/apt,70,0,0.19,70
20489,Sascha,2,Private room,84,4,0.38,88
20490,Calvin,1,Private room,300,0,0.15,300
20491,Zarrin,2,Private room,30,0,0.07,30
20493,Yoni,2,Private room,76,53,5.22,129
20494,Sy,1,Entire home/apt,130,0,0.07,130
20495,Inese & Michæl,2,Private room,124,70,2.32,194
20496,Lisa,1,Entire home/apt,160,125,0.07,285
20497,Max,2,Private room,45,171,2.73,216
20498,Juel,3,Private room,33,139,10.64,172
20499,Juel,3,Private room,45,175,8.17,220
20500,Renee,2,Entire home/apt,200,234,1.5,434
20501,Sophie,1,Private room,130,0,0.06,130
20502,Andrea,1,Private room,95,244,0.63,339
20503,Juel,3,Private room,45,155,9.82,200
20505,Bertus,2,Entire home/apt,117,349,2.85,466
20506,Heather,2,Entire home/apt,220,5,0.23,225
20507,Gala,2,Entire home/apt,100,302,2.31,402
20510,Vanessa,2,Private room,31,89,0.06,120
20511,Audrey,3,Entire home/apt,99,0,0.03,99
20513,Mattia,2,Private room,38,0,0.13,38
20515,Jake,3,Private room,33,0,0.06,33
20517,Chris,2,Entire home/apt,170,258,1.18,428
20520,Clare,2,Private room,68,0,0.13,68
20521,Manuel,3,Private room,65,0,0.64,65
20522,Nora,2,Shared room,37,354,1.58,391
20523,Sandra&Orlando,2,Entire home/apt,92,281,0.49,373
20524,Matt,2,Private room,125,0,0.1,125
20525,Adil,2,Entire home/apt,71,64,3.97,135
20526,Yagil,2,Private room,40,0,0.35,40
20527,Charles,1,Entire home/apt,110,9,0.31,119
20528,Germaine,4,Entire home/apt,47,37,0.16,84
20529,Carla,2,Private room,45,158,1.21,203
20530,Erik,1,Private room,50,0,0.32,50
20531,Charlotte,2,Private room,60,0,0.03,60
20532,Bridgid,2,Private room,60,0,0.04,60
20533,Victor,1,Private room,55,81,0.86,136
20534,Ciprian,4,Private room,58,75,2.74,133
20535,Jenna,1,Entire home/apt,200,48,0.15,248
20536,Tracy,2,Private room,50,206,0.16,256
20539,Mabel,3,Private room,50,0,0.07,50
20540,Meli And Daniel,1,Entire home/apt,129,188,0.35,317
20541,Dana,1,Entire home/apt,255,0,0.03,255
20542,Al,1,Entire home/apt,177,31,1.5,208
20543,Kristan,2,Private room,50,0,0.07,50
20544,Eric,2,Private room,49,29,1.11,78
20545,Nikita,2,Entire home/apt,325,250,2.27,575
20546,Mei,3,Private room,30,145,0.7,175
20547,Per Byholt Leibøl,1,Entire home/apt,109,0,0.07,109
20548,Tali,2,Entire home/apt,100,59,1.81,159
20549,Natalia,1,Entire home/apt,280,17,0.76,297
20550,Rich,1,Entire home/apt,149,0,0.06,149
20551,Maud,1,Entire home/apt,2590,361,0.41,2951
20553,Eric,1,Entire home/apt,220,0,0.03,220
20554,Michael,1,Private room,147,28,1.18,175
20556,Helena,2,Private room,105,0,0.13,105
20557,Shaun-Curtis,2,Entire home/apt,175,0,0.07,175
20558,Colin,2,Entire home/apt,60,0,0.17,60
20559,Ciprian,4,Private room,55,84,2.42,139
20560,Iza,1,Private room,65,34,3.32,99
20561,Natalia,1,Private room,59,29,0.36,88
20563,Sarah,1,Entire home/apt,100,0,0.03,100
20564,Dee,1,Private room,50,0,0.67,50
20565,Amit,1,Entire home/apt,145,0,0.16,145
20566,Sandra,1,Entire home/apt,100,0,0.1,100
20567,Suzanne,2,Entire home/apt,150,0,0.13,150
20568,Brian,2,Private room,59,0,0.03,59
20569,Sasha,2,Private room,45,0,0.13,45
20570,Florian,2,Entire home/apt,170,0,0.07,170
20571,Steven,1,Entire home/apt,120,0,0.03,120
20573,Anne,1,Private room,68,15,0.65,83
20574,Jack - Philippe,1,Private room,105,117,2.79,222
20575,Maude,2,Private room,65,0,0.07,65
20579,Mónica,2,Entire home/apt,75,232,2.28,307
20580,Mat,2,Entire home/apt,125,221,3.65,346
20581,Morgan,2,Entire home/apt,100,8,0.17,108
20582,Emmy,3,Private room,48,0,2.03,48
20583,Rami,1,Entire home/apt,149,19,0.29,168
20585,Lou,1,Entire home/apt,290,0,0.16,290
20586,Shachi,2,Private room,120,89,0.23,209
20587,Jessica,2,Private room,45,0,0.26,45
20589,K.,2,Entire home/apt,95,0,2.3,95
20590,Marlon,1,Private room,45,0,0.71,45
20591,Donna,1,Entire home/apt,400,10,0.9,410
20592,Yuki,2,Entire home/apt,130,203,5.45,333
20593,Jonathon,2,Private room,80,272,1.94,352
20594,Steven,4,Private room,45,332,0.68,377
20595,Erika,1,Private room,100,0,0.03,100
20598,Mei Ni,1,Private room,200,39,0.07,239
20599,Isaac,2,Private room,45,0,0.1,45
20600,Liliana,1,Private room,60,198,3.82,258
20601,Caitlin,1,Entire home/apt,132,26,0.33,158
20603,Katarina,3,Entire home/apt,60,50,4.42,110
20604,Thai,2,Private room,38,0,0.1,38
20606,David,1,Entire home/apt,240,45,0.56,285
20608,Sebastian,2,Entire home/apt,120,291,0.42,411
20610,Shauna,2,Entire home/apt,119,0,0.2,119
20611,Liliana,3,Entire home/apt,225,0,0.03,225
20613,Carl,3,Entire home/apt,79,0,0.11,79
20614,Michael,2,Private room,85,0,0.5,85
20615,Raymond,1,Entire home/apt,200,342,0.03,542
20616,Raymond,1,Entire home/apt,150,350,0.12,500
20618,Ali,1,Entire home/apt,215,0,0.38,215
20619,Amitis,2,Private room,67,0,0.07,67
20620,Peter,1,Private room,79,46,0.69,125
20621,Sam,2,Entire home/apt,139,217,3.02,356
20622,Alexandra,1,Entire home/apt,105,11,4.62,116
20624,Ella,2,Shared room,50,0,0.03,50
20625,Charles,4,Private room,60,169,1.8,229
20626,Emily,1,Private room,75,0,0.1,75
20627,Charles,4,Private room,50,110,2.06,160
20628,Michael,1,Entire home/apt,190,236,2.76,426
20629,Wendy,1,Entire home/apt,230,9,0.45,239
20630,Richard,1,Entire home/apt,80,0,0.13,80
20632,Prithvi,2,Entire home/apt,199,0,0.03,199
20634,Freya,2,Private room,64,0,0.1,64
20637,Nicolas,1,Private room,70,0,0.29,70
20639,Ali,2,Entire home/apt,264,0,0.07,264
20640,Adam,1,Private room,100,0,1.18,100
20641,Scott,1,Entire home/apt,135,0,0.29,135
20642,Alex And Zeena,1,Private room,85,359,2.71,444
20643,Alex And Zeena,1,Private room,85,360,3.63,445
20644,Jon,2,Private room,55,0,0.06,55
20645,Erin,1,Entire home/apt,295,66,1.39,361
20646,Tak,2,Private room,28,0,0.23,28
20647,Nash,3,Private room,45,0,0.07,45
20648,Loreley,2,Private room,120,0,0.07,120
20649,Roberson,2,Private room,90,0,0.16,90
20650,Viktoria,1,Private room,89,34,5.31,123
20651,Elís,2,Private room,50,0,0.07,50
20653,Carl,1,Entire home/apt,150,0,0.07,150
20655,Ira,1,Private room,99,0,0.2,99
20657,Aaron,1,Entire home/apt,65,0,0.45,65
20658,Jazz,2,Entire home/apt,280,359,4.34,639
20660,Verun,1,Entire home/apt,120,0,0.07,120
20661,Eddie,1,Private room,70,0,0.03,70
20662,Chris,1,Private room,100,0,0.19,100
20665,Guelma,3,Private room,50,356,2.96,406
20666,Eva,1,Entire home/apt,95,0,0.1,95
20667,Nathan,2,Entire home/apt,140,0,0.13,140
20668,Katia,1,Entire home/apt,180,0,0.77,180
20669,Jeffrey,1,Entire home/apt,200,0,0.07,200
20670,Marco,2,Private room,74,0,0.55,74
20671,Ania,1,Private room,95,19,3.95,114
20672,Ana Cristina,2,Entire home/apt,114,0,1.44,114
20674,Ken,1,Entire home/apt,279,358,0.26,637
20676,Lia,2,Private room,31,0,0.19,31
20678,Andrea,2,Private room,80,0,0.11,80
20679,Jenny,4,Private room,50,22,2.17,72
20680,Darryl Diego,2,Entire home/apt,190,145,1.18,335
20681,Kenza,1,Private room,90,0,0.1,90
20682,Brendan,2,Entire home/apt,399,290,1.03,689
20684,Lana,1,Entire home/apt,110,257,3.69,367
20685,Melissa,2,Entire home/apt,85,0,0.03,85
20686,Brooklyn,1,Private room,105,327,1.35,432
20687,Crystal,1,Shared room,89,88,0.19,177
20688,Kaj,1,Entire home/apt,200,0,0.03,200
20689,Neil,2,Private room,63,160,0.68,223
20691,Maria,3,Entire home/apt,95,101,2.21,196
20692,Laura,2,Private room,58,8,0.52,66
20693,Pablo,1,Private room,120,0,0.16,120
20694,Oscar,1,Entire home/apt,180,0,0.03,180
20695,Carly,1,Private room,150,8,0.1,158
20696,Salvatore,1,Private room,65,0,0.13,65
20697,Jose Vicente,1,Private room,50,0,0.18,50
20698,Mo,1,Private room,105,0,0.05,105
20699,Melkorka,2,Entire home/apt,70,66,0.13,136
20700,Carlos,1,Private room,53,120,5.35,173
20701,Virginia,1,Private room,50,0,0.13,50
20702,Jenny,1,Entire home/apt,205,117,3.36,322
20704,Jim,1,Entire home/apt,142,151,0.43,293
20705,Wesly/Jessica,2,Private room,52,332,4.01,384
20706,Tye,2,Private room,117,285,0.1,402
20707,Samuel,1,Entire home/apt,230,0,0.37,230
20708,Willy,3,Entire home/apt,75,72,2.93,147
20709,Conor,2,Entire home/apt,89,0,2.25,89
20710,Daria,2,Shared room,30,365,0.15,395
20712,Rito,2,Entire home/apt,200,329,2.5,529
20714,James,3,Entire home/apt,89,42,2.0,131
20715,Freddi,2,Private room,41,0,0.24,41
20716,Sarah,2,Private room,75,108,0.1,183
20717,Etwin,2,Private room,90,50,1.28,140
20718,Stephanie,1,Entire home/apt,135,0,0.03,135
20719,Chioma,4,Private room,40,0,0.03,40
20720,Lindsay,2,Private room,93,146,0.23,239
20721,Elva,3,Entire home/apt,100,12,3.03,112
20722,Sol,2,Entire home/apt,350,152,2.67,502
20725,Kharay,1,Entire home/apt,150,0,0.13,150
20726,Mathew,1,Entire home/apt,300,0,0.03,300
20727,Cynthia,1,Private room,86,24,1.55,110
20728,Dr. Amy,1,Entire home/apt,180,1,1.58,181
20729,Carlos,4,Entire home/apt,135,250,0.32,385
20730,Clément,1,Private room,100,0,0.34,100
20731,Gino,2,Entire home/apt,179,326,1.18,505
20732,Greicy,2,Entire home/apt,116,0,1.89,116
20733,Franklyn,3,Private room,115,19,0.78,134
20734,Isadora,2,Private room,60,0,0.03,60
20735,Nette,2,Entire home/apt,137,266,0.19,403
20736,Ileana,1,Entire home/apt,190,0,0.2,190
20738,Christopher,1,Entire home/apt,150,0,0.07,150
20739,Jess & Hagan,2,Entire home/apt,165,127,2.97,292
20741,Jacqueline,1,Entire home/apt,275,258,2.64,533
20742,Clara,2,Private room,60,0,0.26,60
20743,David,2,Private room,33,0,0.06,33
20744,Anna,1,Entire home/apt,125,0,0.36,125
20745,Kalim,2,Private room,41,45,0.23,86
20747,Alex And Zeena,1,Private room,85,344,2.27,429
20749,Mark,2,Entire home/apt,150,37,0.24,187
20750,Michael,2,Entire home/apt,150,0,1.01,150
20751,Julie,2,Entire home/apt,143,38,0.26,181
20753,Jonathan,2,Private room,36,0,0.03,36
20754,Nuries,1,Private room,75,188,2.95,263
20756,Helena & Greg,1,Entire home/apt,200,0,0.03,200
20757,Svetlana,1,Entire home/apt,150,0,0.05,150
20759,Paula,1,Private room,87,0,0.03,87
20761,Meg,1,Entire home/apt,130,0,0.03,130
20762,Daniel And Helene,2,Entire home/apt,120,22,3.42,142
20763,Corey,1,Entire home/apt,100,9,2.33,109
20764,Anna,3,Private room,55,159,0.91,214
20766,Andres,2,Private room,59,0,0.03,59
20767,Annette,2,Entire home/apt,100,0,0.41,100
20768,Katya,2,Entire home/apt,100,44,1.28,144
20769,Christina,2,Entire home/apt,375,22,0.12,397
20770,Cathy,1,Entire home/apt,105,0,0.03,105
20771,Josie,2,Entire home/apt,165,305,1.15,470
20772,J,2,Entire home/apt,150,29,2.6,179
20775,Daniel,1,Private room,72,323,0.37,395
20776,Helma,2,Entire home/apt,225,0,0.26,225
20777,Laura,1,Entire home/apt,200,0,0.1,200
20778,Nina,1,Entire home/apt,145,0,1.69,145
20779,Ajay,2,Shared room,22,0,0.03,22
20780,Martin,2,Entire home/apt,60,0,0.36,60
20781,Andrea,1,Private room,90,0,0.26,90
20784,Molly & Mike,2,Entire home/apt,128,9,0.67,137
20786,Martha,2,Entire home/apt,50,0,0.04,50
20787,Sue,1,Entire home/apt,300,105,0.53,405
20788,Alix,1,Private room,200,0,0.06,200
20789,Mailee,2,Private room,59,0,0.03,59
20790,Kevin,2,Private room,85,0,0.12,85
20791,Sherian,1,Private room,77,0,0.23,77
20792,Andrew,1,Private room,113,0,0.23,113
20793,Hubert,2,Private room,54,21,0.4,75
20794,Aendel,3,Private room,50,11,4.29,61
20796,Juel,3,Private room,40,154,8.33,194
20799,Charles,4,Entire home/apt,115,7,0.23,122
20801,Dasha,2,Entire home/apt,218,342,0.82,560
20803,Vera,1,Entire home/apt,120,15,2.06,135
20804,David,1,Private room,119,0,0.37,119
20805,Thomas,2,Entire home/apt,100,36,2.59,136
20806,Andrea,2,Private room,69,83,0.33,152
20807,Elodie,1,Entire home/apt,190,0,0.78,190
20809,Kristina,1,Entire home/apt,120,35,1.1,155
20810,Bea Ebony,2,Entire home/apt,140,141,1.09,281
20811,Upinder,2,Private room,75,253,0.23,328
20814,Ibi,3,Shared room,110,56,0.39,166
20815,Chayla,1,Private room,599,365,0.07,964
20816,Brando,1,Private room,38,0,0.03,38
20817,Hello,1,Entire home/apt,375,38,1.03,413
20818,Lily,2,Entire home/apt,90,144,3.52,234
20819,Chayla,1,Private room,999,365,0.05,1364
20822,Josie,2,Entire home/apt,260,309,0.6,569
20824,Brian,2,Private room,98,0,0.1,98
20825,Nathan,1,Private room,79,151,0.7,230
20826,Ben,1,Entire home/apt,175,0,0.38,175
20827,Jenia,1,Private room,200,0,0.69,200
20829,Jacob,2,Private room,60,0,0.16,60
20830,Marta,1,Entire home/apt,125,0,0.56,125
20831,Polly,1,Private room,60,159,0.03,219
20832,Steven,2,Entire home/apt,100,6,2.16,106
20833,Lesya,1,Entire home/apt,225,0,0.42,225
20834,Aj,2,Entire home/apt,110,88,4.79,198
20835,Vinay,2,Entire home/apt,195,0,0.23,195
20836,Jermaine,2,Private room,55,0,0.43,55
20837,Ashley,2,Entire home/apt,55,0,0.16,55
20838,Enid,1,Entire home/apt,99,220,0.22,319
20840,Alex And Zeena,1,Private room,85,356,3.53,441
20841,Felix,3,Private room,100,42,4.48,142
20842,Kdn,1,Private room,69,180,1.34,249
20843,Sheila,4,Private room,46,135,1.65,181
20844,Shane,1,Private room,165,0,0.03,165
20846,Han,3,Private room,40,0,0.06,40
20848,Anthony,2,Entire home/apt,115,275,5.04,390
20849,Sophia,1,Entire home/apt,349,71,2.54,420
20850,Eric,1,Entire home/apt,259,1,4.03,260
20851,Nicholas,2,Entire home/apt,137,0,0.1,137
20853,Claire,1,Entire home/apt,160,124,1.35,284
20854,Joel,2,Entire home/apt,200,0,0.04,200
20855,Maria,1,Private room,52,0,0.61,52
20856,Ana,1,Entire home/apt,160,92,1.22,252
20857,Cody,1,Entire home/apt,200,0,0.16,200
20858,Matt,1,Entire home/apt,550,0,0.14,550
20859,Ivan,1,Private room,100,0,0.07,100
20860,Helen,2,Entire home/apt,175,0,0.21,175
20861,Monika,1,Entire home/apt,275,0,0.15,275
20862,Cori,3,Entire home/apt,100,17,0.53,117
20863,Eric,2,Private room,60,0,1.02,60
20864,CRNY Monthly Rentals,1,Entire home/apt,99,132,0.11,231
20865,Corrado,2,Entire home/apt,56,0,0.1,56
20867,Eric,1,Entire home/apt,180,0,1.51,180
20868,DeAnna,2,Private room,45,0,0.26,45
20869,Louis,2,Private room,48,0,0.03,48
20870,Nicole,1,Private room,115,172,0.34,287
20871,Helga,1,Private room,50,22,1.1,72
20872,Allie,2,Private room,135,29,1.87,164
20874,Stephanie,1,Private room,80,167,3.25,247
20877,Jaleh,1,Private room,87,65,8.79,152
20879,Vineet,2,Entire home/apt,171,244,2.72,415
20880,Gary,1,Private room,225,0,0.16,225
20881,Laila,1,Entire home/apt,100,250,1.18,350
20882,Beth,2,Private room,60,42,1.83,102
20883,Aracelis,2,Private room,85,36,0.72,121
20885,Matthew,2,Entire home/apt,249,54,0.67,303
20886,Isaac,2,Private room,35,0,0.1,35
20887,Hannah,1,Entire home/apt,100,0,0.09,100
20888,Jane Jo,2,Entire home/apt,159,0,0.41,159
20890,Lee,1,Entire home/apt,196,186,3.09,382
20891,Lukasz,1,Private room,40,0,0.07,40
20892,Aaron,1,Private room,95,0,0.07,95
20893,Michael,3,Private room,55,0,0.76,55
20894,Donari,2,Entire home/apt,122,146,1.41,268
20896,Valentina,3,Private room,55,36,1.13,91
20897,Raymond,1,Private room,90,68,2.5,158
20898,Jacqueline,1,Private room,75,158,2.64,233
20899,J,2,Entire home/apt,200,0,0.17,200
20901,D M,2,Entire home/apt,136,0,0.15,136
20902,Lily,3,Private room,50,90,1.99,140
20905,Anaïs,2,Private room,45,0,0.17,45
20907,Ismael,4,Entire home/apt,150,93,2.87,243
20908,Rory,3,Private room,40,0,0.03,40
20909,Melissa,2,Private room,90,244,1.16,334
20910,Melissa,2,Private room,80,342,1.09,422
20911,Kyle,1,Private room,25,99,3.33,124
20912,Lucy,1,Private room,40,0,0.2,40
20913,Mila,1,Entire home/apt,220,14,0.52,234
20914,Ash,3,Private room,81,179,0.2,260
20915,Ricardo,1,Private room,85,0,0.1,85
20916,Jo & Savannah,2,Shared room,31,0,3.72,31
20917,Kwana,2,Entire home/apt,130,0,0.27,130
20919,Victoria,2,Private room,75,0,1.06,75
20920,Rebecca,2,Entire home/apt,73,2,1.86,75
20921,Dustin,2,Entire home/apt,56,0,0.1,56
20922,Tracey,2,Entire home/apt,175,0,0.56,175
20925,Anthony,2,Entire home/apt,125,185,0.31,310
20927,Pearline,2,Entire home/apt,75,179,3.16,254
20928,Danielle,2,Private room,69,0,0.34,69
20929,Brandon,2,Private room,60,0,0.5,60
20930,Jared,2,Private room,80,66,0.03,146
20931,Belinda,2,Private room,60,0,1.02,60
20932,Neena,3,Entire home/apt,225,329,2.34,554
20935,Jonathan,3,Private room,80,244,0.76,324
20936,Ploy,2,Private room,55,58,1.41,113
20937,Emani,2,Private room,36,154,0.79,190
20938,Gerceida,3,Private room,55,59,1.16,114
20939,Sarah-Jane,1,Shared room,55,88,1.28,143
20940,Constanza,2,Private room,80,0,0.18,80
20941,Chad,2,Entire home/apt,149,75,2.87,224
20944,Daniel,2,Entire home/apt,350,156,0.09,506
20945,Cristina,2,Private room,35,79,0.38,114
20946,T,1,Private room,50,25,3.68,75
20947,Nancy,2,Shared room,50,19,6.54,69
20948,Jamil,2,Entire home/apt,100,0,1.19,100
20949,Tal,2,Entire home/apt,150,0,0.11,150
20951,Yukee,1,Entire home/apt,190,337,0.26,527
20952,Sasha,4,Entire home/apt,60,94,0.2,154
20953,Yoko,1,Entire home/apt,80,0,0.03,80
20954,Tee,2,Entire home/apt,380,22,0.37,402
20955,Sammy & Chris,2,Entire home/apt,125,185,3.57,310
20956,Danny,1,Entire home/apt,235,235,4.05,470
20957,Christine,1,Private room,67,9,0.2,76
20958,Mike,1,Entire home/apt,232,13,0.17,245
20959,Aleida,3,Private room,40,145,4.36,185
20960,Elka,1,Private room,96,83,2.97,179
20962,Saphira,1,Private room,120,134,0.76,254
20963,Tom,2,Entire home/apt,120,0,2.53,120
20964,Stella,3,Private room,72,175,0.54,247
20965,Ruth,2,Private room,90,5,0.4,95
20966,Jackie,3,Private room,65,365,0.72,430
20968,Octavio,2,Private room,41,0,0.1,41
20969,Jessie,2,Private room,30,268,0.45,298
20970,Brad,2,Entire home/apt,175,0,0.5,175
20971,Joseph,3,Entire home/apt,100,65,3.08,165
20972,Shelley,3,Private room,100,87,1.38,187
20973,Jonathan,2,Private room,65,294,3.5,359
20974,Isaac,1,Private room,70,0,0.45,70
20976,Hildegaard,2,Private room,80,88,1.16,168
20977,Jason,2,Entire home/apt,160,16,2.26,176
20979,Justyna,1,Entire home/apt,180,35,1.18,215
20980,Oscar,2,Entire home/apt,199,70,4.06,269
20982,Nikki,1,Private room,60,0,0.12,60
20983,Tucker,2,Private room,49,9,2.0,58
20984,Salvatore,2,Entire home/apt,94,11,0.93,105
20985,James,1,Entire home/apt,77,188,0.18,265
20986,Amos,2,Private room,56,87,2.35,143
20987,Kerry,2,Private room,47,0,0.07,47
20988,Roseann,3,Private room,89,319,7.23,408
20989,Cindy,2,Entire home/apt,95,0,0.18,95
20990,Ian,2,Private room,60,3,0.58,63
20991,Todd & Ashta,2,Entire home/apt,125,255,3.67,380
20992,Erika,2,Entire home/apt,11,261,3.86,272
20994,J,1,Private room,80,0,4.59,80
20995,Milan,2,Private room,75,275,2.56,350
20996,Laura,1,Entire home/apt,175,0,0.57,175
20997,J,1,Private room,85,46,4.96,131
20999,Matt,1,Entire home/apt,144,0,0.08,144
21000,Marie,2,Private room,99,364,0.27,463
21001,Michael,1,Entire home/apt,899,89,0.23,988
21002,Brandon,1,Private room,141,334,1.61,475
21003,Bobi,1,Private room,50,350,3.25,400
21005,Natalia & Gustavo,2,Private room,50,348,0.23,398
21009,Iso,3,Private room,35,294,4.33,329
21010,Nikita,2,Entire home/apt,169,259,1.92,428
21012,Sanja,2,Private room,119,0,0.59,119
21013,Virginia & Steve,2,Entire home/apt,115,68,2.9,183
21014,Cecil,1,Private room,115,363,0.94,478
21015,Joi,1,Entire home/apt,200,0,0.2,200
21016,Terumi,2,Entire home/apt,93,222,1.32,315
21017,Michael And Meredith,2,Entire home/apt,160,53,1.21,213
21018,Harrison,1,Private room,100,156,0.46,256
21019,Basile,2,Private room,65,0,0.41,65
21020,Bobi,1,Private room,64,364,3.4,428
21021,Albert,2,Entire home/apt,95,0,2.93,95
21022,Josh,2,Entire home/apt,220,167,0.66,387
21023,Katharine,2,Private room,70,0,1.33,70
21025,Athelstan,2,Entire home/apt,225,337,2.24,562
21027,Charles,3,Entire home/apt,184,300,1.72,484
21028,Athelstan,2,Entire home/apt,175,337,0.23,512
21029,Amy,2,Private room,69,106,3.1,175
21030,Kris,2,Entire home/apt,175,89,0.13,264
21031,Farrah,1,Private room,91,0,0.14,91
21032,Montserrat,1,Private room,122,0,0.67,122
21034,Ro,1,Entire home/apt,250,198,0.37,448
21037,Christi,2,Entire home/apt,125,0,0.13,125
21038,Maria,1,Private room,120,36,0.53,156
21039,Eric,1,Entire home/apt,233,219,3.08,452
21040,Rocco,1,Entire home/apt,220,256,2.01,476
21042,Alexandra,1,Entire home/apt,105,0,4.18,105
21043,BNB-Resorts By RC,1,Entire home/apt,165,0,0.18,165
21044,Shari,2,Entire home/apt,175,0,0.58,175
21047,Samuel,2,Private room,100,0,0.14,100
21048,Omar £ Jacqueline,3,Private room,90,0,0.34,90
21049,Cindy,2,Entire home/apt,109,35,0.04,144
21050,Robert,2,Entire home/apt,95,0,0.43,95
21053,Jac,2,Entire home/apt,175,321,0.87,496
21054,Noam,2,Private room,46,72,0.27,118
21056,Kate,1,Entire home/apt,98,0,0.14,98
21057,Eugon And David,2,Private room,95,60,2.18,155
21058,Dongho,3,Private room,34,0,0.03,34
21059,Jonathan,3,Private room,79,144,0.93,223
21060,MyCity,1,Entire home/apt,130,335,0.38,465
21062,Anna,1,Private room,75,305,2.69,380
21063,Jill,1,Private room,61,121,0.07,182
21064,Taka,3,Entire home/apt,99,60,1.85,159
21065,Roger,1,Entire home/apt,110,0,0.39,110
21066,Roy,1,Private room,99,3,0.7,102
21067,Shay,2,Private room,42,267,0.75,309
21068,Daniel,2,Private room,50,0,0.04,50
21069,Stephen,2,Entire home/apt,82,28,2.76,110
21070,Chris,2,Entire home/apt,206,116,1.25,322
21072,Delphina,2,Entire home/apt,69,0,0.23,69
21073,Cody,1,Entire home/apt,164,0,0.68,164
21074,Lai-Lin,1,Entire home/apt,95,0,0.14,95
21075,MyCity,1,Entire home/apt,160,311,0.18,471
21076,Sara,2,Entire home/apt,150,26,0.4,176
21077,Nadav,2,Private room,75,77,1.95,152
21078,Caroline,2,Entire home/apt,130,0,0.94,130
21079,Patrice,1,Entire home/apt,95,0,0.2,95
21081,Michael,2,Entire home/apt,150,195,3.88,345
21082,Bettina,2,Entire home/apt,550,15,0.42,565
21083,Alex,2,Entire home/apt,250,126,1.41,376
21086,Miles,1,Entire home/apt,100,9,4.81,109
21087,Michael,2,Private room,68,64,0.47,132
21088,Lisa,1,Entire home/apt,140,125,0.07,265
21089,Simon,1,Private room,99,168,3.61,267
21090,Maya,1,Private room,97,73,5.11,170
21092,Simon,1,Private room,75,34,3.65,109
21093,Julia,2,Entire home/apt,150,64,0.91,214
21094,Yves,2,Entire home/apt,80,337,4.07,417
21095,Georgia And Kevin,2,Entire home/apt,98,127,4.13,225
21096,Rebekah,2,Entire home/apt,165,130,3.62,295
21097,Gina,2,Entire home/apt,125,0,0.3,125
21099,Paul,1,Entire home/apt,124,38,0.43,162
21100,Jaleh,1,Private room,100,32,7.75,132
21101,Triny,3,Private room,33,361,0.53,394
21102,Christine,2,Entire home/apt,275,65,4.08,340
21104,Eunjin,1,Private room,30,0,0.03,30
21105,Sasha,4,Entire home/apt,71,310,0.41,381
21106,Jacob,1,Private room,158,238,4.37,396
21107,Kimberly,1,Entire home/apt,100,1,2.16,101
21108,Ioanna,2,Private room,70,0,0.07,70
21109,Dustin,2,Private room,77,0,0.07,77
21110,Abbi,1,Private room,90,0,0.1,90
21111,Audrey,1,Private room,210,365,0.11,575
21112,Steve,2,Entire home/apt,250,258,2.09,508
21114,Julian,2,Entire home/apt,116,295,3.33,411
21115,Ken,1,Entire home/apt,190,365,0.73,555
21116,Vilena,3,Private room,65,362,0.04,427
21118,Evan,1,Entire home/apt,200,159,1.64,359
21119,Josh,2,Private room,55,0,0.17,55
21120,Kimberly,2,Private room,89,139,1.35,228
21121,Adrian,2,Entire home/apt,125,0,0.47,125
21122,Jeanne,2,Entire home/apt,197,342,0.06,539
21123,Alanah,1,Shared room,50,23,1.32,73
21124,Morgan,2,Private room,37,0,0.03,37
21125,Louis,1,Entire home/apt,189,63,0.98,252
21127,Jose,1,Private room,39,52,2.52,91
21129,Nidia,1,Private room,60,0,1.78,60
21131,Agona,2,Private room,45,0,0.12,45
21133,Ziggy & Rome,2,Entire home/apt,135,76,2.61,211
21134,Ksenia & Masha,2,Private room,30,57,0.53,87
21135,Paul,4,Entire home/apt,60,131,3.61,191
21136,Wesly/Jessica,2,Private room,52,329,3.4,381
21137,Jenn,2,Entire home/apt,144,0,0.9,144
21138,Robert,2,Entire home/apt,75,358,0.09,433
21139,Pietro,4,Private room,73,138,0.61,211
21140,Tomas,1,Private room,119,15,1.79,134
21141,Lee,2,Entire home/apt,170,235,5.2,405
21142,Anamaria & Ricardo,1,Private room,135,0,0.11,135
21143,Danielle,1,Private room,25,139,1.46,164
21144,Igam,2,Private room,35,0,1.78,35
21145,Natasha,1,Entire home/apt,103,0,0.57,103
21146,Sam,2,Private room,50,35,2.79,85
21147,Monica,1,Private room,55,24,0.16,79
21148,Natalie,1,Private room,99,107,2.75,206
21149,Justine,4,Private room,43,365,1.26,408
21150,Tiffany,1,Private room,75,156,3.47,231
21151,Mike,1,Private room,117,99,2.26,216
21152,Davide,1,Entire home/apt,195,0,0.38,195
21153,Michal,1,Private room,100,0,0.21,100
21154,Shay,2,Private room,34,280,0.2,314
21155,Arden,2,Private room,44,0,0.24,44
21156,Jason,2,Entire home/apt,210,20,4.41,230
21157,Wen,1,Entire home/apt,150,43,0.44,193
21158,Yngrid And Jiovanni,2,Entire home/apt,84,132,2.43,216
21159,Adam,1,Entire home/apt,69,0,0.07,69
21161,Kate,1,Private room,88,112,3.31,200
21162,Juan,2,Private room,33,308,3.1,341
21163,Kate,1,Private room,98,81,3.43,179
21164,Rina,1,Private room,60,14,3.11,74
21165,Carl,2,Entire home/apt,75,19,2.48,94
21166,Mario,2,Entire home/apt,100,216,3.67,316
21167,Nadine,1,Entire home/apt,115,0,0.39,115
21168,Jaime,2,Entire home/apt,200,291,1.39,491
21169,Michael,1,Entire home/apt,130,0,1.9,130
21170,Valentin,2,Shared room,28,365,0.13,393
21171,Richard,1,Entire home/apt,230,189,1.83,419
21173,Kate,2,Entire home/apt,190,162,0.53,352
21174,D,1,Private room,100,334,2.19,434
21176,Jed,2,Entire home/apt,1000,365,0.31,1365
21177,Helen,2,Private room,55,0,0.07,55
21178,Marianne,2,Private room,85,215,5.85,300
21181,Benjamin,2,Private room,95,25,2.24,120
21182,Sam,2,Entire home/apt,139,29,1.52,168
21183,Laura,2,Private room,100,0,0.05,100
21184,Peter,3,Entire home/apt,120,0,0.08,120
21185,Susy,2,Private room,30,179,1.87,209
21186,Matt & Kathleen,1,Private room,174,145,3.34,319
21187,Malini,3,Private room,53,71,13.15,124
21188,Armando,4,Private room,79,78,2.88,157
21189,Shaun,1,Private room,173,87,0.15,260
21190,Lun,2,Private room,55,0,0.03,55
21191,Armando,4,Private room,60,83,3.43,143
21193,Mike,1,Private room,130,0,0.24,130
21195,Bianca,2,Private room,50,126,0.18,176
21196,Valentin,2,Shared room,20,365,0.09,385
21197,Michael & Hanako,2,Entire home/apt,120,0,0.24,120
21198,Valentine,2,Private room,66,11,0.37,77
21200,Jeffrey,2,Entire home/apt,110,319,0.34,429
21201,Ritchy,1,Entire home/apt,155,3,0.12,158
21203,Monica,3,Private room,85,88,0.11,173
21204,Eunice,1,Entire home/apt,130,0,0.13,130
21206,Cami,1,Entire home/apt,200,109,2.94,309
21208,Hilary,1,Entire home/apt,170,0,0.98,170
21212,Ryan,2,Private room,30,0,0.07,30
21213,Alex,2,Private room,300,0,0.15,300
21214,Jordan,2,Private room,40,0,0.2,40
21215,Philip,2,Entire home/apt,280,343,1.51,623
21216,Regina,1,Private room,60,8,0.71,68
21217,V.Stephan,1,Entire home/apt,200,71,1.73,271
21218,Masud,2,Private room,35,326,0.19,361
21220,Joel,1,Entire home/apt,995,290,0.73,1285
21221,Sabrina,2,Entire home/apt,140,267,1.91,407
21222,Joe,1,Entire home/apt,399,336,1.76,735
21223,Dounia,2,Entire home/apt,75,0,0.43,75
21224,Fumiko,2,Private room,65,173,0.09,238
21225,Valentin,2,Private room,32,124,0.04,156
21226,Valentin,2,Shared room,26,365,0.09,391
21227,Dwane,2,Entire home/apt,100,364,2.27,464
21229,Daniel,1,Entire home/apt,149,0,0.34,149
21230,Tim,2,Private room,85,7,0.55,92
21233,Eric,1,Entire home/apt,125,204,0.26,329
21234,Devika,3,Private room,32,266,1.61,298
21235,Concetta,3,Entire home/apt,47,212,0.9,259
21236,Paul,1,Private room,130,0,0.65,130
21237,Jay,1,Entire home/apt,249,363,0.27,612
21238,Christophe,1,Entire home/apt,360,3,0.84,363
21239,Samantha,2,Private room,40,0,0.03,40
21240,Dwayne,1,Private room,55,365,1.68,420
21241,Clell,2,Private room,800,55,1.64,855
21242,Ryan,3,Entire home/apt,88,0,0.07,88
21243,Nicholas,3,Entire home/apt,175,317,3.05,492
21244,Teri,1,Private room,200,0,0.28,200
21246,Julien,1,Entire home/apt,190,81,0.3,271
21247,Tricia,5,Entire home/apt,75,73,3.52,148
21249,Thiago,1,Entire home/apt,224,0,0.99,224
21251,Santi,1,Entire home/apt,120,0,0.31,120
21252,Auset,2,Private room,55,249,0.38,304
21253,Erfan,3,Entire home/apt,106,34,3.13,140
21256,Felix,4,Entire home/apt,84,63,4.0,147
21257,Vaki,1,Private room,195,9,0.31,204
21258,Charlie,3,Entire home/apt,175,42,0.47,217
21259,Do,2,Private room,53,0,0.04,53
21260,Danielle,2,Private room,55,87,0.28,142
21261,Cleo,2,Private room,47,173,0.35,220
21262,Eitan,1,Private room,53,0,1.39,53
21264,Gaurav,1,Private room,95,0,0.13,95
21265,Claire,2,Entire home/apt,148,3,0.78,151
21266,Milly,1,Entire home/apt,459,173,2.04,632
21267,J,1,Entire home/apt,350,208,2.87,558
21268,Joe,1,Private room,90,272,6.79,362
21269,Tristan,2,Entire home/apt,120,0,0.18,120
21270,Cat,2,Entire home/apt,91,12,0.97,103
21271,Eric,2,Entire home/apt,170,66,0.5,236
21273,Tiara,1,Private room,60,246,0.27,306
21274,Raquel,3,Entire home/apt,90,1,0.49,91
21276,Laura,1,Entire home/apt,135,0,0.03,135
21277,Bianca,1,Private room,91,111,1.86,202
21278,Nicauris,1,Private room,52,237,0.59,289
21279,Maayan,3,Entire home/apt,400,4,0.37,404
21282,Steven & Melissa,2,Entire home/apt,150,80,1.21,230
21283,Eun M,1,Private room,65,43,4.52,108
21284,Aaron,2,Entire home/apt,220,0,0.3,220
21285,Christina,1,Entire home/apt,110,7,1.27,117
21286,Hali,3,Private room,44,0,0.5,44
21288,Simon,2,Private room,65,0,0.35,65
21289,Rebecca,2,Private room,40,0,1.16,40
21290,Luis,2,Entire home/apt,175,325,1.17,500
21291,Autumn,2,Entire home/apt,77,0,0.14,77
21292,Andrew,2,Private room,59,60,5.2,119
21293,Tyreik,1,Private room,85,0,0.29,85
21294,Joling,2,Entire home/apt,240,237,2.95,477
21295,Angela,1,Shared room,49,304,0.39,353
21296,Delphina,2,Private room,49,0,0.44,49
21297,Melissa,4,Private room,45,174,1.55,219
21299,Axel,2,Private room,80,68,0.95,148
21300,Steven,2,Private room,99,0,0.24,99
21301,Chadanut,2,Private room,45,22,1.41,67
21302,René,1,Private room,59,6,2.24,65
21303,Mireille,2,Private room,82,89,0.78,171
21304,Kevin,1,Entire home/apt,110,0,0.17,110
21305,Matthew,1,Private room,95,83,0.07,178
21306,Lauren,2,Private room,58,0,0.11,58
21307,Anthony,1,Private room,69,0,2.38,69
21308,Ari,2,Private room,50,0,0.31,50
21309,Gera & Werc,2,Private room,60,66,0.77,126
21310,RoseAnne,1,Private room,73,0,0.03,73
21312,May,2,Entire home/apt,139,0,0.48,139
21313,Carlos,3,Private room,55,253,2.44,308
21314,David,1,Private room,48,341,0.18,389
21316,Angie,1,Private room,97,127,4.11,224
21317,Angie,1,Private room,99,119,4.31,218
21318,Shain,1,Entire home/apt,175,310,0.28,485
21319,Julia,1,Entire home/apt,159,8,1.21,167
21320,Jensine,1,Entire home/apt,153,3,0.14,156
21321,Katy,1,Entire home/apt,243,8,1.39,251
21322,Jenn,2,Private room,98,145,0.56,243
21323,Liam,3,Private room,60,90,1.5,150
21324,Dioni,3,Entire home/apt,100,200,0.07,300
21325,Paul,3,Entire home/apt,80,8,0.09,88
21326,Guelma,3,Private room,45,281,2.38,326
21327,Lisa,1,Private room,125,0,0.03,125
21328,Berat,3,Private room,30,358,2.53,388
21330,Harry,3,Private room,47,126,1.02,173
21331,Aurora,2,Entire home/apt,99,86,0.54,185
21332,Maggie,2,Entire home/apt,150,0,0.04,150
21333,Isa,1,Private room,45,275,0.15,320
21334,Maggie,2,Entire home/apt,150,0,0.19,150
21335,Yaacov,1,Entire home/apt,140,338,0.23,478
21336,Raymond,1,Entire home/apt,200,340,0.04,540
21337,Nicole,1,Entire home/apt,400,42,0.74,442
21338,Will,2,Private room,35,0,0.07,35
21339,Yaacov,1,Entire home/apt,240,289,0.34,529
21340,Yaacov,1,Entire home/apt,189,331,0.26,520
21341,Yaacov,1,Entire home/apt,225,351,0.48,576
21342,Sofia,3,Entire home/apt,175,176,0.21,351
21344,Ryan,2,Entire home/apt,185,337,0.07,522
21345,Michi,2,Entire home/apt,107,1,0.42,108
21346,Lyuda,1,Private room,85,357,0.68,442
21347,Christie,2,Private room,57,40,1.05,97
21348,Nikita,2,Entire home/apt,195,0,2.03,195
21349,Joe,3,Entire home/apt,40,74,3.47,114
21350,Devin,1,Private room,100,0,1.2,100
21351,Sara Kate,2,Entire home/apt,300,360,2.43,660
21352,Carly,2,Entire home/apt,150,7,0.65,157
21353,Ja,2,Entire home/apt,155,110,1.97,265
21354,Clotilde & Nicolas,2,Private room,45,51,0.83,96
21355,Greg,2,Private room,59,162,2.24,221
21356,Costas,3,Private room,65,23,0.81,88
21357,Vanessa,2,Entire home/apt,91,60,3.99,151
21358,Jacob,1,Private room,118,224,3.93,342
21359,Jeremy,2,Entire home/apt,199,179,0.15,378
21360,Cliff,3,Shared room,34,0,0.1,34
21361,Christopher,3,Private room,40,0,0.61,40
21362,Anna,1,Private room,100,35,0.09,135
21364,Hadass,2,Private room,51,99,0.83,150
21365,Prashant,2,Private room,30,0,0.03,30
21366,Safa,2,Entire home/apt,87,242,3.99,329
21367,Demettre,1,Entire home/apt,215,0,1.0,215
21368,Berat,3,Private room,30,89,2.01,119
21369,Stephen,2,Private room,900,89,0.03,989
21371,Lyra,1,Private room,71,25,2.59,96
21373,Michael,2,Entire home/apt,200,0,1.19,200
21374,Joseph,2,Entire home/apt,225,0,0.55,225
21375,Christopher,1,Entire home/apt,250,149,3.35,399
21378,Figgins,4,Private room,34,126,0.79,160
21379,Armando,4,Private room,79,68,3.45,147
21380,Armando,4,Private room,60,65,2.7,125
21381,Seth,1,Entire home/apt,115,0,0.27,115
21382,Ben And Jane,2,Entire home/apt,20,0,0.58,20
21384,Jason,2,Entire home/apt,165,171,1.95,336
21385,Darlene,1,Private room,46,91,0.97,137
21386,Paulo,3,Entire home/apt,85,0,1.05,85
21387,Greg,1,Private room,99,61,4.62,160
21388,Alison,2,Entire home/apt,206,0,1.46,206
21389,James,1,Private room,65,0,0.07,65
21390,Max,2,Private room,55,0,2.11,55
21391,Mirco,5,Entire home/apt,60,12,0.91,72
21392,Margaret And Orville,3,Entire home/apt,127,44,1.99,171
21393,Martha,3,Private room,50,341,1.0,391
21394,John,5,Entire home/apt,120,191,4.0,311
21396,Anders,1,Entire home/apt,165,228,5.32,393
21397,Angela,4,Entire home/apt,119,146,2.74,265
21398,Lauren,2,Private room,150,359,0.1,509
21399,Marilyn,1,Private room,65,199,6.38,264
21400,Marilyn,1,Private room,103,215,5.06,318
21401,Kathy,2,Private room,65,2,0.24,67
21404,Gautam,1,Private room,80,50,0.15,130
21405,Aspano,1,Entire home/apt,160,19,2.33,179
21406,Daniel,3,Private room,75,67,2.45,142
21407,Barry,4,Private room,35,3,0.61,38
21408,Robert,2,Private room,55,9,3.77,64
21410,Matthew,2,Private room,55,0,0.54,55
21411,Chérie,2,Private room,46,0,2.32,46
21412,Maggie,3,Entire home/apt,95,106,5.31,201
21413,Ed,2,Entire home/apt,115,140,2.23,255
21414,René,1,Private room,75,9,1.64,84
21415,Rossana,3,Private room,47,292,1.5,339
21416,Melani,2,Private room,70,272,0.27,342
21417,Ero,3,Private room,70,31,4.69,101
21418,Michael,2,Entire home/apt,100,15,0.14,115
21419,Tiffany,2,Entire home/apt,135,0,0.68,135
21420,Abra & Domenic,3,Entire home/apt,145,310,1.63,455
21422,Tamarinda,1,Entire home/apt,125,0,0.08,125
21423,Bonnie,1,Entire home/apt,600,261,3.04,861
21424,Danni,1,Private room,89,188,0.26,277
21425,Dennis,3,Entire home/apt,125,0,0.48,125
21426,Ralph,1,Private room,135,3,4.42,138
21427,Concetta,1,Private room,125,86,3.28,211
21428,Karen,1,Private room,70,249,3.28,319
21429,Karen,1,Private room,65,309,2.63,374
21430,Nancy And John,1,Entire home/apt,489,152,3.01,641
21431,A. Kaylee,2,Entire home/apt,99,272,2.05,371
21433,René,1,Private room,120,0,1.03,120
21434,Amanda,1,Entire home/apt,160,0,0.9,160
21435,John,1,Private room,125,363,0.75,488
21436,Chris,2,Entire home/apt,300,3,1.69,303
21438,Chito And Xavier,1,Entire home/apt,115,85,2.99,200
21439,Riley,1,Entire home/apt,600,286,3.75,886
21440,Chito And Xavier,1,Entire home/apt,100,32,3.61,132
21441,Giselle,1,Private room,47,233,2.52,280
21442,Alison,2,Entire home/apt,130,257,2.36,387
21443,Xenia,2,Private room,55,41,0.84,96
21444,Carlotta,1,Entire home/apt,230,260,0.46,490
21445,J,1,Entire home/apt,125,40,2.7,165
21447,Jennifer,2,Private room,85,40,0.22,125
21449,Trouve,2,Entire home/apt,110,0,0.41,110
21450,Liliana,1,Private room,100,0,0.39,100
21451,Philip,1,Private room,80,20,4.56,100
21453,Dana  (& Justin),1,Private room,54,63,2.54,117
21454,John And Colleen,3,Private room,60,84,1.53,144
21455,Gina,1,Entire home/apt,120,0,0.07,120
21456,Karen,2,Entire home/apt,115,34,0.08,149
21457,Natalie,2,Private room,100,87,0.09,187
21459,Alyssa,1,Entire home/apt,100,0,0.66,100
21460,Matt,3,Entire home/apt,90,75,3.97,165
21461,Emilia,2,Private room,60,173,0.14,233
21462,Karthik,1,Private room,60,0,0.04,60
21463,Mirela And Daniel,4,Entire home/apt,89,252,3.2,341
21464,Joe,1,Private room,85,252,7.18,337
21465,Ramin,1,Entire home/apt,350,0,0.15,350
21466,Vinny,1,Entire home/apt,285,310,2.7,595
21467,Manesh,1,Entire home/apt,125,0,0.21,125
21468,Daniel,1,Private room,109,0,2.23,109
21469,Felicity,1,Entire home/apt,545,322,1.57,867
21470,Joseph,2,Entire home/apt,208,255,2.26,463
21471,Steph,3,Entire home/apt,100,360,1.7,460
21472,Walesca,1,Private room,48,0,0.07,48
21474,Sara,2,Private room,60,0,0.21,60
21475,Adi And Evangel,1,Private room,78,138,1.3,216
21476,Stephen,2,Entire home/apt,270,172,1.73,442
21477,Laura,1,Entire home/apt,160,365,0.63,525
21478,Kevin,2,Entire home/apt,175,0,0.05,175
21479,Luis,1,Entire home/apt,180,0,0.11,180
21480,Joe,3,Private room,30,112,4.1,142
21481,Wade,1,Entire home/apt,650,179,1.61,829
21482,Caitlin,1,Private room,70,0,1.08,70
21483,Shane & Nicole,2,Entire home/apt,185,323,0.53,508
21486,Ali,2,Private room,59,85,2.52,144
21488,Taylor,1,Private room,65,18,5.07,83
21489,Gonda,1,Entire home/apt,100,0,0.97,100
21491,Azza,2,Private room,80,88,0.15,168
21492,LeeAna,2,Entire home/apt,100,14,6.02,114
21493,George,1,Entire home/apt,200,0,1.48,200
21494,Chris,3,Private room,64,0,2.21,64
21495,Olya,2,Private room,60,0,0.46,60
21496,Su Lim,1,Entire home/apt,50,0,0.03,50
21497,Viviana,2,Entire home/apt,160,189,0.75,349
21498,Chang,3,Private room,55,67,3.51,122
21499,Daniel,1,Private room,63,218,1.09,281
21501,Esaies,2,Private room,90,0,0.12,90
21502,Laurence,1,Private room,98,0,0.77,98
21503,Tina,1,Entire home/apt,110,15,1.53,125
21504,Mike And Lori,1,Entire home/apt,170,0,0.03,170
21505,Chelsea,2,Private room,95,67,2.56,162
21506,Miyu,1,Private room,118,24,0.63,142
21507,Dylana,2,Private room,43,84,3.02,127
21508,Cem,3,Entire home/apt,100,0,0.17,100
21509,Bev,2,Private room,45,110,2.4,155
21510,Katie,2,Entire home/apt,199,94,1.32,293
21511,Hope,2,Entire home/apt,146,341,3.78,487
21512,Aryn,1,Entire home/apt,239,42,0.65,281
21513,Sharon,1,Entire home/apt,195,34,0.19,229
21514,Mika,3,Entire home/apt,100,0,0.04,100
21515,Kelsey,2,Entire home/apt,103,0,0.45,103
21516,Natalie,1,Entire home/apt,159,33,0.57,192
21517,Danielle,3,Private room,48,338,14.36,386
21518,Mario,1,Entire home/apt,190,32,0.5,222
21519,Mada,3,Private room,80,92,0.62,172
21520,Dan,3,Private room,96,364,0.62,460
21521,Shimin,2,Private room,28,1,1.08,29
21522,Élodie,1,Entire home/apt,160,0,0.75,160
21523,Shimin,2,Private room,30,168,1.64,198
21524,Kabak,3,Private room,50,347,1.17,397
21526,Mabel,2,Private room,85,289,0.58,374
21527,Aron,3,Entire home/apt,60,0,0.1,60
21528,Yaacov,1,Entire home/apt,190,299,0.21,489
21529,Yaacov,1,Entire home/apt,180,331,0.55,511
21530,Yaacov,1,Entire home/apt,235,333,0.39,568
21531,Adel,1,Entire home/apt,175,8,0.23,183
21532,Brian,2,Entire home/apt,160,3,0.59,163
21533,Adi And Evangel,1,Private room,145,329,0.88,474
21534,Daniella,2,Shared room,37,0,0.31,37
21535,Wilson,1,Entire home/apt,140,1,1.14,141
21536,Eric,2,Private room,45,0,0.63,45
21537,Auset,2,Private room,52,294,0.17,346
21538,Genae,4,Private room,40,239,0.42,279
21539,Jeremy,2,Entire home/apt,100,100,2.66,200
21540,Tyler,3,Private room,40,0,0.03,40
21541,Taylor,1,Private room,74,0,1.01,74
21542,Sunshine,2,Entire home/apt,62,23,3.4,85
21543,Carolyn Li Ming,1,Entire home/apt,150,7,0.21,157
21544,Rebecca,2,Entire home/apt,100,0,0.33,100
21545,James,1,Private room,49,0,0.4,49
21547,Arianna,1,Entire home/apt,200,0,0.07,200
21548,Yuval,2,Private room,45,51,2.54,96
21549,Shelley,2,Private room,75,52,7.71,127
21552,Paul,5,Entire home/apt,180,135,2.21,315
21553,Jose Luis,1,Entire home/apt,355,89,0.49,444
21555,Dan,3,Entire home/apt,275,283,1.21,558
21556,John,2,Private room,49,360,0.7,409
21557,René,1,Private room,58,1,2.35,59
21558,Amy,2,Entire home/apt,179,211,3.53,390
21559,Sheila,3,Entire home/apt,95,253,9.66,348
21560,Sam,1,Entire home/apt,158,0,0.18,158
21561,Estie,2,Entire home/apt,165,182,0.83,347
21562,Estie,2,Entire home/apt,169,175,1.15,344
21563,Gyaltsen Benita,2,Entire home/apt,135,0,0.64,135
21565,Mel,2,Entire home/apt,85,0,1.22,85
21566,Robert,2,Private room,53,14,2.68,67
21567,Marc,1,Entire home/apt,185,23,0.71,208
21568,Kay,1,Entire home/apt,260,131,2.36,391
21569,Leslie,2,Entire home/apt,160,101,3.35,261
21570,Patrick,2,Entire home/apt,100,4,0.2,104
21571,Jennifer,2,Entire home/apt,240,302,0.57,542
21572,Haydee,1,Entire home/apt,300,115,0.12,415
21573,Jackie,1,Entire home/apt,250,185,2.46,435
21574,Polly,1,Private room,60,0,0.05,60
21576,Chang,3,Private room,69,65,4.26,134
21577,Fernando,2,Entire home/apt,75,15,0.58,90
21579,Anna,1,Entire home/apt,150,0,1.03,150
21580,Mitsue,1,Private room,60,341,0.21,401
21581,Marcella & Saidat,2,Private room,80,191,6.17,271
21582,Sam,1,Private room,110,45,0.24,155
21583,Alejandro,1,Entire home/apt,160,0,0.04,160
21584,Monica & Robin,2,Private room,65,294,0.44,359
21585,Anna Marie,2,Private room,72,0,0.03,72
21587,Kimberly,2,Entire home/apt,175,4,0.54,179
21588,Jay,2,Private room,80,8,1.86,88
21589,Cesar,1,Private room,150,39,3.09,189
21590,Teresa,2,Entire home/apt,144,14,1.43,158
21592,Banu,1,Private room,95,0,0.07,95
21593,Ria,1,Private room,100,0,0.56,100
21594,Cely,2,Private room,56,18,1.23,74
21595,Gaia,3,Entire home/apt,150,3,0.42,153
21596,Graham And Ben,2,Private room,95,311,0.14,406
21597,Graham And Ben,2,Private room,95,231,0.22,326
21598,Marcella & Saidat,2,Private room,70,202,6.03,272
21600,Thea,2,Private room,60,0,0.03,60
21601,Marija,2,Entire home/apt,170,1,0.29,171
21605,Jj,1,Entire home/apt,200,249,2.55,449
21606,Jesse,1,Entire home/apt,175,0,0.14,175
21607,June,2,Private room,45,17,0.65,62
21608,BeautifulHarlem,1,Entire home/apt,175,127,5.0,302
21609,Irisha,3,Entire home/apt,90,358,0.9,448
21610,Paige,2,Private room,78,345,2.01,423
21611,Blessing,2,Entire home/apt,100,39,0.98,139
21612,Annie,1,Entire home/apt,175,0,1.22,175
21613,Faye,1,Private room,99,0,0.08,99
21615,Palma,1,Entire home/apt,250,51,1.03,301
21616,Dane,1,Private room,91,0,0.05,91
21617,Cat,2,Entire home/apt,200,270,2.29,470
21618,Izabel,2,Private room,40,222,4.21,262
21619,Kareem,1,Private room,75,133,0.07,208
21620,Sen,3,Private room,50,129,2.98,179
21621,Michelle,2,Entire home/apt,110,216,4.03,326
21622,Shane,1,Private room,69,1,1.17,70
21623,Daniel,1,Private room,103,79,2.73,182
21624,Phuong,2,Entire home/apt,100,28,3.72,128
21625,Shane,1,Private room,73,228,1.45,301
21626,Diana,3,Entire home/apt,180,175,2.64,355
21627,Christopher,1,Entire home/apt,79,0,0.14,79
21629,Adisson,3,Entire home/apt,99,247,1.7,346
21630,Daniel,1,Private room,100,99,2.37,199
21631,Cris,2,Entire home/apt,125,239,0.36,364
21632,Johanna,2,Entire home/apt,149,0,0.04,149
21633,Wenli,1,Entire home/apt,58,0,0.32,58
21634,Rachel,2,Private room,75,0,0.11,75
21637,Peggy,1,Entire home/apt,250,163,2.44,413
21638,Francesco,1,Entire home/apt,160,136,1.08,296
21639,Nicolle,1,Private room,70,0,1.24,70
21640,Ivan,1,Private room,289,252,4.52,541
21641,Aurelien,2,Private room,29,0,2.02,29
21642,Amílcar,4,Private room,75,134,4.45,209
21643,Francisca,3,Private room,35,124,2.12,159
21644,Maria,1,Private room,82,292,5.08,374
21645,Francisca,3,Private room,35,124,1.52,159
21646,Allegra,2,Private room,70,120,0.47,190
21647,Brad,1,Private room,75,0,0.1,75
21648,Nina & Keith,2,Entire home/apt,120,61,4.51,181
21649,Cacho,2,Private room,200,0,0.18,200
21650,Bradford,2,Private room,65,104,2.4,169
21651,Trendi,1,Entire home/apt,178,74,2.92,252
21652,Robinette,2,Entire home/apt,45,0,0.1,45
21654,Marco,2,Private room,99,141,1.62,240
21655,Eric,1,Entire home/apt,325,180,0.09,505
21656,Annabelle,1,Entire home/apt,209,0,0.08,209
21657,David,3,Entire home/apt,249,353,0.29,602
21658,Vinit,1,Entire home/apt,600,251,3.38,851
21660,Inna,1,Entire home/apt,135,200,0.21,335
21661,Dine,5,Entire home/apt,65,147,3.42,212
21663,Faith,2,Entire home/apt,99,17,2.06,116
21664,Luiza,3,Private room,47,31,0.83,78
21666,Cassia,1,Private room,250,167,1.18,417
21667,Michael,2,Entire home/apt,90,0,0.07,90
21668,Helen,2,Private room,53,173,0.27,226
21669,Mariano,1,Private room,120,304,1.33,424
21670,Pearl,2,Private room,54,8,2.3,62
21671,Leyla,1,Entire home/apt,125,4,1.08,129
21672,Jacob,1,Entire home/apt,126,0,1.12,126
21673,Rachel,3,Private room,50,190,0.39,240
21674,Camilo,1,Entire home/apt,110,0,0.11,110
21676,Leo & Family,3,Private room,49,355,0.09,404
21677,Doretha,2,Entire home/apt,98,359,0.93,457
21678,Diana,2,Entire home/apt,289,0,0.26,289
21679,Varos,3,Private room,110,47,1.41,157
21680,Kelly,2,Private room,45,0,0.18,45
21681,Cordelia,3,Entire home/apt,169,263,2.33,432
21682,Estie,2,Entire home/apt,275,271,0.96,546
21683,Esther,2,Private room,50,43,0.57,93
21684,Ula,2,Private room,36,0,1.31,36
21685,Cathy,2,Entire home/apt,110,342,1.65,452
21686,Nick,1,Private room,105,9,1.14,114
21687,Susan,1,Entire home/apt,75,166,2.64,241
21688,Yessenia,3,Entire home/apt,100,0,1.42,100
21689,Zandelle,2,Private room,75,54,0.95,129
21690,Berat,3,Private room,30,361,2.17,391
21692,Deborah,1,Entire home/apt,155,62,1.06,217
21693,Josh,2,Private room,68,87,0.39,155
21694,Feather Factory Hotel,3,Private room,109,364,1.23,473
21695,Daniel,2,Private room,20,277,0.11,297
21696,Shabari,2,Entire home/apt,88,0,0.39,88
21697,Diane,1,Private room,500,361,0.62,861
21698,Krzysztof,2,Entire home/apt,80,156,0.22,236
21699,Corley,2,Private room,100,0,0.03,100
21701,Laetitia,1,Private room,55,293,0.28,348
21704,Liza,2,Entire home/apt,75,1,5.7,76
21705,Izi,1,Entire home/apt,184,346,0.12,530
21706,Gary,2,Private room,56,0,0.14,56
21707,David,2,Entire home/apt,160,43,0.12,203
21708,Chelsea,1,Private room,65,89,0.04,154
21709,Antonio,3,Private room,77,332,1.72,409
21710,Juan Pablo,1,Private room,65,0,0.07,65
21711,Sucharita,2,Private room,35,0,0.07,35
21712,Maggie,1,Private room,98,8,0.15,106
21713,Eldad,1,Entire home/apt,400,108,0.19,508
21714,Bart,2,Private room,64,6,0.57,70
21715,Michael,2,Private room,70,35,1.05,105
21716,Michael,1,Entire home/apt,250,0,0.07,250
21717,Rachel,3,Private room,55,300,0.09,355
21718,Stephen,1,Entire home/apt,249,0,0.08,249
21719,Kyle,1,Private room,175,0,0.11,175
21720,Sahar,2,Private room,69,42,2.14,111
21721,Jing,1,Entire home/apt,198,127,0.35,325
21722,Lin,1,Entire home/apt,69,11,2.38,80
21723,Fiz,2,Private room,60,0,1.15,60
21724,Nina,1,Entire home/apt,103,0,0.42,103
21725,BeautifulHarlem,1,Entire home/apt,135,45,4.83,180
21726,Sophie,3,Private room,31,13,2.7,44
21727,Kelly,2,Entire home/apt,245,60,1.19,305
21729,Eric,1,Entire home/apt,200,271,0.21,471
21730,Anna,1,Private room,72,251,4.69,323
21731,Michael,1,Entire home/apt,123,0,0.11,123
21732,Mauro,2,Private room,90,0,0.11,90
21733,Jonathan,4,Shared room,20,5,4.09,25
21734,Jessica,5,Private room,50,0,0.42,50
21735,Jose,2,Private room,45,297,0.72,342
21736,Fred,2,Private room,41,0,0.42,41
21737,Jose,2,Private room,75,325,0.56,400
21738,Lawrence,2,Entire home/apt,105,89,4.16,194
21739,Mackenzie,2,Private room,55,0,0.07,55
21740,Sarah,2,Private room,100,0,2.95,100
21741,Sarah,2,Private room,65,0,0.49,65
21742,Jairo,3,Entire home/apt,149,242,1.9,391
21743,Christina,1,Private room,50,0,1.11,50
21744,Haifa,1,Private room,78,166,0.21,244
21745,Erroyl,3,Entire home/apt,75,294,2.66,369
21750,Maria,1,Private room,133,33,1.39,166
21751,Matt,2,Entire home/apt,150,32,4.26,182
21752,John,2,Entire home/apt,140,54,2.95,194
21753,Mat,1,Entire home/apt,200,338,0.11,538
21754,Pilar,1,Entire home/apt,99,167,0.08,266
21756,Ken,1,Entire home/apt,122,0,0.27,122
21757,Betina,1,Private room,85,60,2.54,145
21758,Lou,2,Private room,45,84,1.29,129
21760,Iris,3,Private room,31,0,1.3,31
21761,Jill,1,Entire home/apt,125,0,0.57,125
21762,Eileen,1,Entire home/apt,100,48,2.3,148
21763,Steven,2,Private room,60,0,0.63,60
21764,Pierre,1,Entire home/apt,80,8,0.43,88
21765,Dena,1,Entire home/apt,150,0,0.23,150
21766,Ahmed,2,Entire home/apt,160,313,0.42,473
21767,Avon,2,Entire home/apt,59,240,3.5,299
21768,Shirley,2,Shared room,30,1,1.25,31
21769,Grace,1,Entire home/apt,85,0,0.08,85
21772,Kyle,1,Entire home/apt,199,365,0.23,564
21773,Alexandra,1,Shared room,35,33,0.95,68
21774,Jose,2,Private room,70,303,1.01,373
21776,Kyle,1,Entire home/apt,169,115,0.04,284
21782,Nina,1,Entire home/apt,115,203,0.31,318
21783,Nina,1,Entire home/apt,150,339,0.22,489
21784,Kyle,1,Entire home/apt,150,365,0.04,515
21785,Nina,1,Entire home/apt,155,332,0.11,487
21786,Gaël-Etienne,2,Entire home/apt,68,0,0.78,68
21788,Ian,1,Private room,300,0,0.04,300
21790,Jamiel,3,Entire home/apt,75,273,2.75,348
21791,Diane,2,Entire home/apt,350,303,1.0,653
21792,Sharon And Dave,2,Entire home/apt,150,89,2.58,239
21793,Alonso,1,Entire home/apt,155,189,2.45,344
21794,Kian,2,Private room,81,63,1.58,144
21795,Yaodong,1,Private room,100,0,0.17,100
21796,Sergio,1,Entire home/apt,185,331,0.26,516
21797,Hao,3,Private room,65,365,0.4,430
21798,Mike,2,Entire home/apt,385,209,2.69,594
21800,Daniel,2,Entire home/apt,130,0,0.07,130
21801,Cameron & Dione,2,Private room,153,11,1.0,164
21802,Ruishu,1,Private room,150,0,0.37,150
21803,Zack,1,Private room,95,0,0.08,95
21804,Sharron And Lenny,1,Entire home/apt,150,0,0.36,150
21805,Evolve,2,Entire home/apt,350,0,0.04,350
21806,Evan & Erika,2,Entire home/apt,120,159,5.23,279
21807,Brenton,1,Entire home/apt,120,13,0.27,133
21808,Danielle,1,Private room,100,0,0.32,100
21809,Vernon,4,Private room,45,186,0.36,231
21810,Susan,1,Private room,74,0,0.28,74
21811,Nicholas,1,Private room,110,0,0.91,110
21812,Serena,3,Entire home/apt,110,174,3.07,284
21813,Ana,1,Private room,75,0,0.73,75
21814,Dmitri,2,Entire home/apt,94,0,0.39,94
21815,Anima,1,Private room,55,0,0.07,55
21817,Imad,1,Private room,99,145,5.42,244
21818,Carol,1,Private room,69,43,1.08,112
21820,Kim,2,Private room,42,72,1.14,114
21822,Niko,2,Private room,55,0,0.11,55
21823,Melissa,1,Private room,119,0,0.16,119
21824,Olga,1,Entire home/apt,105,20,0.85,125
21825,Cameron,2,Private room,55,19,0.76,74
21827,Blair,1,Private room,46,0,0.04,46
21828,Stephany,2,Private room,36,155,2.95,191
21829,Maura,2,Private room,45,0,0.44,45
21830,Andrew,1,Entire home/apt,150,90,0.22,240
21831,Steven,1,Entire home/apt,275,207,3.17,482
21833,Amelia,1,Private room,100,0,0.11,100
21834,Mohamed,1,Shared room,35,0,4.21,35
21835,Mohamed,1,Shared room,35,0,4.06,35
21836,Nance,4,Entire home/apt,130,36,2.19,166
21837,Ebada,2,Entire home/apt,150,312,1.9,462
21838,Anna,1,Private room,73,238,4.07,311
21839,Reggie,2,Entire home/apt,160,0,0.33,160
21840,Connie,2,Private room,54,0,0.04,54
21841,Laura,1,Private room,75,0,0.07,75
21842,Jenia,1,Entire home/apt,380,0,0.04,380
21843,Anelcia Carolle,2,Entire home/apt,115,0,3.68,115
21844,Elliott,2,Private room,100,0,0.43,100
21845,Sneha,1,Private room,80,0,0.11,80
21846,Chris,2,Entire home/apt,109,37,2.64,146
21847,Kathleen,5,Entire home/apt,180,136,4.81,316
21848,Christy,2,Entire home/apt,600,42,0.36,642
21849,Orin,1,Private room,160,0,0.54,160
21850,Amy,1,Entire home/apt,130,216,0.08,346
21851,Louizos Alexandros,1,Private room,90,0,0.42,90
21852,Nicole,1,Private room,63,0,0.75,63
21853,Kilian,2,Entire home/apt,126,0,0.22,126
21854,Gregor,1,Entire home/apt,195,0,0.59,195
21855,Izabel,2,Private room,45,243,3.8,288
21856,Maya,2,Private room,47,0,0.97,47
21858,Sharon,2,Entire home/apt,200,0,0.04,200
21861,Gordon,1,Entire home/apt,160,71,0.4,231
21862,Edith,2,Private room,55,0,0.88,55
21863,Henrik,1,Entire home/apt,110,0,0.39,110
21864,Yolanda,1,Entire home/apt,200,327,0.27,527
21865,Stephany,2,Entire home/apt,109,140,2.55,249
21866,Omar And Kareema,2,Entire home/apt,149,170,2.51,319
21867,Analisa,1,Entire home/apt,220,14,0.65,234
21869,Alex,1,Private room,75,0,0.11,75
21871,Brittney,3,Entire home/apt,65,104,0.7,169
21872,Blondine,2,Entire home/apt,300,136,0.33,436
21873,Silvia,2,Entire home/apt,90,343,2.51,433
21874,Julie,2,Private room,69,189,0.44,258
21875,Ciprian,4,Private room,79,71,4.1,150
21876,Jill & Kerry,1,Entire home/apt,190,252,5.17,442
21877,Max,1,Private room,80,0,0.04,80
21878,Jim,2,Entire home/apt,175,0,0.07,175
21879,Yvonne,3,Private room,65,159,13.48,224
21881,Emma,1,Private room,63,0,0.36,63
21882,Laura And Robert,1,Private room,99,0,0.42,99
21884,Anna,1,Entire home/apt,250,42,0.9,292
21885,Jillian,1,Private room,90,0,0.11,90
21886,Anna,2,Entire home/apt,120,85,4.2,205
21887,Steven,3,Entire home/apt,39,3,4.04,42
21888,Pioneer,2,Entire home/apt,117,324,0.47,441
21889,Emmie,2,Private room,160,303,1.62,463
21891,Harry,1,Entire home/apt,100,0,0.21,100
21892,Lisa,1,Entire home/apt,117,332,0.56,449
21893,Vlad,1,Private room,175,357,2.3,532
21894,Wendell,1,Shared room,25,0,0.32,25
21895,Madeline,2,Entire home/apt,152,0,0.5,152
21896,Noor,2,Private room,45,0,0.4,45
21897,Julio,2,Private room,59,325,0.93,384
21898,Domenica,1,Private room,70,0,0.11,70
21899,Julio,2,Private room,57,337,0.84,394
21900,Alvin,2,Entire home/apt,200,88,2.97,288
21902,Kevin,3,Private room,45,345,11.91,390
21903,Julio,2,Private room,61,350,1.14,411
21904,Luis,2,Private room,55,121,3.66,176
21905,Catherine,2,Private room,74,0,0.15,74
21906,Teri,1,Private room,100,0,0.04,100
21907,Carmen,1,Entire home/apt,178,212,5.28,390
21908,Yvonne,3,Private room,80,180,5.19,260
21909,Olivera,3,Entire home/apt,75,45,0.22,120
21910,Julian,1,Entire home/apt,158,62,2.21,220
21911,Jonathan,2,Entire home/apt,88,0,2.35,88
21912,Sam,2,Entire home/apt,95,0,0.11,95
21913,Marta,1,Entire home/apt,225,234,2.27,459
21914,Jae,2,Entire home/apt,240,66,0.62,306
21915,Steve Kings,3,Entire home/apt,110,299,2.47,409
21916,Cat,1,Entire home/apt,225,0,0.43,225
21918,Miralva,2,Entire home/apt,140,161,1.09,301
21919,Mo,2,Entire home/apt,100,0,1.34,100
21920,Hallie,2,Private room,39,0,0.07,39
21921,Albertina,3,Entire home/apt,110,16,0.37,126
21922,Tina,2,Entire home/apt,105,41,0.07,146
21923,David,1,Private room,49,99,0.3,148
21924,Miranda,3,Private room,45,0,0.32,45
21925,Ed,2,Entire home/apt,450,364,0.42,814
21926,Ed,2,Entire home/apt,99,125,2.51,224
21927,Brandon,1,Entire home/apt,169,0,0.81,169
21928,Arturo,1,Entire home/apt,130,0,0.14,130
21929,Dina,1,Entire home/apt,255,194,3.21,449
21930,Martine,1,Private room,80,0,0.11,80
21931,Colette,2,Private room,70,0,0.11,70
21933,Melissa,1,Entire home/apt,219,0,0.18,219
21934,Erik,2,Private room,60,117,3.14,177
21935,Jackie,2,Private room,60,0,0.16,60
21937,Luna,1,Entire home/apt,122,15,0.87,137
21939,Ebony,2,Private room,44,3,1.78,47
21940,Arthur,3,Entire home/apt,125,278,2.58,403
21941,Cristina,3,Private room,55,0,0.91,55
21942,Petra,2,Private room,47,0,1.28,47
21943,Russell,2,Private room,80,120,2.08,200
21944,Christine,3,Private room,65,148,1.51,213
21945,Lunara,3,Private room,75,112,0.61,187
21948,Emma,2,Private room,45,0,0.57,45
21950,Jose,2,Private room,69,229,0.61,298
21951,Max,1,Entire home/apt,199,147,1.81,346
21952,Sonia,3,Private room,55,361,8.58,416
21953,Linelle,3,Private room,50,324,2.84,374
21954,Paul,1,Private room,125,0,0.14,125
21955,Diana,1,Entire home/apt,2250,343,0.74,2593
21956,Nyls,2,Entire home/apt,125,178,0.16,303
21958,Austin,2,Private room,32,0,0.11,32
21959,Natasha,2,Private room,88,0,0.55,88
21960,Elle,1,Entire home/apt,215,31,1.4,246
21961,Harry,1,Entire home/apt,134,0,2.96,134
21962,Jamal,2,Entire home/apt,125,268,3.69,393
21964,Zhoe,1,Private room,60,323,3.65,383
21965,Mariam,2,Private room,56,0,0.44,56
21966,Trey,2,Private room,85,0,0.72,85
21967,Michael,2,Entire home/apt,100,235,3.12,335
21969,Stanley,1,Entire home/apt,150,238,0.85,388
21970,Suzanne,1,Private room,60,340,0.09,400
21971,Jose,2,Entire home/apt,108,332,0.66,440
21972,Vinz,2,Entire home/apt,122,217,2.11,339
21973,Steven,3,Entire home/apt,45,2,5.03,47
21974,Ceylan,2,Entire home/apt,150,0,0.08,150
21975,Savannah,2,Entire home/apt,160,0,1.61,160
21976,Michael,2,Entire home/apt,140,8,0.05,148
21977,Mark,2,Entire home/apt,210,9,2.8,219
21978,Ashley,1,Entire home/apt,180,365,0.07,545
21979,Simone,3,Private room,80,365,5.74,445
21980,Andrea,1,Private room,79,160,2.59,239
21981,Malik,2,Entire home/apt,180,0,0.07,180
21982,Tim,2,Entire home/apt,190,82,0.36,272
21984,Marine,1,Entire home/apt,139,0,2.79,139
21985,Ginevra,2,Entire home/apt,163,192,0.43,355
21987,Scott,1,Entire home/apt,365,0,0.26,365
21988,Nicholas,3,Entire home/apt,200,77,1.55,277
21989,Michael,2,Entire home/apt,84,0,1.1,84
21990,Leo,3,Private room,58,300,3.74,358
21991,Dmitry,2,Private room,42,0,1.26,42
21992,Erin,2,Entire home/apt,90,248,2.75,338
21994,Kamilya,2,Private room,75,188,0.32,263
21995,Lendy,1,Private room,86,342,0.11,428
21996,Tyler,1,Entire home/apt,251,0,0.43,251
21997,Kyla,2,Entire home/apt,85,98,0.23,183
21998,Grace,2,Entire home/apt,285,15,0.68,300
21999,Genee,1,Entire home/apt,325,0,0.18,325
22000,Kate,1,Entire home/apt,220,47,0.33,267
22002,Leo,3,Private room,58,281,2.66,339
22003,Leo,3,Private room,58,301,3.09,359
22004,Nick,2,Private room,50,37,0.62,87
22005,Angelica And Prescott,2,Entire home/apt,145,18,2.01,163
22007,Gio,1,Private room,126,148,4.28,274
22008,Vladimir,1,Entire home/apt,230,4,1.33,234
22009,Gio,1,Private room,129,155,4.2,284
22010,Gio,1,Private room,119,147,4.34,266
22011,Kevin,3,Private room,50,365,6.15,415
22012,Tomas,2,Entire home/apt,100,0,0.11,100
22013,Mike,2,Entire home/apt,199,0,1.25,199
22014,Sara,2,Private room,65,144,5.0,209
22015,Mike,1,Private room,50,83,0.33,133
22016,Cara,2,Private room,65,0,1.83,65
22017,Kelly,1,Entire home/apt,200,0,0.07,200
22018,Lola,1,Private room,150,287,2.85,437
22019,Autumn,2,Private room,50,0,0.21,50
22020,Atherly,2,Private room,90,363,1.64,453
22021,Joe,2,Entire home/apt,180,0,0.1,180
22022,Shelley,2,Private room,50,6,0.22,56
22024,Mirco,5,Entire home/apt,122,219,2.0,341
22025,Christina,2,Entire home/apt,225,88,0.07,313
22026,Jimmy &Cindy,3,Private room,51,355,4.63,406
22027,Mathew,2,Entire home/apt,90,0,0.14,90
22028,Albert,2,Private room,79,0,0.08,79
22029,Petra,2,Entire home/apt,275,23,2.42,298
22031,Alexi,1,Private room,100,0,0.94,100
22032,Bob,1,Entire home/apt,199,37,3.01,236
22033,Zoe,1,Private room,75,0,0.28,75
22034,Michelle Curran,2,Entire home/apt,145,271,0.95,416
22035,Gretchen,2,Entire home/apt,161,270,1.65,431
22036,Emma,2,Private room,45,0,0.51,45
22037,Thai,4,Private room,43,104,0.69,147
22039,Em,2,Entire home/apt,95,13,0.78,108
22040,Yoko,3,Private room,60,67,1.46,127
22042,Svetlana,2,Entire home/apt,180,334,1.68,514
22043,Lola,1,Entire home/apt,150,11,0.3,161
22044,Kevin,5,Private room,49,276,1.62,325
22045,Kevin,5,Private room,49,315,1.14,364
22046,Kevin,1,Entire home/apt,249,63,0.84,312
22047,Thuy,2,Private room,70,0,1.81,70
22048,Arthur,2,Private room,60,0,0.12,60
22049,Christine,3,Private room,49,96,1.07,145
22050,Christine & Einstein,3,Private room,22,0,2.1,22
22051,Anna,2,Shared room,50,1,0.05,51
22052,Elena,1,Entire home/apt,105,187,4.29,292
22053,Brooklyn,1,Private room,89,157,1.76,246
22054,Ebada,2,Entire home/apt,115,295,0.48,410
22055,Federico,1,Private room,65,0,0.64,65
22056,Nikolas,3,Private room,65,9,3.24,74
22058,Max,1,Private room,99,179,0.15,278
22059,Alexandra,2,Private room,83,192,1.69,275
22060,Sean,2,Private room,45,44,3.53,89
22062,Sonia,3,Private room,55,322,10.6,377
22063,Kara,2,Entire home/apt,100,353,0.96,453
22065,Ashek,1,Private room,89,113,0.07,202
22066,Mabel,2,Private room,37,0,0.04,37
22067,Beth,3,Private room,60,0,0.05,60
22068,Danielle,3,Shared room,38,80,7.96,118
22069,Sasha,1,Entire home/apt,800,0,0.69,800
22070,Kathleen,1,Entire home/apt,325,177,0.41,502
22071,Pamela,2,Private room,89,358,2.77,447
22072,Isaiah,1,Shared room,68,0,0.18,68
22073,John,1,Entire home/apt,700,72,0.09,772
22074,Lindsay,2,Entire home/apt,210,170,1.56,380
22075,Charles,2,Entire home/apt,150,48,0.2,198
22077,Marilyn,1,Private room,103,208,5.12,311
22078,Luca,2,Private room,45,0,0.08,45
22079,Marilyn,1,Private room,90,237,4.04,327
22080,JoAnn,1,Entire home/apt,227,0,0.95,227
22081,Todd,2,Entire home/apt,100,0,0.04,100
22082,Mark,5,Entire home/apt,75,173,4.31,248
22083,Roxanne,1,Entire home/apt,97,0,0.14,97
22084,Christine,3,Private room,50,145,1.29,195
22085,Christine,3,Private room,60,169,1.1,229
22086,Chelsea,2,Private room,50,157,0.26,207
22087,Ann,3,Entire home/apt,229,265,0.8,494
22088,Masha,1,Entire home/apt,150,0,0.87,150
22089,Anthony,2,Private room,50,342,0.13,392
22090,Ketty,5,Entire home/apt,95,0,2.06,95
22091,Michael,1,Private room,62,0,0.11,62
22092,Lucia,1,Entire home/apt,115,156,5.78,271
22093,Norberto & Lana,3,Private room,55,5,2.18,60
22094,Corinne,2,Entire home/apt,90,8,0.35,98
22095,Kathy,1,Private room,30,0,0.25,30
22097,Luke & Madia,2,Private room,71,364,2.61,435
22098,Luke & Madia,2,Private room,70,362,2.11,432
22099,Lucia,1,Entire home/apt,115,1,4.81,116
22100,Deloris,3,Private room,65,0,11.72,65
22101,Melissa,3,Entire home/apt,120,133,4.07,253
22102,Molly,2,Private room,100,0,0.07,100
22103,Olzhas,2,Private room,59,34,6.65,93
22104,Deloris,3,Private room,65,0,13.24,65
22105,Carrie,1,Private room,89,0,2.02,89
22107,Yvonne,3,Private room,80,180,7.0,260
22108,Juhea,1,Entire home/apt,127,0,0.04,127
22110,Rosemary,2,Entire home/apt,170,180,1.14,350
22111,Rosemarie,1,Private room,120,40,2.54,160
22112,Erica,2,Private room,44,365,1.11,409
22113,Daniel,3,Private room,71,173,3.66,244
22114,Andreas,2,Private room,150,117,2.36,267
22116,Kerstin,3,Private room,53,0,0.55,53
22117,Diamond,2,Private room,100,269,0.09,369
22118,Jenna,2,Entire home/apt,175,0,0.18,175
22119,Christianne,1,Entire home/apt,170,111,0.36,281
22121,Luz,3,Private room,51,306,3.91,357
22122,Kelli,1,Entire home/apt,95,0,3.72,95
22123,Nico,2,Entire home/apt,94,74,1.87,168
22124,Maura,2,Private room,69,305,0.78,374
22125,Natasha,1,Private room,105,0,0.3,105
22126,Alejo,1,Entire home/apt,79,0,0.04,79
22128,Nick,2,Private room,40,67,0.93,107
22129,TaSh,1,Private room,62,0,0.77,62
22130,E,1,Entire home/apt,110,272,1.17,382
22131,Lauren,1,Entire home/apt,185,22,0.81,207
22132,John,1,Entire home/apt,177,267,4.8,444
22133,Danielle,2,Entire home/apt,110,0,0.3,110
22135,Cinthya,1,Private room,80,28,3.06,108
22136,Sandra,3,Private room,53,5,1.76,58
22137,Ludvig,2,Private room,95,0,0.18,95
22138,Kara,1,Entire home/apt,115,336,0.05,451
22140,Krysia,1,Entire home/apt,130,0,0.19,130
22141,Sean,1,Private room,79,0,0.04,79
22142,Carri,2,Entire home/apt,107,0,0.18,107
22143,Matthew,2,Entire home/apt,116,0,0.32,116
22144,Karly,2,Private room,47,0,0.2,47
22145,Caitlin,1,Private room,100,27,2.39,127
22146,Silvia,2,Private room,75,360,2.61,435
22147,Jason,2,Entire home/apt,160,0,0.37,160
22148,Kate,2,Entire home/apt,275,96,0.26,371
22149,Gabriel,2,Private room,22,0,0.08,22
22150,Anna,2,Private room,60,1,0.07,61
22151,Marcy,1,Entire home/apt,70,0,0.44,70
22152,Jim,2,Private room,100,179,0.23,279
22154,Shah Memo,1,Private room,64,98,0.29,162
22155,Markus,1,Private room,47,0,0.16,47
22156,Jaime,1,Entire home/apt,250,0,0.07,250
22157,Florent,2,Entire home/apt,190,198,0.31,388
22158,Yerddy,4,Entire home/apt,99,86,4.35,185
22159,Assane,2,Private room,88,82,0.33,170
22161,Ronnie,1,Private room,250,17,0.42,267
22162,Caitlin,1,Entire home/apt,250,264,0.32,514
22163,John,2,Entire home/apt,150,0,0.95,150
22164,Matthew,1,Entire home/apt,484,46,3.95,530
22165,Martha,2,Private room,50,0,0.71,50
22166,Phil,1,Entire home/apt,141,0,0.44,141
22167,Terry,1,Entire home/apt,199,263,2.65,462
22168,Adam,1,Entire home/apt,140,0,0.14,140
22169,Anselmo,1,Private room,79,218,3.17,297
22170,Jeanette,2,Entire home/apt,142,0,0.11,142
22171,Viona,2,Private room,80,0,0.11,80
22173,Julia,4,Private room,47,339,1.58,386
22174,Anna,2,Private room,65,0,0.04,65
22175,Narina,1,Entire home/apt,149,268,2.92,417
22176,Elana,2,Entire home/apt,300,0,0.12,300
22177,Anastasia,2,Private room,159,363,0.19,522
22178,Shahar,2,Private room,60,6,0.34,66
22179,Divina,2,Private room,50,0,0.07,50
22180,Heidi,1,Entire home/apt,220,225,3.92,445
22182,Janessa,2,Private room,99,82,0.52,181
22183,Daniela,2,Entire home/apt,120,3,1.28,123
22184,Sonia,1,Entire home/apt,110,221,0.36,331
22185,Low,3,Private room,50,0,0.5,50
22186,Lisa,3,Private room,30,341,0.08,371
22187,Eve,2,Private room,60,175,0.96,235
22188,Ed,2,Entire home/apt,110,144,2.13,254
22189,Ali,1,Private room,75,280,0.4,355
22190,Terry,2,Entire home/apt,100,45,0.42,145
22191,Christopher,1,Private room,65,0,2.93,65
22192,Michael,1,Private room,125,329,0.77,454
22193,Miranda,2,Private room,40,316,3.04,356
22194,Yahaira,4,Entire home/apt,105,87,2.67,192
22195,Katharine,2,Entire home/apt,115,0,0.22,115
22196,Rosemary,2,Entire home/apt,75,363,1.38,438
22197,Pablo,1,Private room,429,288,4.33,717
22198,Zain,4,Shared room,60,365,0.52,425
22199,Calia,2,Private room,30,0,0.11,30
22200,Maria,2,Private room,84,24,0.26,108
22201,Randy,1,Private room,75,68,2.21,143
22202,Layla,2,Private room,50,7,1.06,57
22203,Shahana,2,Private room,39,220,2.99,259
22204,Jacqueline,2,Entire home/apt,160,243,2.4,403
22205,Dorothy,2,Entire home/apt,175,20,2.67,195
22206,Jimmy &Cindy,3,Private room,47,172,3.4,219
22208,Saori,2,Private room,29,0,0.11,29
22209,Chris,1,Private room,95,86,2.39,181
22211,Trevor,3,Entire home/apt,145,173,2.15,318
22213,Brian,1,Entire home/apt,250,0,0.04,250
22214,Lynda,1,Private room,38,0,0.09,38
22215,Giani,3,Private room,65,309,0.99,374
22216,Sean,4,Entire home/apt,150,179,1.57,329
22217,Remy,2,Entire home/apt,139,20,1.25,159
22218,Anabella,1,Entire home/apt,127,0,0.11,127
22219,Aris,2,Entire home/apt,290,0,0.07,290
22220,Christina,1,Private room,100,0,0.18,100
22221,Sam,1,Private room,100,43,8.07,143
22223,Sofia,2,Private room,65,0,0.15,65
22224,Cari,1,Entire home/apt,200,49,1.66,249
22225,Karl,3,Entire home/apt,100,89,1.06,189
22226,Paul,2,Entire home/apt,148,0,1.44,148
22227,Peter,2,Entire home/apt,160,80,4.18,240
22228,Kristen,1,Entire home/apt,147,7,0.47,154
22230,Maxyne,2,Entire home/apt,130,0,0.12,130
22231,Lily,1,Entire home/apt,157,18,0.49,175
22232,Irving,1,Private room,95,0,1.04,95
22233,Duncan,2,Entire home/apt,120,1,0.31,121
22234,Amy,1,Entire home/apt,110,161,0.38,271
22235,Elsa,1,Entire home/apt,130,363,1.58,493
22237,Hind,3,Entire home/apt,90,237,2.7,327
22238,Gf,2,Private room,138,37,0.48,175
22239,Lynn,1,Entire home/apt,125,84,4.54,209
22240,Cannon,1,Entire home/apt,395,177,1.43,572
22241,Susan,2,Entire home/apt,100,37,0.46,137
22242,Moran& Ori,2,Entire home/apt,150,0,0.44,150
22243,Nicholas,1,Private room,150,0,1.75,150
22244,Kathleen,2,Entire home/apt,85,340,3.7,425
22245,Julia,1,Entire home/apt,115,91,3.67,206
22246,Tom,2,Private room,50,56,0.22,106
22247,Carolyn,3,Private room,45,157,5.35,202
22248,Yaakov,2,Entire home/apt,160,0,0.42,160
22249,Sophia,2,Private room,40,1,0.98,41
22250,Jessica,3,Private room,70,177,0.85,247
22251,Marcella & Saidat,2,Private room,80,169,6.37,249
22253,Emch,1,Entire home/apt,110,52,0.23,162
22254,Lhea,3,Entire home/apt,225,358,0.22,583
22255,Mariann,3,Private room,69,0,0.07,69
22256,Guelma,3,Private room,35,311,1.4,346
22257,Moza,1,Private room,300,0,0.4,300
22258,Taher,1,Entire home/apt,350,0,0.55,350
22259,Dee,2,Private room,45,0,0.58,45
22260,Nate,2,Entire home/apt,150,278,2.86,428
22262,Emmy,3,Private room,108,0,0.44,108
22263,Kevin,5,Private room,89,279,0.43,368
22264,Felecia,3,Private room,70,65,0.42,135
22267,Joana,2,Private room,55,259,1.26,314
22268,Blake,2,Private room,200,23,0.5,223
22269,Joseph,2,Entire home/apt,120,295,1.65,415
22270,Beatrice,4,Shared room,165,15,0.85,180
22271,Brodii,1,Private room,155,0,1.11,155
22272,Ei,1,Private room,95,28,0.11,123
22273,Saba,1,Entire home/apt,139,0,1.05,139
22274,Elaina,1,Private room,65,0,0.05,65
22275,Anna,2,Private room,57,4,0.17,61
22276,Tsotne (Tut),4,Private room,42,314,2.05,356
22277,Tsotne (Tut),4,Private room,42,23,0.65,65
22278,Paige,1,Private room,90,0,0.16,90
22279,Ethan,3,Entire home/apt,69,111,3.25,180
22280,Judith,1,Entire home/apt,376,357,0.07,733
22281,Shiva,4,Private room,75,348,0.55,423
22282,Eloise,1,Private room,99,0,0.11,99
22283,Andrea,3,Private room,85,173,2.47,258
22284,Shah Memo,1,Private room,69,71,0.26,140
22287,Jennifer,1,Private room,10,0,0.07,10
22288,Marian,2,Private room,60,0,0.04,60
22289,Nancy,1,Private room,48,42,1.21,90
22290,Seana,4,Entire home/apt,145,139,3.04,284
22291,Xavier,1,Private room,57,33,1.92,90
22292,Sean,2,Private room,85,102,5.58,187
22294,Evelyn,3,Private room,45,52,3.01,97
22296,Ahmad,2,Entire home/apt,250,0,0.07,250
22297,Oscar,3,Private room,40,95,0.86,135
22299,David,5,Entire home/apt,70,230,7.12,300
22300,Ezel,3,Private room,70,351,0.63,421
22301,Jill,1,Private room,61,160,0.11,221
22302,Guillermo,2,Entire home/apt,300,269,3.41,569
22303,Ani,2,Entire home/apt,92,0,0.17,92
22304,Connor,1,Entire home/apt,200,0,0.08,200
22305,Alex,1,Entire home/apt,150,222,3.78,372
22306,Careen,2,Entire home/apt,120,270,2.78,390
22307,Allison,1,Private room,45,0,2.83,45
22308,Mike,1,Entire home/apt,170,365,0.36,535
22310,Matthew,4,Private room,29,0,0.15,29
22311,Tarik,1,Entire home/apt,250,0,0.2,250
22312,Nicolas,1,Entire home/apt,195,0,1.1,195
22313,Maimi,2,Private room,15,0,0.07,15
22314,Karly,1,Entire home/apt,230,0,0.33,230
22315,Natalia,1,Entire home/apt,130,14,0.85,144
22316,Zheng,3,Private room,78,82,1.53,160
22317,Jaye,2,Private room,53,105,1.86,158
22318,June,1,Private room,100,0,0.41,100
22319,Sara,1,Entire home/apt,150,238,0.31,388
22320,Flo,2,Entire home/apt,89,70,3.75,159
22321,Spencer,1,Entire home/apt,105,0,0.16,105
22322,Rachel,2,Entire home/apt,80,74,2.92,154
22323,Hiroshi & Yukari,3,Private room,57,38,1.85,95
22324,Luiza,3,Private room,75,69,1.35,144
22325,Maria,2,Entire home/apt,151,36,3.49,187
22326,Hannah,2,Entire home/apt,197,0,0.26,197
22327,Eva,3,Entire home/apt,100,245,3.19,345
22328,Petra,2,Private room,88,282,2.07,370
22329,Ella,2,Private room,60,0,0.08,60
22330,Emily,1,Entire home/apt,375,301,2.89,676
22332,Matthew,1,Entire home/apt,95,98,3.87,193
22333,Beebe,2,Entire home/apt,82,238,4.93,320
22335,Alex,2,Private room,40,281,0.44,321
22336,Zach,1,Private room,45,147,0.04,192
22337,Steven-Jon,2,Private room,60,9,0.72,69
22338,Greg,1,Private room,105,103,4.81,208
22339,Raquel,2,Private room,159,166,2.69,325
22340,Mary,1,Entire home/apt,208,0,0.15,208
22341,Camilo,1,Private room,105,95,0.65,200
22342,Viviana,3,Private room,69,332,1.8,401
22344,Marlene,2,Entire home/apt,100,10,4.12,110
22345,Leigh,2,Entire home/apt,80,0,0.04,80
22346,Brendan,2,Private room,72,180,1.82,252
22347,Alan,1,Private room,120,0,0.04,120
22348,Tsotne (Tut),4,Private room,41,334,0.78,375
22350,Benjamin,2,Private room,50,78,0.74,128
22351,Anne Marie,1,Entire home/apt,134,0,0.04,134
22352,Rosa,2,Entire home/apt,150,179,0.08,329
22354,Emmanuel,2,Entire home/apt,300,229,3.51,529
22355,Heather,1,Entire home/apt,150,12,0.65,162
22356,Laura,1,Private room,60,0,0.04,60
22357,Alexander,2,Private room,45,32,0.46,77
22359,Ivan,2,Entire home/apt,142,0,0.29,142
22360,Irie,1,Private room,67,132,1.04,199
22361,M&A New York,3,Private room,69,177,0.78,246
22362,Umut Can,3,Private room,95,0,1.37,95
22363,Terence,1,Entire home/apt,195,0,0.11,195
22364,Dine,5,Entire home/apt,72,152,3.71,224
22365,Dine,5,Entire home/apt,289,230,0.16,519
22366,Efrain,2,Entire home/apt,80,66,0.05,146
22367,Stelios,2,Entire home/apt,69,6,0.59,75
22368,Sonia,3,Private room,95,160,1.38,255
22370,Deep,1,Entire home/apt,175,0,0.81,175
22371,Leo,3,Private room,35,273,3.31,308
22372,Eka,2,Entire home/apt,175,198,2.73,373
22375,Martha Cristina,2,Private room,88,0,0.81,88
22377,Charles,1,Private room,80,365,4.7,445
22378,Britt,2,Private room,49,66,1.94,115
22380,Laura,2,Private room,45,10,0.74,55
22381,Tiffany,1,Private room,100,142,3.57,242
22382,Roland,3,Private room,50,359,1.41,409
22383,Lyndsay,1,Entire home/apt,199,0,0.05,199
22384,Geoffrey,3,Entire home/apt,81,233,3.59,314
22385,Cindy,1,Entire home/apt,90,0,0.44,90
22386,Blanca,2,Private room,80,159,1.4,239
22387,Juan Felipe,1,Entire home/apt,175,4,0.08,179
22389,Lorenzo & Alex,2,Private room,60,189,0.36,249
22391,Philip,2,Entire home/apt,175,208,5.12,383
22392,Saori,2,Private room,30,0,0.22,30
22393,Frank,1,Private room,350,0,0.05,350
22394,Eric,2,Private room,57,95,1.38,152
22395,Yoav,2,Entire home/apt,120,59,0.65,179
22396,Ruth,2,Entire home/apt,129,247,3.17,376
22398,Kassandra,2,Entire home/apt,76,0,0.07,76
22400,Miguel,1,Private room,40,297,3.5,337
22401,Julie,1,Entire home/apt,250,296,0.55,546
22402,Miguel,1,Private room,55,128,3.61,183
22404,Julia,1,Entire home/apt,130,14,0.21,144
22405,Joanna,2,Entire home/apt,700,15,0.21,715
22406,Kyle,1,Entire home/apt,219,362,0.07,581
22407,Diana,1,Entire home/apt,2250,341,0.82,2591
22408,Farhan,3,Entire home/apt,125,111,6.92,236
22411,Ted & Tony,2,Entire home/apt,200,9,0.46,209
22412,Brandon,2,Entire home/apt,160,2,0.7,162
22414,Niji,2,Private room,51,0,0.15,51
22415,Emma,2,Private room,65,0,0.11,65
22416,Dani,3,Entire home/apt,100,197,3.49,297
22417,Marina,3,Private room,49,179,0.08,228
22418,Mark,2,Entire home/apt,195,218,3.0,413
22419,Jeniffer,1,Entire home/apt,115,326,0.12,441
22420,Chris,2,Private room,65,11,0.66,76
22421,Lucy,2,Private room,65,0,0.11,65
22422,Ernesto,2,Private room,60,3,4.15,63
22423,Tia,2,Entire home/apt,175,0,0.43,175
22424,Shah Memo,1,Private room,80,72,0.36,152
22425,Amaya,2,Private room,72,120,2.22,192
22426,Manisha,1,Private room,100,128,0.3,228
22427,Yoni,1,Entire home/apt,100,0,0.11,100
22428,Jim&Lisa,3,Private room,47,342,4.79,389
22429,Vadim,2,Private room,125,90,2.21,215
22430,Soraya,3,Private room,56,100,2.81,156
22431,Tom,1,Entire home/apt,105,120,0.08,225
22432,Jay,1,Private room,80,0,0.11,80
22434,Fania,1,Entire home/apt,180,0,0.26,180
22435,Cristine,1,Private room,79,131,1.77,210
22436,Vadim,2,Entire home/apt,150,177,1.23,327
22437,Kevin,1,Entire home/apt,250,0,0.11,250
22438,Kat,2,Private room,169,50,2.22,219
22439,James,2,Entire home/apt,199,0,0.23,199
22441,Frank,1,Private room,120,0,0.52,120
22442,Julien,1,Entire home/apt,199,0,1.82,199
22443,Sarah,2,Entire home/apt,160,8,0.39,168
22444,Denise,2,Entire home/apt,100,0,0.53,100
22445,Nikita,2,Entire home/apt,550,248,1.5,798
22446,DyAnna,2,Private room,40,0,0.04,40
22447,Marlene,2,Entire home/apt,95,6,4.15,101
22448,Eric,1,Private room,150,0,0.11,150
22449,Rose,2,Entire home/apt,189,24,2.17,213
22450,Stefan,2,Private room,71,0,0.07,71
22451,Aaron,2,Private room,40,0,0.22,40
22452,Marie,2,Private room,55,364,0.35,419
22453,Carolin,3,Private room,150,0,0.04,150
22457,Alessia,2,Entire home/apt,160,358,0.67,518
22459,Shireen,2,Private room,60,0,0.04,60
22460,Kyle,1,Entire home/apt,229,362,0.08,591
22461,Theodore,3,Entire home/apt,99,202,2.98,301
22462,Lisa,1,Entire home/apt,136,0,0.05,136
22463,Haldun,1,Private room,120,0,0.15,120
22465,Lisa,1,Entire home/apt,119,310,0.04,429
22466,Antong,1,Private room,99,0,0.11,99
22467,Ana,2,Private room,60,0,0.07,60
22468,Janu,1,Shared room,31,89,2.44,120
22469,Danielle,3,Private room,48,337,16.03,385
22470,Greg,1,Private room,69,29,2.34,98
22471,David,2,Private room,60,341,0.3,401
22472,Sata,3,Entire home/apt,1000,365,0.27,1365
22473,Jessica,1,Entire home/apt,350,25,0.74,375
22475,Joanna,3,Entire home/apt,150,0,0.19,150
22476,Jamaul,2,Entire home/apt,140,259,4.53,399
22477,Christian,1,Entire home/apt,200,0,0.26,200
22478,Erin,2,Entire home/apt,235,9,1.29,244
22479,Jeniffer,1,Entire home/apt,200,350,0.04,550
22480,Will,2,Private room,40,0,0.16,40
22481,Julia,2,Entire home/apt,90,35,0.11,125
22484,Doa,2,Entire home/apt,250,0,0.18,250
22485,Shay & Cam,1,Shared room,49,194,1.95,243
22486,Melissa,2,Private room,60,0,0.34,60
22487,Alexandra,2,Entire home/apt,224,192,1.01,416
22488,Sarah,2,Entire home/apt,115,0,0.23,115
22489,Taylor,2,Private room,49,89,0.74,138
22490,Alan,3,Entire home/apt,115,7,0.12,122
22491,Skender,5,Entire home/apt,95,134,1.66,229
22492,Ann,2,Private room,98,0,0.82,98
22493,Gabriele,1,Private room,110,203,0.41,313
22494,Stefan,1,Private room,50,24,0.96,74
22496,Kim,1,Entire home/apt,50,0,0.44,50
22497,Monica,2,Private room,27,84,2.99,111
22498,Shakira,2,Entire home/apt,130,0,0.48,130
22499,Diana,2,Entire home/apt,85,0,0.64,85
22500,Kate,2,Private room,115,95,0.09,210
22501,Aditi,2,Private room,53,0,0.38,53
22502,Ada,3,Entire home/apt,80,304,0.27,384
22503,Horatio,1,Private room,35,0,0.22,35
22504,Mel,1,Entire home/apt,165,269,1.39,434
22505,Jesse,2,Private room,60,41,0.64,101
22506,B,3,Entire home/apt,379,152,3.44,531
22508,Jeremy,2,Private room,60,0,0.71,60
22509,Sean,1,Entire home/apt,329,16,1.25,345
22511,Tee,4,Private room,75,87,0.25,162
22512,Nina,1,Private room,100,5,2.62,105
22513,Jessica,1,Entire home/apt,200,43,2.9,243
22514,Jessica,1,Private room,115,34,4.77,149
22515,Elena,2,Private room,85,3,0.3,88
22516,Ma,1,Private room,40,0,0.52,40
22518,Lawson,2,Private room,64,3,0.19,67
22519,Gharet,1,Entire home/apt,134,0,0.08,134
22520,Christina,2,Entire home/apt,86,349,0.04,435
22521,Alejandra,1,Entire home/apt,330,0,0.11,330
22522,Akil,2,Entire home/apt,170,0,0.81,170
22523,Sheba,1,Private room,90,9,4.29,99
22524,Jia,3,Entire home/apt,65,119,3.19,184
22525,Mustafa,3,Private room,60,40,0.08,100
22526,Liliana,3,Private room,75,341,0.32,416
22527,Charles,2,Entire home/apt,265,70,1.01,335
22528,Andreas,1,Entire home/apt,148,277,4.9,425
22529,Kevin,3,Private room,95,90,1.2,185
22530,Wendy,1,Private room,94,0,0.08,94
22531,David,2,Entire home/apt,109,258,4.22,367
22532,Christian,1,Entire home/apt,490,180,0.04,670
22533,Kristen,1,Entire home/apt,200,15,0.6,215
22535,Ivanna,3,Entire home/apt,99,63,3.52,162
22536,Erik,2,Private room,75,10,0.54,85
22537,Christopher,2,Entire home/apt,146,17,2.5,163
22538,Ariel,1,Private room,77,0,0.12,77
22539,Edyta,3,Private room,35,294,0.27,329
22540,Mekkie,1,Entire home/apt,140,5,3.17,145
22541,Kyra,1,Private room,100,0,0.81,100
22542,Evelyn,3,Private room,45,62,3.48,107
22543,Myles,2,Entire home/apt,185,112,3.22,297
22544,Yaroslav,4,Entire home/apt,60,0,0.13,60
22545,Paula,3,Private room,50,34,0.14,84
22546,Patrick,2,Private room,50,0,0.19,50
22547,Matthew,2,Private room,47,75,0.09,122
22549,Shanta,1,Entire home/apt,100,363,2.66,463
22550,Nir,1,Entire home/apt,400,14,0.36,414
22551,Posh,4,Private room,75,129,0.11,204
22552,Deri,2,Private room,145,0,0.04,145
22553,Faye,5,Private room,65,351,2.09,416
22554,Ed,2,Entire home/apt,110,150,1.95,260
22555,Patrick,1,Entire home/apt,85,0,0.08,85
22556,Tianchen,1,Entire home/apt,51,0,0.15,51
22557,Bobby,1,Entire home/apt,140,0,0.04,140
22558,Andrew,1,Entire home/apt,85,0,0.93,85
22559,Jeff,2,Private room,165,246,4.04,411
22560,"Destiny ""Bunmi""",1,Private room,30,0,0.12,30
22561,Audrey,1,Entire home/apt,116,0,0.61,116
22562,Anastasia,2,Entire home/apt,70,0,0.33,70
22563,Alisa,2,Entire home/apt,46,0,1.02,46
22564,Brett,1,Entire home/apt,70,0,0.72,70
22566,Lorenzo & Alex,2,Private room,70,265,0.52,335
22567,Tiff & David,1,Private room,140,0,0.42,140
22569,Mckenzie,1,Entire home/apt,168,0,0.37,168
22570,Victoria,2,Entire home/apt,85,105,1.01,190
22571,Audrey,2,Private room,50,64,1.29,114
22572,Alexander,1,Private room,99,178,5.88,277
22573,Krishaine,2,Private room,65,0,0.08,65
22574,Yara,1,Entire home/apt,145,140,3.28,285
22575,Seeranie,3,Private room,50,354,4.02,404
22576,Devon,1,Private room,39,282,0.14,321
22577,Gil,2,Private room,200,0,0.07,200
22578,Osa,2,Private room,69,145,0.89,214
22579,Jack,1,Entire home/apt,300,126,2.55,426
22580,Osa,2,Private room,69,319,1.33,388
22581,Petya,3,Private room,40,362,0.16,402
22582,Aiya,2,Entire home/apt,160,0,0.46,160
22583,Charlotte,1,Shared room,99,0,0.24,99
22584,Osa,2,Private room,29,319,1.49,348
22586,Kricket,1,Entire home/apt,850,365,0.26,1215
22587,Lane,2,Private room,75,0,0.04,75
22588,Amos,2,Private room,60,175,3.15,235
22589,Joseph,2,Entire home/apt,249,0,0.08,249
22590,Grace,2,Private room,69,0,0.61,69
22592,Vadim,2,Private room,75,89,0.52,164
22593,Mark,1,Private room,179,84,1.31,263
22594,Helen,5,Entire home/apt,80,50,2.55,130
22595,Michelle,2,Entire home/apt,196,9,3.32,205
22596,Jayson,1,Private room,43,0,0.04,43
22598,Nic,1,Private room,50,0,0.08,50
22599,Alexander,1,Private room,99,176,4.96,275
22600,Shesh,1,Private room,80,55,0.69,135
22601,Theodore,1,Entire home/apt,118,0,0.92,118
22602,Sarah,3,Private room,55,0,0.79,55
22603,Anndean,2,Entire home/apt,200,269,0.36,469
22605,Joy,2,Entire home/apt,125,360,1.07,485
22606,Ashley,1,Entire home/apt,145,0,0.62,145
22607,Alex,1,Private room,99,179,5.74,278
22608,Vidula,2,Private room,80,0,0.04,80
22609,Erika,1,Entire home/apt,195,1,1.36,196
22610,Julie,2,Private room,42,0,0.16,42
22611,Nicauris,1,Private room,53,354,0.42,407
22612,Tynan,2,Entire home/apt,125,0,0.11,125
22613,Alex,1,Private room,99,174,5.45,273
22614,Donald,1,Entire home/apt,210,95,0.15,305
22615,Theresa,1,Entire home/apt,177,199,2.67,376
22617,Maneto,1,Private room,44,349,0.69,393
22618,Judith,1,Private room,85,9,0.24,94
22619,Grace,2,Entire home/apt,150,0,0.3,150
22620,Jimmy &Cindy,3,Private room,70,358,3.28,428
22622,Felicia,1,Entire home/apt,125,247,3.67,372
22624,Faye,5,Private room,55,362,0.48,417
22625,Sally,2,Private room,69,156,0.23,225
22626,Only One,1,Entire home/apt,215,214,3.19,429
22627,Tiago,2,Entire home/apt,235,0,0.18,235
22628,Joe,2,Private room,42,0,0.26,42
22629,Faith,2,Private room,180,131,1.16,311
22630,Lydia,1,Private room,125,0,0.15,125
22631,Sarah,2,Entire home/apt,160,0,0.26,160
22632,T,1,Private room,100,120,1.65,220
22633,Devon,1,Private room,39,202,0.24,241
22634,Henrietta,2,Private room,71,364,0.11,435
22635,Virginie,1,Entire home/apt,1475,362,1.0,1837
22636,Mich,1,Private room,100,66,2.67,166
22637,Sam,1,Entire home/apt,180,211,3.03,391
22638,Lara,2,Private room,79,101,0.34,180
22639,Femi & Toya,2,Private room,60,338,1.46,398
22640,Natalya,1,Entire home/apt,160,90,5.63,250
22641,Martin & Christine,1,Private room,110,51,2.92,161
22642,Ben,1,Private room,193,0,0.13,193
22643,Oleg,3,Private room,50,0,1.11,50
22644,Amanda,2,Entire home/apt,250,0,0.27,250
22645,John,3,Private room,72,341,0.42,413
22646,Reuben,2,Private room,50,0,0.23,50
22648,Leah,2,Private room,90,0,0.32,90
22649,Tasny,1,Entire home/apt,325,69,3.15,394
22650,Alexisz Tamás,3,Entire home/apt,79,3,0.48,82
22651,Alice,1,Private room,180,0,0.04,180
22654,Marc,2,Entire home/apt,160,23,0.26,183
22655,Jimmy &Cindy,3,Private room,100,335,2.37,435
22657,Alexandria,1,Entire home/apt,278,30,2.01,308
22658,Jinny,1,Private room,100,0,0.04,100
22660,Lesley,1,Entire home/apt,200,365,0.15,565
22661,Suzzanne,2,Private room,39,0,0.27,39
22662,Griffith,2,Private room,99,180,1.92,279
22663,Jeff,1,Entire home/apt,110,249,0.12,359
22664,Emily,1,Private room,250,246,2.93,496
22665,Muath,2,Private room,199,179,0.07,378
22666,Danny,2,Entire home/apt,150,0,0.08,150
22667,Andy,1,Private room,55,0,0.15,55
22668,Tanya,2,Private room,60,0,0.11,60
22669,Val &Yuko,1,Private room,65,54,1.2,119
22670,Christopher,3,Private room,45,0,0.3,45
22671,Kosuke,1,Entire home/apt,150,0,0.13,150
22672,Gloria And Dmitrii,3,Private room,50,0,0.23,50
22674,Ewa,1,Entire home/apt,120,79,0.21,199
22675,Ian,2,Private room,54,0,0.52,54
22676,Tal,1,Entire home/apt,150,188,0.04,338
22677,Katie,2,Private room,100,78,2.25,178
22678,Luna,1,Entire home/apt,130,244,0.72,374
22679,Thor,1,Private room,95,38,0.95,133
22680,Johari,2,Private room,36,0,0.61,36
22681,Yosef,1,Private room,115,3,1.38,118
22682,Vida,2,Entire home/apt,199,310,0.28,509
22683,Kate,1,Entire home/apt,195,213,3.29,408
22684,Joe,1,Entire home/apt,350,253,3.63,603
22685,Christopher,2,Private room,72,0,0.47,72
22686,Anastasia,1,Entire home/apt,145,0,0.16,145
22687,Josephine,3,Private room,48,3,2.35,51
22690,Alex,2,Entire home/apt,225,87,0.59,312
22691,Maria,1,Entire home/apt,149,10,0.21,159
22692,Caroline,1,Private room,75,0,0.16,75
22693,Christopher,1,Private room,46,0,0.55,46
22695,Mark,1,Private room,130,254,3.42,384
22696,Kara,1,Entire home/apt,150,0,1.48,150
22697,Monika,2,Entire home/apt,145,98,0.76,243
22698,Nicky,2,Private room,95,43,2.11,138
22699,Sebastian,2,Private room,49,0,0.91,49
22700,Caroline,1,Entire home/apt,220,124,0.16,344
22701,Jooin,2,Entire home/apt,200,188,0.1,388
22702,Allison,2,Entire home/apt,150,185,4.96,335
22703,Duanne,2,Private room,30,0,0.34,30
22704,Lena,2,Private room,187,35,2.69,222
22705,Lorenzo & Alex,2,Private room,85,189,0.35,274
22706,Laura,2,Private room,54,0,0.3,54
22707,Gary,2,Entire home/apt,175,168,4.0,343
22708,Emma,4,Private room,38,327,1.27,365
22709,"Rossy,  Carmen And Juan",4,Private room,53,80,2.15,133
22710,Terrence,1,Private room,145,136,2.46,281
22711,Melissa,2,Entire home/apt,173,18,3.88,191
22712,Jaran,2,Entire home/apt,150,170,1.6,320
22713,Michael,1,Entire home/apt,89,332,0.26,421
22714,Seryn,2,Entire home/apt,200,244,3.78,444
22715,Shanee,2,Entire home/apt,120,185,3.24,305
22716,Leah,2,Private room,54,0,0.14,54
22717,Maryam,2,Private room,50,0,0.23,50
22718,Mel,2,Private room,45,322,0.42,367
22719,Mel,2,Private room,59,311,0.16,370
22721,Kate,1,Entire home/apt,142,187,0.07,329
22722,Alyson,1,Private room,120,90,1.25,210
22723,Faith,2,Private room,70,0,0.49,70
22724,Elie,2,Entire home/apt,200,5,1.53,205
22725,Aaron,2,Entire home/apt,299,0,3.11,299
22726,Masha,2,Entire home/apt,80,0,0.04,80
22727,Johanna,2,Private room,60,0,0.12,60
22728,Jennifer,1,Shared room,99,365,0.08,464
22730,Charles,2,Private room,46,309,2.69,355
22731,Ricardo,2,Private room,60,190,0.81,250
22732,Laura,2,Entire home/apt,175,0,0.16,175
22733,Kathleen,1,Private room,75,310,0.29,385
22735,Cesar,1,Private room,70,138,0.87,208
22736,Derek,1,Entire home/apt,190,306,3.97,496
22737,Juan,4,Private room,60,30,3.36,90
22738,Juan,4,Private room,45,34,2.89,79
22739,Ronna,2,Entire home/apt,450,179,0.27,629
22740,Lauren,3,Entire home/apt,99,0,0.04,99
22741,Devon,1,Private room,37,291,0.18,328
22742,Kizzie,2,Entire home/apt,100,78,0.09,178
22743,Eva,3,Entire home/apt,197,0,0.9,197
22744,Shanise,2,Private room,90,0,0.15,90
22745,Chaya,2,Entire home/apt,188,28,2.25,216
22746,Andrei,1,Entire home/apt,110,0,0.08,110
22747,Antoinette,2,Entire home/apt,175,0,0.47,175
22748,Diane,1,Private room,100,213,3.84,313
22749,Paulina,1,Entire home/apt,295,256,5.05,551
22750,Jia,3,Entire home/apt,99,120,3.38,219
22751,Nishant,1,Private room,70,0,0.04,70
22752,Maite,1,Private room,55,38,0.52,93
22753,Faye,5,Private room,65,356,1.41,421
22754,Daniel,1,Entire home/apt,99,1,1.32,100
22755,Grisha,1,Private room,60,0,0.23,60
22758,Ray,1,Entire home/apt,300,104,2.03,404
22759,Lara,2,Entire home/apt,210,3,0.21,213
22760,Ken,1,Entire home/apt,195,365,0.25,560
22761,Joe,1,Entire home/apt,96,0,0.11,96
22762,Yuna,2,Entire home/apt,80,78,1.45,158
22763,Yaacov,1,Entire home/apt,160,330,0.29,490
22764,Christina,3,Private room,199,53,0.26,252
22765,Devon,1,Private room,35,78,0.28,113
22766,Ramiro & Jeff,1,Private room,80,172,1.58,252
22768,Alexander,2,Private room,55,20,0.34,75
22769,Monica,2,Entire home/apt,207,231,3.06,438
22770,Zee,3,Private room,59,198,2.97,257
22771,Danny,2,Private room,75,220,2.79,295
22772,Michael,3,Private room,49,90,0.19,139
22773,Erica,2,Entire home/apt,115,121,4.47,236
22774,Jeanette,1,Private room,40,276,0.42,316
22777,Dima,2,Entire home/apt,93,45,0.04,138
22778,Christina,1,Entire home/apt,159,0,0.23,159
22779,Mimi,1,Entire home/apt,150,0,0.47,150
22780,Dan,1,Entire home/apt,86,203,0.22,289
22783,Jeniffer,1,Entire home/apt,200,330,0.07,530
22784,Emmanuel,4,Private room,50,0,0.23,50
22785,Patrick,1,Private room,120,0,0.35,120
22787,Joy,2,Entire home/apt,90,269,2.38,359
22788,Hannah,2,Private room,50,0,0.12,50
22789,Machel,2,Entire home/apt,100,108,2.37,208
22790,Kasey,1,Private room,35,0,0.04,35
22791,Michael,2,Entire home/apt,94,1,1.1,95
22792,Tatiana,2,Entire home/apt,190,303,1.62,493
22793,Nadja,1,Private room,86,0,0.05,86
22795,Kayleigh,1,Private room,55,0,0.15,55
22796,Chelsea,1,Entire home/apt,226,0,0.58,226
22797,Adam,2,Entire home/apt,186,1,1.0,187
22798,Mia,1,Entire home/apt,170,0,0.35,170
22799,Kate,1,Private room,100,211,3.28,311
22800,Joonas,2,Private room,90,37,0.61,127
22801,Virginia,2,Private room,50,2,4.03,52
22802,Brian,1,Entire home/apt,119,0,0.45,119
22804,Lyvan Esteban,1,Entire home/apt,80,0,1.51,80
22805,Jolanta,2,Private room,64,0,0.72,64
22806,Jimmy &Cindy,3,Private room,47,346,3.15,393
22807,Angela,2,Entire home/apt,100,277,2.96,377
22808,Brian,2,Private room,49,84,1.53,133
22809,Azzie,2,Private room,100,88,1.92,188
22810,Jenny,2,Private room,47,0,0.15,47
22811,Paul,2,Entire home/apt,150,0,0.15,150
22813,Sumaiya,2,Entire home/apt,165,74,2.66,239
22814,Vadim,3,Private room,70,0,0.3,70
22815,Jason,2,Private room,49,45,4.82,94
22816,Loren,1,Entire home/apt,199,0,0.43,199
22817,Peter & Gabe,1,Private room,90,204,5.13,294
22818,Alana,2,Private room,60,173,1.65,233
22819,Xolie,2,Private room,125,350,0.19,475
22820,Xolie,2,Private room,100,347,0.43,447
22821,Hadas,1,Entire home/apt,80,0,0.06,80
22822,Shayan,1,Entire home/apt,200,8,0.6,208
22823,Jose Vicente,1,Private room,50,0,0.04,50
22825,Melody,1,Private room,37,0,0.04,37
22826,Mikanny,3,Entire home/apt,135,195,0.11,330
22827,Emanuele,2,Private room,50,0,0.34,50
22828,Jessica,2,Private room,60,1,0.81,61
22830,Ava,2,Private room,40,12,0.26,52
22831,Joffrey,1,Entire home/apt,85,40,1.36,125
22832,Christina,2,Entire home/apt,85,339,0.53,424
22833,Foster,2,Entire home/apt,165,146,3.73,311
22834,Gustavo,2,Entire home/apt,200,342,0.12,542
22835,Maria,3,Entire home/apt,10,252,1.68,262
22837,Ada,2,Private room,60,31,0.36,91
22838,Ann,3,Entire home/apt,400,255,0.34,655
22839,Jenny,2,Private room,124,111,0.2,235
22840,Valéry Blake,2,Private room,75,0,0.04,75
22841,Justin,2,Entire home/apt,106,0,0.76,106
22842,Dasha,2,Entire home/apt,190,155,2.29,345
22843,Guy,2,Private room,80,340,0.9,420
22846,Esther,2,Private room,50,31,0.83,81
22847,Alfred And Lau,1,Private room,78,189,3.36,267
22848,Nitya,2,Private room,79,0,0.42,79
22849,Cyrille,2,Private room,75,0,0.32,75
22850,Rachel,1,Private room,205,308,1.56,513
22851,Low,3,Private room,50,0,0.44,50
22852,Allison,1,Entire home/apt,99,0,0.26,99
22853,Megan E,2,Private room,44,0,4.0,44
22854,Gab,1,Entire home/apt,615,282,1.78,897
22855,Philippe,2,Entire home/apt,260,330,1.31,590
22856,Anitra And Steven,1,Entire home/apt,275,96,3.41,371
22858,Pasang,3,Private room,45,242,1.23,287
22859,Sheila,4,Private room,42,147,1.18,189
22860,Juan,4,Private room,43,59,2.71,102
22861,Anthony,2,Entire home/apt,200,8,1.25,208
22862,Donny,1,Entire home/apt,79,128,0.19,207
22863,Alina,2,Private room,70,44,0.17,114
22865,Max,1,Private room,100,0,0.04,100
22867,Emily,1,Private room,175,0,0.08,175
22868,Marissa,2,Private room,40,0,0.47,40
22869,Nicolas,2,Entire home/apt,300,94,0.44,394
22870,Athena,2,Entire home/apt,180,289,2.88,469
22871,Steven,2,Entire home/apt,180,308,2.15,488
22872,Oscar,2,Entire home/apt,149,284,1.13,433
22873,Carolina,2,Private room,58,0,0.65,58
22875,Ella,2,Entire home/apt,235,228,7.04,463
22876,Yaacov,1,Entire home/apt,206,327,0.35,533
22877,Fernando,3,Entire home/apt,199,57,3.48,256
22878,Kaitlin,2,Private room,40,197,0.32,237
22879,Florian,3,Entire home/apt,120,0,0.12,120
22880,Clara,3,Private room,38,346,4.19,384
22881,Nahuel,4,Private room,100,344,4.12,444
22882,Chuck And Ellen,2,Entire home/apt,100,0,0.69,100
22883,Andrew,1,Entire home/apt,175,0,0.04,175
22884,Vineet,2,Entire home/apt,171,267,2.59,438
22885,Ranita,1,Private room,169,220,1.14,389
22886,Carleen,2,Private room,60,77,1.81,137
22887,Anthony,1,Private room,94,0,0.15,94
22888,Allen,2,Entire home/apt,88,0,0.04,88
22889,Aminata Mody,4,Private room,65,365,1.36,430
22892,A.J.,1,Private room,90,137,2.62,227
22893,Parry,2,Entire home/apt,140,0,0.27,140
22894,Britney,1,Entire home/apt,198,0,0.08,198
22895,Ruth,3,Private room,78,166,2.65,244
22896,Jose,2,Private room,65,272,0.09,337
22897,Chang,1,Private room,65,0,0.08,65
22898,Dusean,4,Entire home/apt,199,286,3.17,485
22899,Piper,1,Private room,99,0,0.38,99
22900,Carlos,2,Private room,70,0,0.49,70
22901,Justin,2,Private room,75,0,0.04,75
22902,Avi,1,Entire home/apt,350,352,0.64,702
22903,Janet,2,Private room,75,0,0.51,75
22904,Pat,1,Entire home/apt,199,280,0.65,479
22905,Laura,2,Private room,30,0,0.05,30
22906,Maria,1,Private room,70,0,2.47,70
22907,Marty,2,Entire home/apt,120,0,0.12,120
22908,Chris,1,Shared room,65,138,2.6,203
22909,Dilara,1,Entire home/apt,295,0,0.16,295
22910,Alex,2,Entire home/apt,135,0,0.48,135
22912,Juan,4,Private room,40,44,2.38,84
22913,Nitya,2,Private room,70,0,0.38,70
22914,Sigi,2,Private room,60,21,0.13,81
22915,"R, J",2,Entire home/apt,109,20,5.59,129
22916,James,1,Entire home/apt,50,0,0.15,50
22917,Anthony,3,Entire home/apt,99,0,2.69,99
22918,Jessica,1,Shared room,105,0,0.04,105
22920,Danny,2,Private room,70,197,2.15,267
22923,Elizabeth,1,Entire home/apt,150,338,0.71,488
22924,Assol,2,Private room,70,0,1.99,70
22925,Leatha,2,Entire home/apt,349,361,1.99,710
22927,Jo & Savannah,2,Private room,70,0,1.32,70
22928,Alejandra,1,Private room,150,0,0.21,150
22929,Ruchi,1,Entire home/apt,232,364,0.1,596
22930,Zoe,2,Private room,47,0,0.04,47
22931,Julio,2,Private room,45,0,0.15,45
22932,Haley,1,Entire home/apt,200,0,0.12,200
22933,David,3,Entire home/apt,278,0,0.62,278
22934,Ariel,2,Entire home/apt,195,0,0.08,195
22935,"R, J",2,Entire home/apt,109,21,5.57,130
22936,Obed,2,Private room,65,0,0.24,65
22937,Mercedes,1,Private room,80,311,3.59,391
22938,Maria,2,Private room,65,0,0.24,65
22939,Willie,1,Private room,100,365,0.15,465
22940,Ben,1,Entire home/apt,180,14,1.12,194
22942,Nahuel,4,Private room,80,338,3.86,418
22943,Artnell,2,Entire home/apt,105,320,4.18,425
22945,Kwankaew,2,Private room,45,0,0.08,45
22946,Ana Y Victor,2,Entire home/apt,315,262,4.44,577
22948,Sara,1,Entire home/apt,90,242,0.7,332
22949,Jennifer,2,Private room,215,341,0.15,556
22950,Mel,2,Private room,59,333,0.04,392
22951,Pablo,1,Entire home/apt,200,6,0.91,206
22952,Marc,2,Private room,90,197,1.91,287
22953,Michael,3,Entire home/apt,545,224,1.2,769
22954,Jasen,2,Private room,33,0,0.04,33
22955,Jeniffer,1,Entire home/apt,125,339,0.45,464
22956,Daniel,1,Entire home/apt,100,0,0.37,100
22957,Chris,1,Private room,275,0,0.31,275
22958,Ludine,2,Private room,45,0,0.08,45
22959,Max,2,Entire home/apt,199,0,0.08,199
22960,Caroll,2,Entire home/apt,150,6,0.56,156
22961,Jeniffer,1,Entire home/apt,125,342,0.14,467
22963,Nuttamon,1,Entire home/apt,168,287,4.78,455
22964,Jeniffer,1,Entire home/apt,125,344,0.17,469
22965,Sara,2,Private room,150,83,0.1,233
22966,Uri,2,Private room,48,343,4.47,391
22967,Kathleen,1,Private room,85,125,0.12,210
22968,Oscar,2,Private room,80,0,0.24,80
22969,Reuben,5,Private room,43,89,1.56,132
22970,Diane,1,Private room,60,267,1.07,327
22972,Lana,2,Entire home/apt,179,14,0.19,193
22973,Penelope,2,Entire home/apt,156,0,0.39,156
22974,Candice,2,Entire home/apt,153,0,0.08,153
22978,Lisa& Jonathan,2,Private room,145,282,3.1,427
22979,Caio,2,Private room,75,3,3.11,78
22981,Aurora,2,Entire home/apt,199,65,0.28,264
22983,Kevin,2,Private room,60,90,1.0,150
22984,Dario,1,Private room,70,0,0.31,70
22985,Abi,3,Private room,36,31,3.8,67
22986,Jonathan,1,Entire home/apt,210,0,0.19,210
22987,Sheila,4,Private room,40,171,1.36,211
22988,Donald,2,Private room,140,0,0.04,140
22989,K,1,Private room,120,5,2.09,125
22990,Kung,2,Private room,95,56,2.63,151
22991,Laetitia,2,Entire home/apt,90,1,0.27,91
22993,Abel,1,Entire home/apt,199,35,0.95,234
22994,Lauren,1,Private room,70,0,0.42,70
22995,Louiza,2,Entire home/apt,169,0,0.04,169
22997,Daphnee,2,Entire home/apt,140,218,0.73,358
22998,Larry,1,Entire home/apt,110,34,0.73,144
22999,Debra,3,Private room,30,90,0.67,120
23000,Adam,2,Entire home/apt,130,2,0.05,132
23001,Tony,2,Entire home/apt,99,356,5.84,455
23002,Mark,1,Entire home/apt,200,68,0.43,268
23003,Tim And Allison,1,Entire home/apt,170,0,0.77,170
23006,Chelsea,1,Entire home/apt,133,0,0.19,133
23007,Caitlin,1,Private room,75,0,0.55,75
23008,Triada,2,Entire home/apt,125,275,2.66,400
23009,Sabrina,2,Entire home/apt,325,39,0.46,364
23010,Max Prana,2,Private room,50,4,0.76,54
23012,Maria,1,Entire home/apt,120,9,3.43,129
23014,Jeff,3,Entire home/apt,100,213,0.13,313
23015,Megan E,2,Private room,45,0,0.31,45
23016,Jody,2,Entire home/apt,94,66,3.09,160
23017,Caitlin,2,Private room,60,0,0.08,60
23018,Anushua,3,Private room,63,338,1.03,401
23019,Bethany,2,Entire home/apt,175,11,0.4,186
23021,Devon,1,Private room,45,67,0.17,112
23022,Sean,1,Entire home/apt,123,4,1.22,127
23023,Dee,2,Entire home/apt,185,0,0.04,185
23024,Shia,1,Private room,55,18,3.93,73
23025,Patrick,1,Entire home/apt,133,0,0.35,133
23026,Shia,1,Private room,75,1,1.57,76
23027,Margot,2,Entire home/apt,450,0,0.12,450
23029,Andrea,3,Private room,90,334,0.65,424
23030,Ana Y Victor,2,Private room,400,77,2.19,477
23031,Andrea,3,Private room,62,154,1.03,216
23032,Kseniya,1,Entire home/apt,287,324,2.67,611
23033,Paul,1,Entire home/apt,200,84,3.0,284
23034,John,2,Private room,58,79,3.82,137
23035,Tiffany,2,Entire home/apt,325,33,1.25,358
23037,Zexi,2,Entire home/apt,130,0,0.08,130
23038,Ben,1,Private room,70,0,0.04,70
23041,Allie,1,Private room,85,0,0.12,85
23042,Tami,2,Private room,52,0,0.46,52
23043,Lauren,1,Private room,60,0,0.12,60
23044,Richard,2,Entire home/apt,275,0,0.32,275
23045,Trisha,1,Private room,75,0,0.81,75
23047,Caroline,2,Entire home/apt,475,72,0.17,547
23049,Ada,3,Entire home/apt,80,305,0.85,385
23050,Mo,2,Entire home/apt,200,250,0.17,450
23051,Heejun,2,Private room,70,331,0.85,401
23053,Bam,2,Entire home/apt,150,0,0.59,150
23056,Reuben,5,Private room,50,73,1.03,123
23057,Meja Hilde,3,Private room,69,0,0.12,69
23059,Win,3,Private room,44,47,10.19,91
23060,Lexi,1,Private room,60,0,0.08,60
23061,Robert,1,Private room,180,0,0.27,180
23062,Yinhang,1,Entire home/apt,95,0,0.08,95
23063,Shirley,1,Private room,70,0,0.19,70
23065,Leah,1,Entire home/apt,195,0,0.58,195
23066,Roodmy,2,Private room,45,0,0.42,45
23067,David,1,Private room,135,25,2.92,160
23068,Mili,1,Entire home/apt,145,0,0.08,145
23071,Lauren,2,Private room,80,0,0.92,80
23072,Stanley,1,Entire home/apt,150,180,0.2,330
23075,Adam,1,Entire home/apt,128,0,0.5,128
23077,Hermann,2,Private room,60,342,0.19,402
23078,Avrora,2,Private room,89,364,0.19,453
23079,Howard,1,Private room,60,170,2.26,230
23080,Marc,2,Entire home/apt,145,0,0.66,145
23081,Cara,2,Entire home/apt,97,0,0.24,97
23082,Emma,4,Private room,45,324,1.95,369
23084,Andrea,1,Private room,110,71,6.37,181
23085,Cecilia,2,Private room,65,0,0.05,65
23086,Alex,2,Entire home/apt,175,364,0.28,539
23087,Marianel,1,Private room,80,0,0.15,80
23088,Nazila,2,Entire home/apt,325,166,3.67,491
23090,Zhi And Gloria,1,Private room,104,0,1.07,104
23091,Monica,2,Entire home/apt,150,0,0.08,150
23093,Ā.,2,Private room,45,0,0.73,45
23094,Christoni,4,Private room,60,0,0.19,60
23095,Kung,2,Private room,120,0,0.14,120
23096,Linda,2,Entire home/apt,200,271,3.14,471
23097,Ken,1,Entire home/apt,235,307,0.07,542
23098,Azi,1,Entire home/apt,180,2,1.4,182
23099,Jacqueline,2,Entire home/apt,160,88,2.42,248
23100,Ude,2,Private room,42,35,1.13,77
23102,Rachel,2,Entire home/apt,175,0,0.12,175
23103,John,1,Entire home/apt,164,0,0.08,164
23104,Rachel,2,Entire home/apt,147,204,1.94,351
23105,New,2,Entire home/apt,120,0,0.29,120
23106,Daryen,2,Entire home/apt,88,1,0.24,89
23107,Kremer,2,Entire home/apt,120,342,0.19,462
23108,George,1,Private room,63,237,0.31,300
23110,Mariama,1,Private room,110,342,1.86,452
23111,Jiqiong,3,Private room,60,48,1.77,108
23113,"Jeanne - Aka, 'Rindy'",2,Entire home/apt,165,170,1.63,335
23114,Jenny,1,Private room,105,0,0.04,105
23115,Ms. George,3,Entire home/apt,150,292,0.93,442
23116,Claire,2,Entire home/apt,75,0,0.08,75
23118,Ms. H,4,Private room,60,360,1.57,420
23119,Trilla,2,Entire home/apt,90,263,2.79,353
23120,Leah,3,Private room,55,0,0.12,55
23121,Burcu,3,Private room,150,87,0.08,237
23122,Nneka,2,Private room,41,0,0.04,41
23123,Anny,1,Private room,115,0,0.19,115
23124,Noah,2,Entire home/apt,100,0,0.12,100
23125,Danni,2,Entire home/apt,155,0,0.08,155
23126,Sam,2,Private room,52,10,4.26,62
23127,Jonathan,2,Private room,80,36,0.36,116
23128,Marlène,1,Entire home/apt,75,1,0.2,76
23129,Suri,2,Private room,150,365,0.27,515
23130,Felipe,1,Private room,40,204,0.42,244
23131,Desmond,1,Entire home/apt,95,14,1.92,109
23132,Ben,2,Private room,50,10,0.62,60
23133,Javerick,2,Entire home/apt,158,324,0.08,482
23134,Daniël,2,Private room,60,0,0.08,60
23135,Kathleen,1,Private room,50,0,0.54,50
23137,Mara,1,Private room,44,0,0.27,44
23139,Carol,2,Entire home/apt,184,0,1.12,184
23140,Ashley,2,Entire home/apt,175,0,0.55,175
23141,Devan,2,Entire home/apt,300,311,0.37,611
23142,Robert,2,Entire home/apt,99,68,2.08,167
23143,Ori & Juanjo,2,Entire home/apt,137,191,3.34,328
23144,Hannah,3,Private room,49,65,2.36,114
23146,Jose,3,Private room,39,0,0.81,39
23147,Irina,2,Entire home/apt,59,140,0.8,199
23148,Julio,2,Entire home/apt,229,0,1.22,229
23149,Julio,2,Entire home/apt,825,44,0.19,869
23150,Simon,1,Private room,125,115,0.73,240
23151,Shahana,2,Private room,39,218,1.57,257
23152,Kim,1,Entire home/apt,130,0,0.08,130
23154,Ruthie,2,Entire home/apt,80,0,0.19,80
23155,Matt,2,Entire home/apt,125,0,0.31,125
23156,Halliday,2,Entire home/apt,185,0,1.5,185
23158,Jennifer,2,Private room,90,179,0.34,269
23160,Ashley,1,Entire home/apt,120,11,0.34,131
23161,Kimberly,2,Private room,0,28,0.05,28
23162,Kaila,2,Private room,65,0,0.13,65
23163,Meredith,2,Entire home/apt,225,34,0.09,259
23164,Salah,2,Private room,100,365,0.28,465
23165,King,1,Entire home/apt,195,67,1.96,262
23166,Rossana,3,Private room,69,208,0.65,277
23167,Omer,1,Private room,75,0,0.2,75
23168,Carla,2,Entire home/apt,150,94,5.61,244
23169,Ely,5,Private room,40,343,2.42,383
23171,Lu,1,Entire home/apt,260,0,0.05,260
23172,Shuting,1,Private room,60,16,0.15,76
23173,Tracy,2,Entire home/apt,150,0,3.53,150
23174,Ava,1,Entire home/apt,254,0,0.72,254
23176,Terry,1,Entire home/apt,295,0,0.27,295
23177,Daniel,1,Private room,45,0,0.11,45
23178,Allison,1,Private room,50,298,1.78,348
23179,Cheryl,2,Entire home/apt,80,0,0.08,80
23180,Allie,2,Private room,80,21,2.33,101
23181,David,3,Entire home/apt,88,0,0.27,88
23182,Stanley,1,Entire home/apt,150,180,0.14,330
23183,Sean,1,Private room,70,0,0.7,70
23184,Anada,2,Private room,98,0,0.04,98
23185,Rose & Brian,2,Entire home/apt,250,0,0.36,250
23186,David,3,Entire home/apt,238,188,0.09,426
23187,John And Colleen,3,Private room,100,84,0.62,184
23188,Ben,1,Entire home/apt,265,323,2.65,588
23190,Paul,2,Private room,55,364,0.96,419
23191,Margot,1,Entire home/apt,160,7,1.4,167
23193,Lana,3,Private room,100,21,3.54,121
23196,Marie-Astrid,2,Entire home/apt,250,174,2.35,424
23197,Elsa,2,Private room,77,1,0.77,78
23198,Jason & Mary,2,Entire home/apt,180,147,1.19,327
23199,Stanley,1,Entire home/apt,150,180,0.56,330
23200,Vanessa,2,Entire home/apt,150,78,0.35,228
23201,Fanny,2,Entire home/apt,165,18,0.39,183
23202,Edmund,2,Entire home/apt,125,1,3.87,126
23203,Vincent,1,Entire home/apt,150,0,0.24,150
23204,Justin,2,Private room,51,0,0.19,51
23205,Zachary,2,Private room,53,256,2.82,309
23206,Kevin,1,Private room,95,0,0.36,95
23208,Stanley,1,Entire home/apt,195,365,0.05,560
23209,Vincent,1,Entire home/apt,125,0,0.08,125
23210,Lauren,1,Entire home/apt,299,64,1.15,363
23211,Oday,2,Private room,146,0,0.62,146
23212,Malachi,2,Private room,55,13,1.9,68
23213,Stephanie,2,Private room,50,2,0.24,52
23214,Diana,2,Private room,65,349,1.21,414
23215,Cameron,1,Entire home/apt,165,0,0.04,165
23216,Franck And Joshua,2,Private room,41,280,2.21,321
23217,Joe Berat,3,Entire home/apt,70,157,3.42,227
23218,Ikello,4,Private room,55,271,4.65,326
23220,Melissa,1,Entire home/apt,250,0,0.04,250
23221,Tykia,1,Private room,73,0,0.93,73
23222,Steven,2,Private room,63,282,3.7,345
23224,Alan,3,Entire home/apt,183,365,0.19,548
23226,Robert,3,Entire home/apt,250,280,1.93,530
23227,Ruben,2,Private room,55,0,0.12,55
23228,Karen,2,Entire home/apt,85,147,1.71,232
23230,Karen,2,Entire home/apt,150,1,0.25,151
23231,Jean,1,Entire home/apt,305,66,0.43,371
23232,Joseph,3,Private room,80,83,1.0,163
23233,Stanley,1,Entire home/apt,150,180,0.18,330
23234,Dave,2,Shared room,64,81,3.04,145
23236,Jean Paul,2,Private room,31,37,3.28,68
23237,Leslie,2,Private room,125,0,0.07,125
23239,Stanley,1,Entire home/apt,150,365,0.09,515
23240,Raviv,1,Private room,70,0,0.69,70
23241,James,2,Private room,90,260,1.8,350
23242,Andrea,1,Private room,130,76,5.44,206
23243,Thomas,2,Entire home/apt,390,115,0.17,505
23244,Yaacov,1,Entire home/apt,160,338,0.29,498
23246,Gabriele,2,Private room,43,0,0.15,43
23247,AFI Apartments,1,Entire home/apt,119,327,0.14,446
23248,Oksana,2,Private room,50,321,1.57,371
23249,Marlene,2,Entire home/apt,115,50,0.36,165
23250,Max,2,Private room,73,0,2.45,73
23251,Harmony,2,Private room,85,355,1.79,440
23252,Candace,2,Private room,89,365,0.61,454
23254,Irina,1,Entire home/apt,160,313,0.17,473
23255,Kat,5,Entire home/apt,49,64,1.67,113
23256,Amy,1,Entire home/apt,10,0,0.39,10
23257,Olvin,2,Private room,55,0,2.25,55
23258,Maria,2,Entire home/apt,119,160,2.01,279
23259,Dave,2,Entire home/apt,85,182,0.82,267
23260,Brian,1,Entire home/apt,350,0,4.63,350
23261,James,1,Private room,76,116,2.37,192
23262,Ronn,2,Entire home/apt,46,80,2.29,126
23264,Saxon,2,Entire home/apt,79,0,0.08,79
23265,Natasha,2,Entire home/apt,350,0,0.2,350
23266,Frank,1,Entire home/apt,205,32,4.29,237
23267,Barbara,1,Private room,190,63,0.68,253
23268,Ro,2,Entire home/apt,120,0,0.04,120
23269,Luidmila,1,Private room,135,338,2.93,473
23271,Alyssa,2,Entire home/apt,85,0,0.04,85
23272,Michael,1,Private room,80,0,1.7,80
23273,Adrienne,1,Private room,49,76,0.46,125
23274,Tobi,1,Private room,51,0,0.87,51
23275,Shary,1,Entire home/apt,149,0,0.24,149
23277,Liliana,1,Entire home/apt,270,0,0.43,270
23278,Zeeshan,4,Private room,49,0,0.04,49
23279,Paula,1,Private room,75,303,0.99,378
23280,Yasmin,1,Private room,55,286,0.29,341
23281,Pauline,4,Private room,70,0,0.12,70
23282,Leo,3,Private room,54,279,2.89,333
23283,David,2,Private room,55,0,0.08,55
23284,Joe,1,Private room,142,246,1.82,388
23285,Tammie,3,Private room,50,174,2.09,224
23286,Aleida,3,Private room,50,149,3.86,199
23287,Rachel,2,Entire home/apt,109,79,3.66,188
23288,Steven,1,Private room,100,0,0.35,100
23289,Karen,2,Private room,40,354,3.69,394
23290,Antonella,1,Private room,100,24,0.55,124
23291,Patrick,3,Entire home/apt,99,81,2.41,180
23292,Vik,3,Entire home/apt,125,86,1.99,211
23293,Sarah,2,Private room,75,16,0.2,91
23295,Giampiero,1,Entire home/apt,250,306,3.28,556
23296,Inna,1,Entire home/apt,79,329,0.05,408
23297,Julie,2,Private room,90,255,0.6,345
23298,Sara,1,Private room,80,71,1.64,151
23300,Frederick,3,Entire home/apt,85,0,0.51,85
23301,Yohan,1,Private room,55,321,0.05,376
23302,Lilly,1,Private room,150,59,3.1,209
23303,David,2,Entire home/apt,250,41,1.58,291
23304,Kathleen,1,Private room,50,0,0.08,50
23305,Adam,3,Private room,60,0,0.16,60
23306,Marcia,3,Private room,60,0,0.32,60
23307,Charles,4,Entire home/apt,75,119,2.68,194
23310,Stanley,1,Entire home/apt,175,147,0.21,322
23311,Kremer,2,Entire home/apt,119,156,0.19,275
23312,AFI Apartments,1,Entire home/apt,148,264,0.52,412
23313,Lima,2,Private room,77,71,1.19,148
23314,Kat Kat,1,Entire home/apt,118,17,4.02,135
23315,A,1,Private room,350,76,1.11,426
23317,Kerith,3,Private room,60,95,5.11,155
23318,Anton,2,Entire home/apt,105,0,0.87,105
23319,Wilder,2,Entire home/apt,100,56,1.05,156
23320,Tammie,3,Private room,50,156,1.98,206
23321,Ashley,2,Private room,65,110,1.0,175
23322,Chelsea And Alistair,2,Entire home/apt,245,13,0.97,258
23323,Yaasha,1,Private room,80,0,0.31,80
23325,Andrea,3,Private room,40,89,0.3,129
23327,Mai,2,Private room,40,0,0.08,40
23328,Tori,1,Entire home/apt,254,0,0.17,254
23329,Narina,2,Private room,80,312,0.72,392
23330,Zoom Imports,2,Entire home/apt,299,180,2.31,479
23331,Anthony,2,Private room,67,307,0.27,374
23332,Sylvia,1,Private room,110,0,0.36,110
23333,Stacy,1,Private room,150,0,0.04,150
23335,Heidi,2,Private room,80,0,1.11,80
23336,Lindsay,2,Entire home/apt,800,0,0.05,800
23337,Sasha,4,Entire home/apt,48,93,0.16,141
23338,Jen,2,Private room,52,0,0.2,52
23339,Pat,1,Entire home/apt,200,0,0.04,200
23340,Dlb,3,Private room,37,0,0.37,37
23341,Nicole,1,Entire home/apt,200,0,0.16,200
23342,Mervin (Michael),5,Private room,45,207,1.89,252
23343,Emmanuel,2,Private room,119,180,0.39,299
23344,Zheng,3,Private room,60,45,1.77,105
23345,Christina,3,Private room,259,0,0.22,259
23346,Kaila,4,Private room,55,364,0.12,419
23347,Joyell,2,Shared room,25,82,4.22,107
23348,Antonio,1,Private room,90,0,0.04,90
23349,Yoga,3,Entire home/apt,98,55,1.38,153
23352,Kenny,2,Entire home/apt,137,126,2.36,263
23353,Eileen,2,Entire home/apt,70,142,3.68,212
23354,Patrick,2,Shared room,60,0,0.09,60
23355,Jeffrey,1,Entire home/apt,200,28,0.9,228
23356,Jason,2,Private room,50,45,4.66,95
23357,Bam,2,Private room,45,8,0.16,53
23358,Hsiao,1,Entire home/apt,125,0,0.32,125
23359,Cat,1,Private room,45,0,0.31,45
23361,Kanyi,1,Entire home/apt,112,0,0.04,112
23363,Bryon,1,Entire home/apt,105,0,0.82,105
23364,Dan,1,Entire home/apt,175,0,0.12,175
23366,Michelle,2,Private room,96,0,0.43,96
23367,Zach,1,Entire home/apt,78,0,0.29,78
23368,Olivia,2,Private room,120,0,0.16,120
23369,Christopher,1,Private room,49,0,0.21,49
23370,Tammie,3,Private room,66,63,2.27,129
23371,Luis,4,Entire home/apt,95,345,10.34,440
23372,Timothy,2,Private room,43,0,0.08,43
23373,Ellena,2,Private room,70,2,2.03,72
23374,Amy,2,Entire home/apt,265,41,0.79,306
23375,Audrey,2,Private room,44,87,1.07,131
23376,Daniel,2,Private room,35,0,0.08,35
23377,Geetika,1,Shared room,55,0,0.04,55
23378,Lana,3,Private room,100,0,0.51,100
23379,Dan,2,Entire home/apt,123,131,2.48,254
23380,Arielle,1,Entire home/apt,100,0,0.16,100
23381,Yaacov,1,Entire home/apt,200,281,0.19,481
23382,Ude,2,Private room,50,179,2.88,229
23383,Imanuelly,3,Private room,75,364,0.46,439
23384,Marc,2,Entire home/apt,225,258,1.52,483
23385,Massy,2,Private room,51,276,1.55,327
23386,Samuel,2,Private room,45,0,0.12,45
23387,Alexandra,2,Entire home/apt,125,0,0.11,125
23388,Kristen,1,Private room,88,34,2.34,122
23389,Tom,2,Private room,70,16,3.33,86
23390,Gio,1,Private room,55,0,0.31,55
23391,Luo,3,Entire home/apt,104,0,0.28,104
23392,James,1,Private room,90,17,1.56,107
23393,Gurpreet  Singh,3,Private room,59,0,4.85,59
23394,Modesta,1,Private room,55,57,1.06,112
23395,David,3,Private room,175,176,2.14,351
23397,Karim,1,Entire home/apt,199,61,0.24,260
23398,Clemence,2,Entire home/apt,150,0,0.27,150
23399,Amedeo,1,Entire home/apt,145,9,2.61,154
23400,Lym,1,Entire home/apt,220,0,0.31,220
23401,Raymond,2,Entire home/apt,105,258,0.2,363
23402,Andrew,2,Entire home/apt,185,0,0.41,185
23403,Tal,2,Private room,45,0,0.31,45
23404,Uly,1,Private room,115,38,1.69,153
23406,Maya,2,Entire home/apt,200,70,3.43,270
23407,Alex,1,Entire home/apt,160,0,0.08,160
23408,Carmen,3,Private room,35,0,0.04,35
23409,Cheryl,2,Entire home/apt,200,274,4.57,474
23410,Kelly,1,Entire home/apt,129,0,0.08,129
23411,Akiko,2,Entire home/apt,1067,32,2.51,1099
23412,Frank,1,Entire home/apt,120,0,0.43,120
23413,Pavel,2,Entire home/apt,105,0,0.27,105
23414,Anthony,2,Private room,36,311,0.37,347
23416,Francis,3,Private room,74,8,1.38,82
23417,Ali,2,Entire home/apt,68,0,0.2,68
23418,Michelle,1,Entire home/apt,122,220,5.03,342
23421,Daniel,3,Private room,71,194,3.66,265
23422,Hugo,2,Private room,50,0,0.44,50
23423,Yogita,1,Private room,138,66,1.9,204
23424,Jason,2,Private room,39,223,2.57,262
23425,Garen,1,Entire home/apt,158,142,5.45,300
23426,Jamie,3,Entire home/apt,195,0,0.12,195
23427,Chrissy,2,Private room,80,0,0.16,80
23428,Hannah,3,Private room,38,171,2.39,209
23429,Gabriella,2,Entire home/apt,134,130,2.56,264
23430,Stay With US!,1,Entire home/apt,70,98,3.21,168
23431,Lakisha,2,Private room,50,179,1.24,229
23433,Mante,1,Private room,79,263,2.67,342
23434,Max,2,Entire home/apt,150,0,0.08,150
23435,Joseph,3,Private room,50,0,0.63,50
23436,James,3,Private room,46,0,0.75,46
23437,Aiana,2,Private room,65,0,0.13,65
23438,Emily,1,Private room,51,0,0.08,51
23439,Neelu,1,Entire home/apt,176,64,0.6,240
23440,David,4,Private room,60,81,0.75,141
23441,Ayinde,2,Entire home/apt,95,60,3.63,155
23442,Monica A,4,Private room,60,0,0.05,60
23444,Christine,2,Private room,125,156,0.32,281
23445,Constanze,1,Entire home/apt,170,0,0.63,170
23446,Gida,1,Private room,350,0,0.04,350
23447,Justine,4,Private room,40,365,1.03,405
23448,Kate + Max,2,Private room,42,43,1.04,85
23449,Sharlene,5,Entire home/apt,103,189,0.09,292
23450,Philip,3,Entire home/apt,165,153,2.14,318
23451,Phaedra,2,Entire home/apt,128,0,0.25,128
23452,Natasha,3,Entire home/apt,250,166,0.4,416
23453,Matt,3,Private room,60,73,2.21,133
23455,Stephanie,1,Entire home/apt,465,0,0.05,465
23456,Isabelle,1,Private room,100,0,0.32,100
23457,Ella,2,Private room,40,0,0.04,40
23458,Mai,2,Private room,45,0,0.1,45
23459,George,2,Private room,85,189,0.13,274
23460,Sueann,5,Entire home/apt,85,159,2.08,244
23462,Miranda,2,Private room,65,365,0.78,430
23463,Elena,2,Private room,55,0,0.07,55
23465,Karli,2,Entire home/apt,225,80,3.18,305
23467,Frankie And J,1,Private room,200,8,1.0,208
23468,FuKang,3,Private room,55,137,4.44,192
23469,Xavier,2,Entire home/apt,180,0,1.17,180
23470,Evelyn,2,Entire home/apt,115,183,0.37,298
23471,Jourdan,2,Entire home/apt,185,85,1.44,270
23472,Breanna,2,Private room,50,0,0.04,50
23473,Brian,1,Entire home/apt,218,9,0.13,227
23474,Garrett,3,Entire home/apt,99,0,0.12,99
23476,Monique,1,Private room,99,362,2.38,461
23477,Robert,1,Private room,100,224,2.58,324
23478,Alex,1,Entire home/apt,150,242,2.7,392
23480,Dana,2,Private room,75,0,0.12,75
23481,Lindsay,2,Entire home/apt,250,0,0.04,250
23482,Michelle,2,Private room,78,41,1.78,119
23484,Peter,1,Private room,117,332,0.15,449
23485,Justin,1,Entire home/apt,179,5,0.67,184
23486,Abcstay,1,Entire home/apt,1599,0,0.24,1599
23487,Lisanne,2,Private room,49,251,0.59,300
23488,Maria,1,Private room,85,310,3.84,395
23490,George,1,Entire home/apt,350,104,0.72,454
23492,Sandra,1,Private room,125,0,0.12,125
23494,Miriam,1,Private room,80,179,0.75,259
23495,Ashley,2,Entire home/apt,220,0,1.71,220
23496,Joanna,3,Entire home/apt,100,3,5.33,103
23498,Nolwenn,2,Private room,40,0,0.04,40
23500,Martijn,2,Private room,45,0,0.1,45
23503,Cynthia,2,Private room,49,332,2.15,381
23505,Ese,1,Private room,125,341,0.44,466
23506,Carol,2,Private room,52,365,0.53,417
23507,Jose,3,Entire home/apt,110,9,3.33,119
23508,Shampa,3,Private room,38,188,0.75,226
23509,Devyn,1,Private room,60,0,0.65,60
23510,Devony,1,Private room,55,3,0.47,58
23511,Emilia,2,Entire home/apt,119,50,0.51,169
23512,Morgan,2,Entire home/apt,121,0,0.12,121
23513,Abir,1,Private room,89,0,0.55,89
23515,Shawn,2,Private room,80,104,0.12,184
23516,Debra,3,Private room,60,0,1.65,60
23517,Lorenzo,1,Private room,90,0,0.05,90
23518,Anthony,3,Entire home/apt,115,66,0.47,181
23519,Eliu,4,Entire home/apt,350,0,0.09,350
23520,Mira,2,Private room,85,49,7.05,134
23521,Zakir And Shagraf,3,Private room,55,0,1.46,55
23522,Ben,3,Private room,61,109,4.46,170
23523,Maxime,1,Private room,95,0,0.08,95
23524,Mo,1,Private room,35,0,0.2,35
23525,Chad,1,Entire home/apt,150,40,1.67,190
23526,Gigi,1,Entire home/apt,350,51,0.33,401
23528,Colin,1,Entire home/apt,165,0,0.33,165
23529,Chris,2,Private room,45,0,0.12,45
23530,José,2,Private room,200,0,0.08,200
23531,Carmelo,1,Private room,75,280,4.52,355
23532,Chris,1,Entire home/apt,279,0,0.19,279
23534,Ana Y Victor,2,Private room,400,77,2.48,477
23535,Linda,2,Entire home/apt,80,240,4.28,320
23538,Alena,1,Entire home/apt,140,0,3.02,140
23539,Joshua,2,Private room,101,364,0.36,465
23540,Ming,2,Private room,43,90,2.8,133
23541,Pj,2,Entire home/apt,424,31,0.09,455
23543,Mai,2,Entire home/apt,170,0,0.28,170
23544,Steven,2,Private room,60,0,0.09,60
23546,Deren,2,Entire home/apt,125,1,0.95,126
23547,Malen,1,Entire home/apt,115,7,0.47,122
23548,Ben,1,Private room,36,106,1.12,142
23549,Goran,1,Private room,49,8,1.62,57
23550,Mira,1,Entire home/apt,108,50,0.17,158
23551,Joe,1,Entire home/apt,578,240,2.84,818
23552,LadyShepsa,2,Private room,40,0,0.21,40
23553,Gurpreet  Singh,3,Private room,50,0,4.15,50
23554,Zeyu,1,Private room,55,0,0.04,55
23555,Zedal,2,Private room,46,0,0.24,46
23556,Sonya,1,Private room,150,125,2.37,275
23557,Lisa,3,Private room,39,136,0.17,175
23558,Lizzie,2,Entire home/apt,100,99,1.0,199
23561,Giona,1,Entire home/apt,300,2,0.2,302
23562,Yuval,2,Private room,50,0,5.65,50
23563,Nehama And Chen (Agent ),1,Entire home/apt,115,220,0.22,335
23564,Alessandro,1,Private room,100,0,0.04,100
23565,Artem,1,Private room,99,179,0.57,278
23567,Helene,1,Entire home/apt,175,0,0.3,175
23568,Corporate Housing,1,Entire home/apt,125,140,0.15,265
23569,Jeniffer,1,Entire home/apt,100,345,0.09,445
23571,Joyell,2,Shared room,29,73,4.99,102
23572,Ocean,2,Private room,70,179,0.04,249
23573,Charles,1,Private room,52,0,0.16,52
23574,Emmanuel,2,Private room,105,179,0.32,284
23575,Richard,1,Shared room,29,0,0.86,29
23576,Emmanuel,2,Private room,110,179,0.12,289
23577,Lydia,2,Private room,80,86,1.98,166
23578,Kourosh,2,Private room,31,0,0.12,31
23579,Rachel,1,Shared room,320,179,0.1,499
23580,Charles,1,Private room,40,0,0.12,40
23582,Sara,3,Entire home/apt,104,65,3.26,169
23585,Braden,2,Private room,37,0,0.25,37
23586,Ivy,3,Private room,40,2,0.06,42
23588,Timothée,2,Entire home/apt,150,0,0.04,150
23589,Eda,2,Entire home/apt,180,0,0.65,180
23590,Oz,2,Private room,90,0,0.04,90
23591,Anthony,2,Private room,36,318,0.29,354
23593,Tony,1,Private room,145,59,3.07,204
23594,Jean Paul,2,Private room,33,15,3.17,48
23595,Daniel,1,Private room,68,332,0.31,400
23597,Cory,2,Private room,67,0,0.86,67
23598,Anny,1,Entire home/apt,175,0,0.29,175
23599,Douglas,1,Entire home/apt,100,0,0.59,100
23600,Joseph,1,Entire home/apt,180,57,0.43,237
23602,Rudy,1,Entire home/apt,160,0,0.04,160
23603,Kenny,2,Entire home/apt,130,0,0.18,130
23604,Madalina,2,Entire home/apt,70,0,1.16,70
23605,Marie,2,Entire home/apt,300,333,2.36,633
23606,Joey,2,Private room,45,0,0.08,45
23607,Diana,2,Private room,69,0,0.25,69
23608,Ana Corina,1,Entire home/apt,290,66,0.54,356
23610,Zach,1,Entire home/apt,149,364,0.08,513
23611,Esther,2,Entire home/apt,100,0,0.6,100
23612,Troy & Aki,2,Entire home/apt,100,77,4.31,177
23613,Keri,2,Entire home/apt,95,0,0.32,95
23614,Adrian,2,Entire home/apt,200,0,0.24,200
23615,Jacqueline,1,Private room,70,0,0.16,70
23616,Aigerim Aika,2,Private room,75,19,5.31,94
23617,Ed,3,Private room,49,359,0.24,408
23620,Aigerim Aika,2,Private room,65,11,4.82,76
23621,David,4,Entire home/apt,100,0,1.18,100
23622,Zoila,1,Private room,50,4,2.55,54
23623,Jamie,2,Entire home/apt,79,0,0.08,79
23624,Thomas,1,Private room,950,237,1.45,1187
23626,Andrea,2,Entire home/apt,188,144,0.45,332
23627,Jorge,3,Private room,50,175,1.5,225
23629,Katri,2,Private room,105,12,0.33,117
23630,Janene,1,Entire home/apt,225,40,2.06,265
23632,Jared,2,Entire home/apt,185,0,0.19,185
23633,Milorad,1,Private room,90,0,0.47,90
23635,Josh,1,Private room,119,0,0.08,119
23636,Chris,1,Entire home/apt,150,0,0.05,150
23638,Inna,1,Entire home/apt,125,332,0.39,457
23639,Sanyika,4,Private room,60,66,0.67,126
23640,Jason,2,Private room,42,218,1.58,260
23641,Anna,1,Entire home/apt,130,48,0.95,178
23642,Sarabeth,2,Entire home/apt,66,0,0.12,66
23643,Liz,2,Private room,109,179,0.2,288
23644,Chris,2,Private room,90,7,0.58,97
23645,Patrick,2,Private room,89,333,2.68,422
23646,Chris,2,Entire home/apt,600,64,0.47,664
23647,Opal,1,Entire home/apt,250,0,0.52,250
23648,Brian,1,Entire home/apt,278,35,0.73,313
23649,Mark,1,Entire home/apt,800,68,0.22,868
23650,Kathy,3,Private room,70,89,1.23,159
23651,Rob,1,Entire home/apt,275,0,0.08,275
23652,Walter,1,Entire home/apt,195,0,0.16,195
23653,Samantha,2,Private room,50,0,0.08,50
23654,Frankie,2,Private room,45,0,0.08,45
23655,Xiaoxia,2,Private room,62,0,0.12,62
23656,Silvana,1,Entire home/apt,150,0,0.09,150
23657,Sofia,1,Entire home/apt,98,30,2.26,128
23658,Sara,1,Entire home/apt,236,314,2.24,550
23659,Marie-Louise,2,Entire home/apt,250,0,0.04,250
23660,Hanna,1,Entire home/apt,200,0,0.04,200
23661,Steve,2,Entire home/apt,195,0,0.45,195
23662,Andy,3,Entire home/apt,90,62,0.69,152
23663,M,2,Private room,128,305,1.43,433
23664,Naima,2,Private room,44,286,1.39,330
23665,Amarsana,1,Private room,75,0,0.04,75
23666,Aaron,1,Private room,100,0,0.4,100
23667,Ezio,1,Entire home/apt,90,44,0.32,134
23668,Kaan,1,Private room,60,154,0.73,214
23669,Barrett,1,Entire home/apt,250,151,0.48,401
23670,Lena,1,Entire home/apt,349,264,1.0,613
23671,Francisca,1,Entire home/apt,101,0,0.28,101
23672,Neek,2,Private room,120,53,3.9,173
23673,Samantha,3,Entire home/apt,86,20,2.06,106
23674,Sergii,3,Shared room,30,365,0.05,395
23675,Jo,3,Private room,40,36,1.33,76
23676,Simi,1,Entire home/apt,106,364,0.39,470
23677,John,3,Private room,40,311,0.55,351
23678,Sergii,3,Shared room,30,365,0.08,395
23679,Heather,2,Private room,52,302,1.25,354
23680,Alyssa,2,Entire home/apt,147,0,0.04,147
23681,Mariana,1,Private room,200,0,0.08,200
23683,Bryan,2,Private room,37,152,2.34,189
23685,Sharon,2,Private room,70,48,0.53,118
23687,Joseph,1,Entire home/apt,135,0,1.64,135
23688,Jake,2,Entire home/apt,150,91,0.05,241
23689,Beatrice,1,Private room,108,23,0.68,131
23690,Chris,2,Entire home/apt,225,8,0.29,233
23691,Lucilu,3,Private room,59,30,7.84,89
23692,Sophia,2,Entire home/apt,115,3,1.23,118
23693,Masud,2,Private room,35,312,0.29,347
23694,Sasha,1,Entire home/apt,1000,90,0.12,1090
23695,Sergii,3,Shared room,55,365,0.1,420
23696,Matthew,1,Entire home/apt,280,0,0.13,280
23697,Shlomi,2,Entire home/apt,100,0,0.21,100
23698,Ivanna And Emmanuel,2,Entire home/apt,55,25,3.1,80
23699,Brittany,1,Private room,70,173,0.53,243
23700,Regitze,2,Entire home/apt,219,0,0.37,219
23701,Lorenzo & Alex,2,Private room,45,310,0.46,355
23703,Mohammad,1,Private room,60,0,0.05,60
23704,Aaron,2,Entire home/apt,150,5,0.8,155
23705,Joy,2,Entire home/apt,150,106,3.29,256
23706,Joyell,2,Shared room,50,0,0.98,50
23708,Robert,2,Private room,119,279,4.09,398
23710,Vicky,1,Private room,160,0,0.04,160
23711,Elvira,1,Private room,60,13,1.71,73
23712,Nicholas,1,Entire home/apt,125,0,1.8,125
23714,Corey,1,Entire home/apt,98,0,0.48,98
23715,Jolly,1,Private room,128,329,0.94,457
23716,Jure,1,Entire home/apt,100,22,0.47,122
23717,Mamun,3,Entire home/apt,120,340,3.37,460
23718,Trace,1,Entire home/apt,90,0,0.12,90
23719,Jamie,2,Entire home/apt,147,0,0.49,147
23720,Conrad,3,Private room,60,37,0.17,97
23721,Ali,1,Private room,115,67,0.5,182
23722,Pierre,1,Entire home/apt,110,0,0.32,110
23723,"Yumi, Chizu",1,Private room,155,157,1.45,312
23724,John,1,Entire home/apt,275,0,0.58,275
23725,Irving,1,Private room,150,0,0.04,150
23726,Ninja,3,Entire home/apt,159,0,0.08,159
23727,Titus,2,Private room,200,178,0.08,378
23728,"Yumi, Chizu",1,Private room,135,155,1.53,290
23729,Xintong (Nancy),2,Private room,89,0,0.4,89
23730,Amy,3,Private room,80,10,0.45,90
23731,Harmony,2,Private room,60,180,1.55,240
23732,Easton,2,Private room,45,0,1.31,45
23734,Julissa,1,Entire home/apt,99,29,1.51,128
23735,Mariana,1,Private room,120,0,0.37,120
23736,Jay,1,Entire home/apt,219,59,1.33,278
23737,Rob,1,Private room,65,0,0.04,65
23738,Sam & Stefanie,2,Entire home/apt,215,0,0.09,215
23739,Andom,1,Entire home/apt,90,64,1.68,154
23740,Giulliana,2,Private room,51,7,7.66,58
23741,Jason & Mary,2,Entire home/apt,170,249,0.9,419
23742,Tara,1,Private room,90,125,4.95,215
23744,Mira,2,Private room,79,46,7.79,125
23745,Heather,2,Private room,39,344,1.2,383
23746,Heather,2,Private room,65,321,0.95,386
23747,Ricardo,2,Private room,80,158,0.04,238
23748,Noelle,2,Private room,120,0,0.13,120
23749,Cassidy,1,Private room,52,242,1.65,294
23751,Jianyan,1,Entire home/apt,120,0,0.12,120
23752,Missy,1,Entire home/apt,315,0,0.05,315
23753,Mahlet,2,Entire home/apt,125,65,0.36,190
23754,Sk,1,Entire home/apt,399,112,2.4,511
23755,Peter,2,Shared room,72,0,0.13,72
23756,Nancy,3,Entire home/apt,239,188,0.46,427
23757,Nancy,3,Entire home/apt,200,215,1.11,415
23758,Maria,1,Entire home/apt,110,161,0.62,271
23759,Janine,2,Private room,80,64,0.46,144
23760,Deaton,1,Entire home/apt,118,0,1.15,118
23761,Cristal,2,Private room,37,0,0.12,37
23762,Becca,2,Private room,77,12,0.64,89
23763,Jen,1,Private room,100,28,4.07,128
23764,Madelline,1,Entire home/apt,95,0,0.38,95
23766,Colin,3,Private room,55,0,0.21,55
23768,Freddie,2,Private room,60,0,0.04,60
23769,Marlene,2,Entire home/apt,240,0,0.78,240
23770,Yaacov,1,Entire home/apt,287,326,0.27,613
23772,Valentin,3,Shared room,27,6,0.18,33
23773,Valentin,3,Shared room,26,365,0.22,391
23774,Rick,1,Entire home/apt,290,0,0.04,290
23775,Andrea,3,Private room,85,166,3.7,251
23776,Joseph,3,Private room,69,51,2.72,120
23777,Vk,1,Entire home/apt,196,0,0.61,196
23778,Assane,2,Entire home/apt,154,172,1.22,326
23779,Dan,2,Entire home/apt,113,99,2.8,212
23781,Rayan,3,Private room,45,283,0.69,328
23782,Kaitlin,1,Private room,70,0,0.52,70
23783,Doa,3,Private room,70,0,1.02,70
23784,Will,2,Private room,100,0,0.91,100
23785,Vaughn,1,Entire home/apt,102,0,0.96,102
23786,Katherine,2,Entire home/apt,350,0,0.16,350
23788,Robert & Bianca,2,Entire home/apt,136,0,0.4,136
23791,Sam,1,Private room,115,0,1.16,115
23792,Itamar,2,Entire home/apt,160,0,0.04,160
23793,Christopher,2,Entire home/apt,130,0,1.24,130
23794,Gh,1,Entire home/apt,148,320,2.42,468
23795,Alena,2,Private room,110,85,5.99,195
23796,Alena,2,Private room,87,73,5.58,160
23797,Jade,1,Entire home/apt,72,0,1.15,72
23799,Kathy,1,Private room,120,0,0.12,120
23800,Christina,2,Entire home/apt,450,22,1.24,472
23801,Rachel,2,Entire home/apt,84,0,0.33,84
23802,Tupac,1,Private room,75,119,0.4,194
23803,Catherine,1,Private room,110,321,0.13,431
23804,Ruth,2,Entire home/apt,148,258,3.22,406
23805,Todd,1,Entire home/apt,225,0,0.04,225
23806,Milan,1,Entire home/apt,122,5,0.67,127
23807,Pierre,1,Entire home/apt,190,0,0.17,190
23808,Betul,1,Entire home/apt,120,0,0.29,120
23809,Lynsey,2,Entire home/apt,200,0,0.4,200
23810,Maria,3,Entire home/apt,80,190,0.11,270
23811,Kate,2,Entire home/apt,149,0,0.52,149
23812,Jennifer,1,Private room,60,223,0.19,283
23814,Terry,1,Entire home/apt,175,0,3.43,175
23815,Adeyemi,2,Private room,55,164,4.64,219
23816,Diana,1,Private room,77,0,0.81,77
23817,Adeyemi,2,Private room,55,205,4.78,260
23818,Adeyemi,2,Private room,50,237,4.14,287
23819,Steven,1,Entire home/apt,350,27,3.46,377
23820,Cameron,1,Private room,50,0,0.81,50
23821,Lane,3,Private room,100,174,1.96,274
23822,Christie,1,Entire home/apt,319,79,1.51,398
23824,Romy,1,Entire home/apt,120,0,0.36,120
23825,Beth,2,Entire home/apt,150,0,0.52,150
23826,James,1,Entire home/apt,250,0,0.08,250
23828,Ami,1,Entire home/apt,400,128,1.21,528
23830,Emilie,2,Entire home/apt,125,26,0.45,151
23831,Natallia,1,Entire home/apt,180,0,0.21,180
23832,Lisa,2,Entire home/apt,90,215,0.13,305
23833,Jena,1,Entire home/apt,200,52,1.41,252
23834,Julia,3,Entire home/apt,100,0,0.29,100
23835,Maddie,2,Private room,70,18,0.4,88
23837,Andrea,3,Entire home/apt,199,0,0.23,199
23838,Adonis,1,Private room,120,350,1.65,470
23839,Luke,2,Private room,60,0,0.04,60
23840,Sivan,2,Entire home/apt,199,37,2.47,236
23841,Ramy,2,Entire home/apt,130,0,0.12,130
23842,Tian,2,Private room,60,0,0.33,60
23843,Viviana,3,Private room,69,357,0.85,426
23844,Ellen,1,Private room,30,0,0.12,30
23845,Abby,2,Entire home/apt,350,142,3.26,492
23847,Jonathan,2,Entire home/apt,93,37,0.25,130
23848,Steven,1,Entire home/apt,150,282,3.24,432
23849,Meghan,2,Private room,60,0,0.11,60
23850,Adonis,1,Private room,180,328,1.17,508
23851,Jimmy &Cindy,3,Private room,116,361,2.19,477
23852,Lianne,2,Entire home/apt,225,0,0.21,225
23855,William,2,Entire home/apt,124,12,0.04,136
23856,Maria,1,Entire home/apt,140,13,1.66,153
23857,Alyssa,1,Entire home/apt,84,0,0.12,84
23860,Mark And Josephine,1,Entire home/apt,125,186,3.93,311
23861,Lilian,2,Entire home/apt,63,0,1.08,63
23862,Nicki,2,Entire home/apt,85,0,0.09,85
23863,Christine & James,2,Entire home/apt,425,262,1.74,687
23864,Ben,2,Private room,50,0,0.04,50
23866,Abigail,1,Entire home/apt,215,0,0.24,215
23867,Gigi,4,Private room,60,175,0.16,235
23868,Aldric,2,Entire home/apt,200,355,0.33,555
23870,Ali,1,Entire home/apt,135,9,3.52,144
23872,Igor,2,Shared room,32,21,0.32,53
23873,Sofia,3,Private room,85,6,0.76,91
23874,Christian,1,Entire home/apt,195,0,0.2,195
23875,Alison,1,Entire home/apt,352,13,0.63,365
23876,Noel,1,Entire home/apt,225,0,0.24,225
23877,Giovanni,2,Entire home/apt,60,88,5.82,148
23878,Talha Can,2,Private room,35,36,0.13,71
23881,Jillian,2,Private room,60,104,1.08,164
23882,Bella,3,Entire home/apt,90,0,1.24,90
23883,David,3,Entire home/apt,274,315,1.37,589
23884,Braden,1,Private room,69,0,0.08,69
23885,Hanan,2,Private room,65,78,1.09,143
23886,Christina,1,Entire home/apt,278,0,0.32,278
23887,David,2,Private room,60,0,0.2,60
23888,Allen,1,Private room,79,0,0.45,79
23889,Jen,2,Private room,100,179,0.52,279
23891,Schimpff,2,Private room,100,0,0.04,100
23892,Colleen,1,Entire home/apt,210,148,2.27,358
23893,Joseph,1,Entire home/apt,180,65,1.69,245
23894,Vik,3,Entire home/apt,165,62,2.46,227
23895,Nick,2,Entire home/apt,225,4,0.29,229
23896,Kristin,3,Entire home/apt,150,0,0.05,150
23897,Keely,2,Entire home/apt,90,0,0.32,90
23898,Jimmy,2,Entire home/apt,77,0,0.2,77
23899,Nina,1,Entire home/apt,145,207,0.18,352
23900,Chris,1,Private room,60,0,0.31,60
23901,Joy,1,Entire home/apt,250,176,4.03,426
23902,Tara,1,Private room,90,87,4.19,177
23903,Luis,1,Entire home/apt,220,127,3.04,347
23904,Tiasha,2,Private room,46,7,0.41,53
23905,Narmeen,2,Private room,55,0,0.04,55
23906,Leidy,2,Entire home/apt,250,0,0.14,250
23907,Robianddebbie,2,Private room,55,318,1.33,373
23908,Michael,1,Entire home/apt,225,345,1.79,570
23909,Chuck,1,Entire home/apt,120,5,3.37,125
23910,Y,2,Entire home/apt,89,52,6.79,141
23911,Justine,4,Private room,40,362,1.26,402
23912,Laura,1,Private room,69,16,3.7,85
23913,George,1,Shared room,55,347,0.44,402
23914,Adam,1,Entire home/apt,152,0,1.17,152
23916,Cynthia,3,Entire home/apt,57,56,5.37,113
23917,Brian,2,Shared room,37,343,0.13,380
23919,Julie,2,Private room,42,0,0.12,42
23920,Mel,1,Entire home/apt,100,0,0.52,100
23921,Cassandra,2,Entire home/apt,226,127,2.32,353
23922,Gabriella,1,Private room,60,0,0.24,60
23923,Holly,2,Entire home/apt,300,194,0.05,494
23927,Luis,2,Private room,80,0,0.38,80
23928,Ann,2,Entire home/apt,150,72,4.23,222
23929,Carmelo,2,Entire home/apt,225,152,0.25,377
23930,Andrew,1,Private room,69,316,2.93,385
23931,Cici,1,Private room,61,50,0.65,111
23932,Georgi And Alisa,2,Entire home/apt,100,0,0.47,100
23933,Omar And Kareema,2,Entire home/apt,399,221,0.28,620
23934,Nneya,2,Entire home/apt,90,74,0.58,164
23935,Chelsea,2,Private room,40,0,0.12,40
23936,Jack And Rachel,2,Private room,60,46,0.88,106
23938,Susan,2,Entire home/apt,212,10,0.46,222
23939,Zack,1,Entire home/apt,200,11,0.16,211
23941,Camilla,1,Private room,115,325,3.03,440
23942,Corporate Housing,1,Entire home/apt,185,147,0.16,332
23943,Emma,2,Entire home/apt,130,189,0.13,319
23944,Stefanie Elizabeth,1,Entire home/apt,165,217,8.16,382
23945,G,2,Entire home/apt,160,30,0.94,190
23946,Edyta,2,Entire home/apt,185,261,0.16,446
23949,Douglas,2,Entire home/apt,250,31,0.52,281
23950,John,1,Entire home/apt,150,281,3.14,431
23952,Zheliang,1,Entire home/apt,70,0,0.12,70
23953,Fabiana,1,Entire home/apt,210,54,0.34,264
23954,Dalina,1,Private room,113,90,0.48,203
23955,Nia,2,Entire home/apt,97,0,0.85,97
23956,Ladi,1,Private room,85,190,1.13,275
23957,Mari,2,Entire home/apt,550,249,0.25,799
23959,Isak,1,Entire home/apt,260,0,0.2,260
23961,Ikkyukim,4,Private room,37,329,0.37,366
23962,Carlos,2,Private room,85,64,0.09,149
23963,Tammie,3,Entire home/apt,85,0,1.51,85
23964,Adam,1,Entire home/apt,100,36,1.22,136
23965,Ralph,2,Private room,65,76,1.66,141
23966,Alex,2,Private room,90,0,0.71,90
23967,Alan,3,Entire home/apt,115,319,0.22,434
23968,Sylvia,2,Entire home/apt,160,236,3.2,396
23969,Luka,1,Entire home/apt,325,240,6.22,565
23971,Joseph,1,Private room,80,13,1.56,93
23973,Keith,2,Entire home/apt,90,126,1.82,216
23976,Colin,2,Private room,65,0,0.2,65
23977,Jason,1,Entire home/apt,150,83,0.16,233
23978,Toby Steven,1,Private room,200,24,0.16,224
23979,Jaime And Stephen,2,Private room,80,365,0.22,445
23980,Courtney,2,Entire home/apt,125,0,0.65,125
23981,Michele,2,Entire home/apt,139,82,2.53,221
23984,Shaun,1,Entire home/apt,198,300,5.91,498
23985,Daria,2,Private room,40,0,0.09,40
23987,Julie,2,Private room,60,23,0.43,83
23988,Hao,1,Private room,75,0,0.61,75
23989,William,2,Private room,35,0,0.32,35
23990,Piya,2,Entire home/apt,162,19,1.92,181
23991,Erika,1,Private room,50,157,0.72,207
23993,Janet,2,Private room,75,104,1.21,179
23994,Shauna And Sarah,3,Entire home/apt,50,13,1.14,63
23995,Lisa,2,Private room,130,0,0.04,130
23996,Cyn,2,Private room,75,0,0.1,75
23997,Baden,1,Private room,60,35,4.14,95
23998,Bojana,1,Entire home/apt,125,92,0.88,217
23999,Daniel,1,Entire home/apt,80,0,0.44,80
24000,Tia,3,Entire home/apt,120,7,0.32,127
24001,Esty,2,Entire home/apt,150,120,0.93,270
24002,Yimka,2,Private room,37,0,0.12,37
24004,Liliya,2,Entire home/apt,130,10,1.14,140
24005,Moraa,1,Private room,69,0,0.12,69
24008,Shoshannah,4,Entire home/apt,120,77,1.42,197
24010,Yana,1,Entire home/apt,300,45,0.24,345
24011,Dr. Shirin,3,Private room,70,364,1.29,434
24013,Sarah,2,Entire home/apt,160,9,2.16,169
24014,Dr. Shirin,3,Private room,60,365,1.53,425
24015,Dr. Shirin,3,Private room,70,0,0.89,70
24016,Jules,1,Private room,55,0,0.08,55
24017,Louise,1,Private room,94,0,0.04,94
24018,Maxine,2,Entire home/apt,105,0,0.08,105
24019,Lauren,1,Private room,50,0,0.08,50
24020,Abraham,2,Entire home/apt,87,72,1.36,159
24021,Ana,1,Entire home/apt,299,0,0.04,299
24022,Tala,1,Private room,100,0,0.04,100
24024,Tim,1,Private room,52,0,0.14,52
24025,Victoria,3,Private room,80,0,0.08,80
24026,Mathilde,2,Private room,55,0,0.12,55
24027,Silvia,2,Entire home/apt,81,356,1.82,437
24028,Donna,1,Entire home/apt,185,15,0.88,200
24029,Molly,2,Private room,60,0,0.04,60
24030,Charlene,2,Private room,37,30,2.53,67
24031,Sarah,2,Private room,70,0,0.24,70
24032,Joe,2,Private room,69,0,0.04,69
24033,Genevieve,1,Entire home/apt,191,5,1.5,196
24034,Charlotte And Mary,1,Private room,80,0,0.08,80
24035,Nancy,1,Entire home/apt,250,16,0.58,266
24036,Erin,1,Private room,70,0,0.05,70
24038,Eden,2,Private room,33,0,0.04,33
24039,Carolina,1,Entire home/apt,200,19,0.13,219
24040,Inna,1,Entire home/apt,135,340,0.38,475
24041,Elisa-Beth,2,Private room,49,33,0.23,82
24042,Audrey,1,Entire home/apt,190,0,0.04,190
24043,Zoilo,3,Entire home/apt,80,0,0.48,80
24045,Kateryna & Michael,2,Private room,120,52,0.91,172
24046,Serena,1,Private room,130,0,0.96,130
24047,Annesofie,3,Private room,75,0,0.68,75
24049,Jim&Lisa,3,Private room,120,365,1.87,485
24050,Erik,1,Private room,72,0,0.48,72
24051,Joy,2,Entire home/apt,150,42,3.38,192
24052,Liz,2,Private room,110,269,0.14,379
24053,Jason,3,Entire home/apt,70,3,0.41,73
24054,Bozhena,1,Entire home/apt,179,197,5.77,376
24055,Maria,3,Private room,45,154,1.68,199
24056,Camila,2,Entire home/apt,95,0,0.25,95
24058,Mark,2,Entire home/apt,450,2,0.44,452
24059,Elise,1,Entire home/apt,140,37,0.97,177
24060,Vivianne,1,Private room,89,125,0.91,214
24061,Sherry,3,Entire home/apt,88,0,0.28,88
24062,John,2,Private room,55,24,5.02,79
24063,Samantha,1,Private room,50,0,0.04,50
24064,Andy,1,Private room,95,0,2.23,95
24065,Delton,2,Entire home/apt,124,308,2.67,432
24067,Johny,2,Entire home/apt,165,247,3.3,412
24069,Hangi,1,Private room,100,0,0.04,100
24070,Roger,1,Private room,88,208,2.24,296
24071,Victoria,1,Entire home/apt,200,0,0.29,200
24072,Marlyn,1,Entire home/apt,127,1,3.68,128
24073,Belinda,2,Entire home/apt,133,171,2.98,304
24075,Jessie,1,Private room,35,0,0.17,35
24076,Shannon,2,Private room,69,102,2.53,171
24077,Simon & Jessie,2,Entire home/apt,250,83,0.43,333
24078,Saya,2,Private room,35,36,0.25,71
24079,Daniela,1,Entire home/apt,375,178,0.08,553
24080,Eric,1,Entire home/apt,135,5,0.41,140
24081,Stanley,1,Entire home/apt,175,342,0.06,517
24082,Stanley,1,Entire home/apt,175,365,0.06,540
24083,Coline,2,Private room,60,0,0.51,60
24085,Stephanie,1,Private room,140,177,0.05,317
24086,Wes,2,Private room,80,5,1.26,85
24087,Tim,2,Entire home/apt,160,0,0.24,160
24088,Sasha,2,Private room,70,0,0.12,70
24089,Kyriaki,1,Entire home/apt,145,221,2.13,366
24090,Lydia,1,Entire home/apt,225,79,2.22,304
24091,Andrea,2,Private room,68,0,0.16,68
24092,Zachary,2,Private room,90,0,0.32,90
24093,Chloe,1,Entire home/apt,102,0,0.5,102
24094,Sally,2,Shared room,60,83,0.18,143
24096,Richard,3,Private room,49,65,0.49,114
24097,Leo,2,Private room,70,0,0.12,70
24098,Marie,1,Entire home/apt,150,286,0.17,436
24099,Heidi,1,Entire home/apt,119,0,0.25,119
24100,Mario,1,Shared room,10,0,0.08,10
24101,Nelle,2,Entire home/apt,375,75,0.6,450
24102,Melissa,1,Entire home/apt,175,0,0.08,175
24103,Aristides,1,Entire home/apt,132,198,0.07,330
24104,Benjamin,1,Entire home/apt,200,0,0.04,200
24105,Stanley,1,Entire home/apt,150,344,0.26,494
24106,Denise,2,Private room,45,0,0.08,45
24107,Javier,3,Entire home/apt,150,178,0.81,328
24109,Jillian,2,Private room,60,0,0.23,60
24110,Anthony,1,Entire home/apt,250,0,2.1,250
24111,Shannon,2,Private room,36,81,3.48,117
24114,Irina,1,Entire home/apt,130,333,0.22,463
24115,Joel,1,Entire home/apt,99,0,0.18,99
24116,Ali,4,Private room,50,328,3.43,378
24117,Lin,2,Entire home/apt,155,0,0.16,155
24118,James,3,Private room,166,89,0.36,255
24119,Jhon,3,Private room,40,0,0.65,40
24120,Aj,3,Private room,135,90,0.7,225
24122,Alysse,2,Entire home/apt,140,8,0.58,148
24123,Deeksha,1,Entire home/apt,120,0,0.12,120
24124,Brian,2,Shared room,37,138,0.04,175
24125,Giada,2,Private room,50,0,0.15,50
24126,Jenna,1,Private room,103,0,0.04,103
24127,Jenna,1,Private room,125,0,0.04,125
24128,Michelle & Eddie,3,Entire home/apt,120,230,3.31,350
24129,Luis,2,Private room,65,0,0.75,65
24130,Balwinder,3,Entire home/apt,79,56,11.56,135
24131,Ted,1,Entire home/apt,189,0,0.3,189
24132,Gonzalo,3,Entire home/apt,250,336,3.01,586
24133,Chef Menezes,1,Private room,100,172,2.11,272
24134,Charlie,1,Entire home/apt,105,0,0.97,105
24135,Ebin,1,Private room,36,0,0.45,36
24138,Romé,1,Private room,99,216,1.98,315
24139,Christian,2,Entire home/apt,95,22,2.9,117
24140,Nelson,1,Private room,48,242,2.48,290
24141,Sarah,2,Entire home/apt,126,11,0.25,137
24142,Mariel,1,Private room,135,43,3.32,178
24143,Nabeela,1,Private room,100,66,0.42,166
24144,Jack,2,Entire home/apt,126,0,0.16,126
24145,Val,1,Entire home/apt,150,89,0.54,239
24146,Louie,1,Private room,49,43,1.63,92
24147,Abraham,2,Entire home/apt,88,46,1.26,134
24148,Andrew,2,Entire home/apt,139,93,0.78,232
24149,Jess,1,Private room,65,0,0.08,65
24150,Yuichi,2,Private room,40,0,0.17,40
24151,Miles,1,Entire home/apt,250,0,0.21,250
24152,Hillside Hotel,3,Private room,93,90,0.08,183
24153,Jenny,2,Entire home/apt,125,2,5.78,127
24154,Victoria & Lovely,3,Entire home/apt,85,69,2.48,154
24155,Louisa,2,Entire home/apt,210,50,0.3,260
24156,Hanna,1,Private room,60,42,1.1,102
24158,David,3,Entire home/apt,278,0,0.39,278
24159,David,3,Private room,75,0,0.04,75
24160,Daisy,4,Entire home/apt,85,0,0.08,85
24162,Jangho,2,Private room,35,0,0.22,35
24163,Robb,2,Private room,60,56,0.47,116
24164,John,2,Entire home/apt,225,2,0.37,227
24166,Annie,1,Entire home/apt,250,237,1.1,487
24167,Sabrina,2,Entire home/apt,60,5,0.65,65
24168,Samantha,2,Private room,62,21,1.92,83
24170,Andrew,1,Entire home/apt,250,165,0.91,415
24171,Landon,2,Entire home/apt,150,14,0.38,164
24172,Keisha,2,Entire home/apt,180,73,1.91,253
24173,Yaacov,1,Entire home/apt,265,345,0.3,610
24174,Jenny,1,Entire home/apt,173,0,0.13,173
24175,Laura,3,Private room,60,0,0.04,60
24176,Felicia,1,Private room,85,359,1.22,444
24177,Maya,1,Entire home/apt,150,0,0.16,150
24178,Keir,1,Entire home/apt,250,0,0.63,250
24179,Val,1,Private room,28,0,0.78,28
24180,Jonathan,3,Private room,60,0,0.13,60
24181,Carla,2,Private room,25,319,1.17,344
24182,Ibrahim,2,Entire home/apt,256,166,2.52,422
24183,Justin,1,Private room,70,0,0.45,70
24184,Charly,2,Entire home/apt,70,0,0.04,70
24186,Cardelle,1,Private room,65,0,0.24,65
24189,Milo,1,Private room,72,0,0.26,72
24190,Keianna,1,Shared room,40,0,0.12,40
24191,Juliana,2,Private room,80,13,0.36,93
24192,Filip,1,Entire home/apt,230,0,0.31,230
24193,Beau,1,Entire home/apt,119,0,0.17,119
24194,Wendy,2,Entire home/apt,389,80,4.4,469
24195,Sydney,1,Entire home/apt,180,0,0.16,180
24196,Leah,2,Private room,40,0,0.12,40
24198,Linda,1,Private room,135,4,1.02,139
24199,Krystin,1,Entire home/apt,139,0,0.04,139
24200,Natasha,1,Shared room,50,188,0.86,238
24201,David,1,Private room,54,0,0.69,54
24203,Arthur,1,Private room,99,157,3.36,256
24204,Arthur,1,Private room,99,342,2.96,441
24205,CK & Tia,1,Private room,82,323,3.9,405
24207,Alena,2,Private room,65,69,5.25,134
24208,Marie,1,Entire home/apt,225,30,0.55,255
24210,Laura,2,Entire home/apt,120,70,1.56,190
24211,Daniele,1,Private room,165,179,0.18,344
24212,Nicholas,1,Private room,149,0,0.37,149
24214,Lucky Day,3,Entire home/apt,248,262,0.73,510
24215,Gabe,2,Private room,44,0,0.08,44
24216,Adrienne Miriam,2,Entire home/apt,150,330,1.96,480
24217,Will,2,Private room,89,40,1.12,129
24219,Igor,3,Private room,900,296,5.37,1196
24220,Colin,1,Entire home/apt,275,5,0.65,280
24221,Shmuel,2,Entire home/apt,200,32,0.46,232
24222,Sylvia,2,Entire home/apt,115,0,0.22,115
24223,Amber+Shawn,2,Private room,100,84,0.08,184
24224,Nick,5,Entire home/apt,91,205,2.6,296
24225,William,1,Entire home/apt,200,250,1.36,450
24226,Tanya,2,Private room,39,0,0.04,39
24227,Vikas,2,Entire home/apt,275,213,0.58,488
24229,Nelli,2,Private room,50,20,0.99,70
24230,David,2,Private room,79,69,0.19,148
24231,William,2,Private room,80,82,4.35,162
24232,Sasha,4,Entire home/apt,127,250,0.19,377
24233,Lou,1,Entire home/apt,110,26,2.49,136
24234,Adrian,2,Entire home/apt,167,326,0.19,493
24235,Andrew,1,Entire home/apt,145,0,0.37,145
24236,Rebeccah & Daniel,2,Entire home/apt,174,123,3.39,297
24237,Oceane,3,Entire home/apt,119,0,0.04,119
24238,Taina,4,Private room,62,175,0.67,237
24240,Bing,3,Private room,60,356,2.03,416
24241,Ian,2,Private room,50,0,0.12,50
24242,Andrew,2,Entire home/apt,139,178,2.9,317
24243,Weisbrod,2,Entire home/apt,200,363,0.31,563
24245,Olivia,2,Private room,43,301,0.23,344
24246,Lin,2,Entire home/apt,80,0,0.04,80
24247,Ryan,1,Entire home/apt,180,0,0.2,180
24248,Yan,2,Private room,54,63,3.72,117
24249,Hichem,1,Private room,75,0,0.74,75
24252,Francisco,1,Entire home/apt,200,0,0.29,200
24253,Oscar,2,Entire home/apt,95,199,1.4,294
24254,Anne A,1,Private room,80,0,1.44,80
24255,Yan,2,Private room,63,39,2.68,102
24256,Igor,2,Shared room,32,343,0.09,375
24257,Igor,2,Shared room,32,320,0.09,352
24258,Sean,3,Entire home/apt,275,293,4.29,568
24259,Yoon,2,Entire home/apt,70,0,0.19,70
24260,Gulcin,1,Private room,70,249,4.74,319
24261,Bilal,1,Entire home/apt,400,180,0.58,580
24262,Yuriy,1,Entire home/apt,100,0,0.08,100
24264,Alina,2,Private room,100,8,0.33,108
24266,Remi,2,Private room,36,0,0.04,36
24268,Logan,1,Entire home/apt,175,142,0.16,317
24269,Alona,3,Entire home/apt,93,73,7.64,166
24270,Harry,3,Private room,150,178,1.19,328
24272,Georgia,1,Entire home/apt,499,365,0.44,864
24274,Shaunda,1,Entire home/apt,175,0,0.45,175
24275,Richard,1,Private room,129,0,0.73,129
24276,The,2,Entire home/apt,225,278,3.49,503
24277,Yiska,1,Entire home/apt,68,0,0.09,68
24278,Stephanie,1,Entire home/apt,250,0,0.95,250
24279,Novi,3,Entire home/apt,49,22,0.96,71
24281,Joe,2,Entire home/apt,400,0,0.25,400
24282,Emily,1,Private room,80,0,0.16,80
24284,Scott,2,Entire home/apt,135,302,5.55,437
24285,Alex,1,Entire home/apt,220,239,5.28,459
24286,Logan,1,Entire home/apt,2500,0,0.91,2500
24287,Gulcin,1,Private room,60,257,4.13,317
24290,Marlon,1,Private room,50,15,0.68,65
24291,Stanley,1,Entire home/apt,175,365,0.05,540
24292,Ze,1,Private room,140,22,0.21,162
24294,Bing,3,Private room,54,85,2.86,139
24295,Halima,2,Entire home/apt,91,234,0.53,325
24297,Kyla,2,Entire home/apt,200,201,3.51,401
24298,Steven,1,Private room,70,28,5.39,98
24299,Kiki,1,Private room,77,116,1.49,193
24300,Yassir,1,Entire home/apt,100,0,0.15,100
24302,Sasha,2,Private room,70,0,0.08,70
24303,Zhana And Adam,2,Entire home/apt,250,13,1.27,263
24304,John,1,Entire home/apt,175,0,0.29,175
24305,Carlo,1,Private room,106,10,1.05,116
24306,Alec,2,Private room,49,0,0.08,49
24307,Megan,2,Entire home/apt,200,0,0.38,200
24308,Romana,2,Entire home/apt,100,0,0.21,100
24309,Marie,1,Entire home/apt,150,141,0.58,291
24312,Alexander,2,Private room,45,0,0.25,45
24313,Tonisha,2,Private room,58,0,0.59,58
24314,Erik,1,Private room,94,54,2.69,148
24315,Corinne,3,Private room,75,0,0.17,75
24316,Jeffrey,2,Entire home/apt,95,248,0.09,343
24317,Elena,1,Private room,79,258,2.58,337
24320,Adam,3,Private room,40,0,0.04,40
24321,Juan,2,Shared room,34,192,3.42,226
24322,Brama,2,Private room,45,0,0.04,45
24323,Helen,2,Private room,32,0,0.12,32
24324,Marie,1,Entire home/apt,190,277,0.57,467
24325,Ali,3,Entire home/apt,138,322,0.89,460
24326,Yaneli,4,Private room,75,364,0.57,439
24327,Linda,3,Private room,110,0,1.03,110
24328,Jane,2,Entire home/apt,264,167,5.3,431
24329,Dorothea,1,Private room,120,64,0.62,184
24330,Ali,3,Entire home/apt,298,174,1.34,472
24331,Ali,3,Entire home/apt,150,343,2.27,493
24332,Ali,3,Entire home/apt,398,139,2.11,537
24333,Meera,3,Entire home/apt,155,308,4.12,463
24335,Marie,1,Entire home/apt,120,66,0.34,186
24336,Amanda,4,Private room,29,0,0.04,29
24337,Ricky,1,Entire home/apt,160,0,0.3,160
24338,George,3,Entire home/apt,150,288,1.07,438
24339,Tal & Amarelle,2,Entire home/apt,100,128,2.81,228
24340,Ariana,1,Entire home/apt,150,8,0.27,158
24343,Claudio,2,Private room,85,5,0.54,90
24344,Dan,1,Private room,85,0,0.08,85
24346,Barron,1,Private room,45,17,0.06,62
24348,Cathy,1,Private room,165,0,0.13,165
24349,Yan,2,Private room,64,63,3.13,127
24350,Norma,3,Private room,60,177,0.99,237
24351,Jeffrey,1,Private room,101,0,0.08,101
24352,Chen,1,Private room,50,0,0.12,50
24354,Ben,2,Private room,100,251,3.61,351
24356,Yan,2,Private room,53,61,3.59,114
24357,Megan,2,Private room,44,0,0.16,44
24358,Farheen,1,Private room,90,0,0.17,90
24360,Alana,2,Entire home/apt,215,31,3.08,246
24361,Jeremy,2,Entire home/apt,150,263,2.85,413
24362,Shana,1,Entire home/apt,150,0,0.12,150
24364,Casandra,1,Entire home/apt,325,294,3.27,619
24365,Caroline,1,Entire home/apt,155,0,0.16,155
24366,Shelly & Wayne,2,Entire home/apt,100,78,3.13,178
24367,Jennifer,2,Entire home/apt,115,86,0.36,201
24368,StayWithaTravelWriter,2,Shared room,59,90,1.8,149
24370,Brian,2,Entire home/apt,110,12,0.14,122
24371,Giselle,3,Entire home/apt,150,0,0.17,150
24372,Nicole,1,Private room,75,77,1.91,152
24373,Yaz,1,Private room,100,0,0.5,100
24374,John,1,Private room,175,90,0.35,265
24375,Javier,2,Private room,90,43,2.07,133
24377,Michael & Sharon,3,Entire home/apt,150,132,3.52,282
24378,Leah,1,Entire home/apt,148,0,0.09,148
24379,Belgica,2,Entire home/apt,100,46,4.37,146
24380,Mike,3,Entire home/apt,188,151,3.52,339
24381,Alican,2,Private room,43,3,0.34,46
24382,Maria,1,Private room,110,0,3.38,110
24384,Alexander,1,Entire home/apt,200,0,0.43,200
24385,Anna,1,Private room,120,188,1.31,308
24387,David,2,Private room,42,0,0.06,42
24388,Caleb,2,Private room,60,0,0.16,60
24390,Simranjeet,5,Private room,40,286,1.6,326
24391,Magdalena,3,Entire home/apt,140,0,0.17,140
24392,Nicholas,1,Entire home/apt,116,0,1.22,116
24394,Michael,2,Entire home/apt,181,0,0.12,181
24395,Florangie,1,Private room,70,8,0.37,78
24396,Jannices,2,Entire home/apt,169,241,3.58,410
24397,Kay,3,Entire home/apt,105,319,2.49,424
24398,Linett,1,Private room,55,0,0.33,55
24399,Cesare Friend,1,Entire home/apt,163,266,1.16,429
24400,Safiah,3,Private room,75,0,0.23,75
24401,Hope,2,Entire home/apt,225,350,2.98,575
24402,Carmine,1,Private room,110,99,0.06,209
24403,Elan,2,Private room,29,16,2.1,45
24404,Karanja,2,Private room,55,163,0.67,218
24405,J,1,Entire home/apt,102,0,1.85,102
24406,Katie Knapp,1,Entire home/apt,130,29,1.71,159
24407,Michelle,2,Entire home/apt,350,281,2.37,631
24408,Yan,2,Private room,53,30,2.75,83
24409,Jordon,1,Private room,69,0,0.25,69
24410,Dim,1,Entire home/apt,130,202,4.5,332
24411,Anamaria,4,Entire home/apt,140,0,0.08,140
24414,Lucia,4,Entire home/apt,100,14,0.58,114
24415,Nadia,3,Private room,125,364,0.13,489
24416,Simon,1,Private room,125,87,1.0,212
24417,Maggie,3,Entire home/apt,60,0,2.2,60
24418,Una,2,Private room,88,0,1.04,88
24419,Stella,4,Private room,39,39,2.38,78
24420,Laura,2,Entire home/apt,48,17,3.62,65
24421,FuKang,3,Private room,60,335,1.42,395
24422,Daniel,1,Entire home/apt,75,0,0.04,75
24423,Asif,2,Private room,55,5,0.47,60
24424,Yan,2,Private room,51,55,3.4,106
24425,Yan,2,Private room,54,57,2.75,111
24426,Yan,2,Private room,52,68,3.04,120
24427,Hayley,1,Entire home/apt,117,0,0.33,117
24428,Yan,2,Private room,62,65,2.83,127
24429,Yan,2,Private room,63,51,2.02,114
24430,Susan,2,Private room,120,0,0.38,120
24431,Dr. Shirin,3,Private room,45,0,0.58,45
24432,Kyle,2,Private room,52,0,0.13,52
24433,Meredith,1,Private room,42,0,0.13,42
24434,Robert,2,Entire home/apt,175,84,2.74,259
24435,Richard,3,Entire home/apt,142,117,0.46,259
24436,Lauren,1,Private room,80,0,0.34,80
24437,Suzy,2,Private room,42,35,0.33,77
24438,Nikki,2,Private room,90,0,1.07,90
24439,Nicholas,2,Private room,50,0,0.04,50
24440,Kyle,2,Private room,52,0,0.18,52
24442,Wiler,3,Entire home/apt,125,347,2.08,472
24443,Yaniv,1,Private room,105,0,3.76,105
24444,Livienne,2,Entire home/apt,100,202,3.73,302
24445,Farida,2,Private room,31,0,0.17,31
24446,Jordan,2,Private room,45,0,0.58,45
24447,Juan,2,Private room,50,0,0.12,50
24448,Miguel,2,Private room,60,0,0.08,60
24449,Dorian,1,Private room,80,6,1.93,86
24450,Ro-E,1,Entire home/apt,180,0,0.04,180
24453,Yesenia,4,Shared room,70,0,0.11,70
24454,Scott,2,Private room,60,52,1.96,112
24456,Camille,2,Private room,40,0,0.12,40
24457,Marci,2,Entire home/apt,99,74,2.48,173
24458,Jeffrey,1,Private room,125,28,2.19,153
24459,Reuben,5,Private room,34,78,0.65,112
24460,Arelis,1,Entire home/apt,100,0,0.66,100
24461,M,1,Private room,115,129,3.92,244
24462,Stanley,1,Entire home/apt,170,323,0.22,493
24463,Marcelo,1,Entire home/apt,200,0,4.9,200
24464,Stanley,1,Entire home/apt,175,353,0.09,528
24465,Tal,2,Entire home/apt,100,0,0.37,100
24466,Kamilah,2,Private room,50,0,0.09,50
24467,Karina,1,Entire home/apt,220,232,3.26,452
24468,Frances,2,Private room,50,39,0.52,89
24469,Tamera,2,Entire home/apt,275,0,0.09,275
24470,Daniel,2,Entire home/apt,200,0,0.9,200
24471,Ashley,2,Private room,115,0,2.98,115
24472,Yuval,2,Private room,60,128,5.36,188
24473,Misha,2,Private room,54,0,0.08,54
24474,Brandon,2,Private room,55,241,0.1,296
24475,Dane,2,Private room,44,0,0.54,44
24476,Rebecca,2,Entire home/apt,70,4,0.12,74
24478,Margarita,2,Entire home/apt,135,3,2.31,138
24479,Atif,1,Entire home/apt,138,0,0.17,138
24480,Andre,1,Private room,115,0,0.74,115
24482,Andrea,1,Entire home/apt,150,94,2.61,244
24483,Joanne,3,Entire home/apt,150,0,0.35,150
24484,Carolyn,2,Entire home/apt,170,0,0.04,170
24485,Marie,1,Entire home/apt,140,153,0.27,293
24489,Greg,2,Private room,65,0,0.29,65
24490,Madalyn,1,Entire home/apt,102,0,0.77,102
24491,Samuel,2,Entire home/apt,175,0,0.34,175
24492,Andrea,1,Entire home/apt,275,0,0.67,275
24493,Andrew,1,Entire home/apt,145,267,2.55,412
24494,Karen,1,Entire home/apt,700,124,0.62,824
24495,Kathy,1,Entire home/apt,239,266,0.08,505
24496,Lauren & Ron,1,Entire home/apt,65,103,4.67,168
24497,Edwin,2,Entire home/apt,250,333,0.13,583
24498,Philip,2,Private room,90,79,3.29,169
24499,Danielle,2,Entire home/apt,85,171,2.85,256
24500,Michael,2,Entire home/apt,170,9,0.86,179
24501,Jacqueline,1,Private room,60,0,1.09,60
24502,Natalia & Gustavo,2,Private room,50,89,0.35,139
24504,Renee,2,Entire home/apt,152,0,0.13,152
24505,Lilia,3,Private room,62,318,2.31,380
24506,Chelsea,2,Private room,70,55,0.04,125
24508,Theresa,1,Entire home/apt,150,0,0.41,150
24509,Frances,2,Entire home/apt,100,56,1.57,156
24510,Harry,3,Private room,110,358,1.4,468
24511,Tutti,2,Private room,60,0,0.25,60
24512,Julian,1,Entire home/apt,700,0,0.04,700
24514,Alina,1,Private room,73,0,0.3,73
24515,Marija,1,Entire home/apt,100,60,3.12,160
24516,Russell,4,Entire home/apt,58,42,2.89,100
24517,Jamie,2,Entire home/apt,200,0,0.09,200
24518,Avremi And Shmuly,2,Private room,70,0,0.21,70
24519,Marie,1,Entire home/apt,140,267,0.09,407
24520,Ali,3,Private room,45,14,0.5,59
24521,Anne,1,Entire home/apt,98,0,0.09,98
24522,Joffrey,1,Entire home/apt,150,157,0.89,307
24524,Sarah,2,Entire home/apt,299,27,0.27,326
24525,Maurice,1,Private room,60,0,0.25,60
24527,Annelise,3,Entire home/apt,140,36,0.38,176
24528,Gia,1,Entire home/apt,150,3,3.67,153
24530,Jūrate,2,Private room,70,0,0.6,70
24531,Valentina,2,Private room,40,0,0.71,40
24532,Jessica,2,Private room,45,0,0.04,45
24533,Luca,1,Private room,67,179,1.22,246
24534,Paula,2,Entire home/apt,290,299,2.07,589
24535,Andrea,2,Entire home/apt,150,0,0.25,150
24536,Inna,1,Entire home/apt,159,358,0.18,517
24537,Edward,2,Entire home/apt,77,0,0.18,77
24538,Eileen,1,Entire home/apt,175,0,0.88,175
24539,Kevin,2,Entire home/apt,85,120,7.65,205
24540,Townsend,1,Entire home/apt,1000,79,0.06,1079
24541,Deonisis,1,Private room,60,67,6.03,127
24543,Anna,2,Private room,55,0,0.04,55
24544,Jimmy &Cindy,3,Private room,48,360,2.28,408
24546,Aldi,1,Entire home/apt,200,351,0.69,551
24547,Thomas,1,Private room,56,0,0.42,56
24549,Eryka,2,Private room,114,114,1.82,228
24550,Jonathan,2,Entire home/apt,200,317,1.37,517
24551,Jess,2,Entire home/apt,125,0,0.04,125
24552,Marta,3,Private room,60,335,2.24,395
24553,Kristen,2,Private room,40,22,0.41,62
24554,Gosia,2,Entire home/apt,105,0,1.01,105
24555,Kristen,1,Private room,70,0,0.04,70
24556,Alexa,3,Entire home/apt,108,329,0.85,437
24557,Caroline,2,Private room,60,0,0.04,60
24558,Lester And Shirell,2,Entire home/apt,130,211,2.3,341
24559,Victor-Andres,3,Private room,30,0,0.42,30
24560,Ron And Khine,3,Entire home/apt,135,0,0.21,135
24562,Roxana,1,Entire home/apt,79,15,0.35,94
24563,Bianca And Jordan,2,Entire home/apt,146,200,1.66,346
24564,Parsa,2,Private room,57,0,0.04,57
24565,Michael,1,Entire home/apt,250,0,0.16,250
24566,Stanley,1,Entire home/apt,150,320,0.07,470
24567,Deb,4,Entire home/apt,85,168,1.76,253
24569,Peter A.,1,Private room,67,0,0.21,67
24570,J.F.,4,Private room,35,76,0.17,111
24572,Michka,1,Private room,100,0,0.25,100
24573,Bartek,2,Private room,47,0,0.33,47
24574,Laura,1,Private room,46,12,0.96,58
24575,Roberto,2,Private room,50,343,0.66,393
24576,Ellie,2,Private room,65,179,0.83,244
24579,Melvin & Maya,2,Private room,110,0,0.41,110
24580,Akiko,3,Private room,48,8,2.17,56
24581,Noel,2,Private room,45,0,0.04,45
24582,Russ,2,Entire home/apt,140,0,0.2,140
24583,Viviana,1,Private room,45,252,1.78,297
24585,Brittani,3,Entire home/apt,137,0,0.12,137
24586,Matan,2,Entire home/apt,170,3,0.53,173
24588,Switch,1,Entire home/apt,198,0,0.19,198
24589,Kat,1,Private room,100,0,0.61,100
24590,Jamie,3,Shared room,33,0,0.46,33
24591,Josh,1,Private room,70,0,0.06,70
24592,Stacy & Simon,2,Private room,42,114,1.81,156
24593,Alice,3,Entire home/apt,139,101,1.74,240
24595,Andreas,2,Entire home/apt,180,4,0.64,184
24596,Agraj,3,Private room,60,0,1.09,60
24597,Anna,1,Entire home/apt,275,106,0.86,381
24598,Igor,1,Private room,59,0,0.04,59
24599,Roshumba,2,Entire home/apt,167,294,4.27,461
24600,Daniel,1,Private room,95,229,1.05,324
24601,Anna,1,Private room,50,0,0.62,50
24602,Jing,1,Entire home/apt,200,0,0.47,200
24604,Ntifafa Akoko,1,Entire home/apt,100,1,1.15,101
24605,Daniel,1,Entire home/apt,94,0,0.33,94
24607,Hillside Hotel,3,Private room,135,180,0.05,315
24608,Naheima,2,Entire home/apt,550,97,0.22,647
24609,Junior,4,Private room,80,88,0.09,168
24610,Suzy,2,Entire home/apt,68,286,0.43,354
24611,Amie,3,Private room,63,0,0.26,63
24612,Mervin (Michael),5,Private room,83,188,0.24,271
24613,Marian,3,Entire home/apt,60,336,2.41,396
24614,Inna,1,Entire home/apt,155,333,0.37,488
24616,Karen,2,Private room,75,0,0.29,75
24618,Debra,2,Private room,35,16,0.66,51
24619,Stanislas,2,Private room,70,0,0.04,70
24620,Dan,2,Entire home/apt,195,0,0.13,195
24621,Iris,4,Private room,75,246,1.74,321
24622,Evgenia,2,Entire home/apt,98,0,0.04,98
24623,Gharet,1,Entire home/apt,100,0,0.05,100
24624,Alana,2,Private room,57,83,0.27,140
24625,Madison,1,Entire home/apt,200,20,1.14,220
24626,Stephen,1,Shared room,350,0,0.26,350
24627,Miranda,1,Entire home/apt,145,0,0.12,145
24628,Chris And Nina,3,Entire home/apt,170,305,2.91,475
24629,Alan,3,Entire home/apt,180,320,0.12,500
24630,Bismillah,2,Entire home/apt,200,124,1.54,324
24632,Jeff,2,Entire home/apt,789,175,2.12,964
24633,Esperanza,2,Private room,60,248,0.7,308
24635,Marta,3,Entire home/apt,140,190,1.56,330
24636,Jie,3,Entire home/apt,89,0,4.38,89
24637,Laila,1,Entire home/apt,150,9,1.17,159
24638,Seda,2,Entire home/apt,127,286,2.48,413
24639,Andrea,2,Private room,110,173,0.89,283
24640,Reisha,1,Entire home/apt,123,0,1.08,123
24641,Patrick,1,Private room,81,111,2.47,192
24642,Ronnie,2,Private room,44,0,0.29,44
24644,Assol,2,Entire home/apt,100,0,0.68,100
24645,Daniel,1,Entire home/apt,305,58,1.29,363
24646,Larissa,1,Private room,85,0,0.34,85
24647,Adam,2,Private room,65,0,0.04,65
24648,Giulia,2,Private room,90,0,0.12,90
24649,Mathilde,3,Private room,50,0,0.05,50
24650,Stephen,2,Entire home/apt,100,0,0.21,100
24651,Simone,1,Entire home/apt,176,0,0.13,176
24652,Caitlin,2,Entire home/apt,100,4,0.5,104
24653,Jewel,1,Private room,187,0,0.26,187
24654,Richard,3,Private room,70,65,0.3,135
24655,Watson,1,Private room,76,11,3.33,87
24657,Bobi,1,Private room,43,161,3.55,204
24659,Julia,1,Private room,65,76,0.1,141
24660,Trudy,3,Private room,50,251,1.23,301
24661,Veronica,3,Shared room,37,365,0.75,402
24662,David,3,Private room,48,0,0.13,48
24663,Deniz,1,Entire home/apt,300,9,0.67,309
24664,Mike,1,Entire home/apt,135,0,0.12,135
24665,Roni,1,Private room,135,75,1.4,210
24666,Justin,1,Private room,72,61,0.9,133
24668,Eddie,1,Private room,120,0,0.04,120
24670,Jiwon,1,Entire home/apt,128,0,0.17,128
24672,David,2,Entire home/apt,100,0,0.09,100
24673,Emily,1,Entire home/apt,190,330,0.36,520
24674,Naheima,2,Entire home/apt,150,328,2.9,478
24675,Marie,1,Private room,50,0,0.13,50
24678,Chris,2,Entire home/apt,175,152,4.23,327
24679,Yuval,1,Entire home/apt,229,0,0.05,229
24680,Jane,1,Private room,95,54,0.04,149
24681,Justin,2,Private room,84,0,0.04,84
24682,Paul,1,Entire home/apt,80,28,1.55,108
24683,Linda And Liz,3,Private room,120,222,4.75,342
24684,Nina,2,Entire home/apt,100,250,0.25,350
24685,Chris,1,Entire home/apt,210,234,5.73,444
24686,Brock,2,Entire home/apt,260,88,0.68,348
24687,Livia,2,Entire home/apt,99,325,1.92,424
24688,Sahar,1,Private room,125,340,3.35,465
24690,Taylor,2,Private room,80,51,4.09,131
24691,Natalie And Vince,1,Private room,69,0,0.72,69
24692,Jennifer,2,Private room,48,214,0.19,262
24693,Eileen,2,Private room,40,0,0.09,40
24694,C Lum,1,Private room,135,95,0.22,230
24695,Yolanda,2,Entire home/apt,103,291,1.52,394
24696,Steve,3,Entire home/apt,110,27,0.84,137
24697,Leeron,1,Private room,50,0,0.31,50
24699,Moheb,1,Entire home/apt,125,0,1.56,125
24700,Gio,1,Private room,129,116,4.49,245
24701,Gio,1,Private room,129,111,4.61,240
24702,Gio,1,Private room,129,132,4.03,261
24703,Emily,1,Entire home/apt,190,334,0.43,524
24704,Mariame,4,Private room,65,0,0.11,65
24705,Brendan,1,Private room,99,0,4.66,99
24706,Erykah,1,Private room,60,95,0.66,155
24707,Awilda,2,Entire home/apt,89,0,2.38,89
24708,Ward,2,Private room,75,96,2.24,171
24709,Rachel,1,Entire home/apt,187,5,0.33,192
24710,Martin,3,Entire home/apt,95,0,0.79,95
24712,Sherry  W  X,2,Entire home/apt,160,294,2.24,454
24713,Neha,1,Entire home/apt,140,0,0.13,140
24714,Mendy,2,Private room,90,45,1.59,135
24715,Angele,3,Entire home/apt,200,247,0.45,447
24716,Willy,3,Private room,48,111,2.09,159
24717,Thomas,1,Private room,69,0,0.09,69
24718,Chadanut,2,Private room,45,7,0.96,52
24719,Jewell,2,Private room,90,89,0.2,179
24720,Kwam,3,Private room,45,0,0.13,45
24721,Pamela,1,Entire home/apt,110,244,1.72,354
24725,Jeanie,2,Private room,45,0,0.38,45
24726,Michael,1,Entire home/apt,125,0,0.08,125
24727,Ariel,1,Entire home/apt,325,2,0.89,327
24728,Ivan,2,Private room,55,24,3.72,79
24729,Di,3,Private room,39,0,1.22,39
24730,Dominic,3,Private room,85,0,0.21,85
24731,Marie,2,Private room,80,0,0.04,80
24732,Bennett,2,Entire home/apt,124,63,4.71,187
24733,Jasmine,1,Entire home/apt,120,0,0.94,120
24734,Kelly,1,Entire home/apt,120,0,0.34,120
24735,Erin,2,Entire home/apt,198,0,0.18,198
24736,Michael,1,Private room,55,0,0.08,55
24737,Sharif J.,1,Entire home/apt,100,0,0.42,100
24738,Karen,2,Entire home/apt,225,0,0.65,225
24740,Andrew,2,Private room,57,0,0.09,57
24741,Ariel,2,Private room,95,67,0.04,162
24743,Gina,2,Entire home/apt,200,0,0.16,200
24744,Julia,4,Private room,80,358,1.33,438
24745,Zaid,2,Entire home/apt,116,0,0.26,116
24747,Fanny,3,Private room,45,0,1.85,45
24749,Umberto,3,Entire home/apt,150,36,0.12,186
24750,Katherine,1,Entire home/apt,120,128,0.46,248
24751,Michael,2,Entire home/apt,99,0,0.3,99
24753,Luke,1,Entire home/apt,150,0,0.13,150
24755,Mac,2,Entire home/apt,210,0,0.96,210
24756,Sidney,2,Private room,55,0,0.29,55
24757,Sean And Kat,2,Entire home/apt,108,0,0.26,108
24758,Tatianna,1,Private room,50,0,0.22,50
24759,Sasha,4,Entire home/apt,72,223,0.12,295
24760,Dine,5,Private room,33,197,2.78,230
24761,Eli,1,Entire home/apt,500,0,0.05,500
24762,Stacy & Simon,2,Private room,42,202,1.97,244
24763,Celia,1,Private room,87,31,1.41,118
24764,Becky,4,Private room,45,54,0.96,99
24765,Stephen,2,Entire home/apt,150,158,0.34,308
24766,Edwin,2,Entire home/apt,170,323,3.24,493
24767,Alina,2,Private room,75,53,0.34,128
24768,Peter,2,Entire home/apt,200,127,2.15,327
24771,Raymundo,2,Private room,60,0,0.08,60
24772,Tak,2,Private room,59,0,0.07,59
24773,Reina,2,Private room,49,258,4.99,307
24774,Emma,1,Entire home/apt,150,0,0.28,150
24775,Deniz,1,Private room,77,0,0.84,77
24776,Oscar,2,Entire home/apt,99,0,0.38,99
24777,Coline,2,Entire home/apt,120,2,0.25,122
24780,Amanda,2,Private room,60,0,0.68,60
24781,Camaron,1,Entire home/apt,250,6,0.11,256
24782,Joel,3,Private room,30,0,0.08,30
24783,Richard,1,Private room,99,24,0.89,123
24784,Stacy & Simon,2,Private room,42,74,1.42,116
24785,Careff,2,Private room,90,170,1.43,260
24786,Claudia,1,Private room,48,0,0.04,48
24787,Kesaun,1,Private room,55,0,0.3,55
24788,Vasiliki,3,Entire home/apt,40,7,0.22,47
24789,Daniela,1,Entire home/apt,200,27,0.38,227
24790,Steven,2,Entire home/apt,100,0,0.08,100
24791,Kat,2,Private room,107,90,1.0,197
24794,Emily,1,Entire home/apt,225,286,0.9,511
24795,Iquane,2,Private room,27,112,2.88,139
24796,Jill,2,Entire home/apt,101,0,0.64,101
24797,Emily,1,Entire home/apt,255,254,0.26,509
24798,Emily,1,Entire home/apt,320,261,0.38,581
24799,Josie,2,Entire home/apt,87,0,0.09,87
24800,Cedric,1,Entire home/apt,60,0,0.25,60
24801,Nini,1,Entire home/apt,199,297,1.52,496
24802,Gulcin,1,Entire home/apt,320,249,0.1,569
24803,Sebastian,2,Private room,88,0,0.33,88
24804,Jacquelyn,1,Private room,115,0,0.12,115
24805,Christine,2,Private room,85,0,0.48,85
24808,Ayodeji,1,Private room,100,0,0.25,100
24809,Anh,1,Private room,100,0,0.04,100
24810,Thelma,5,Entire home/apt,135,354,0.88,489
24811,Mariano,1,Entire home/apt,150,64,0.17,214
24812,Merve,1,Entire home/apt,250,0,0.13,250
24813,Magnus,2,Entire home/apt,125,3,0.09,128
24814,Komail,1,Entire home/apt,160,0,0.89,160
24815,Aleksandr,2,Entire home/apt,95,111,0.68,206
24816,Helen,2,Entire home/apt,250,118,0.33,368
24817,Michael,1,Entire home/apt,175,0,0.13,175
24818,Richard,1,Entire home/apt,150,65,0.27,215
24821,Tamar,2,Entire home/apt,110,18,0.04,128
24822,Anne,2,Entire home/apt,92,0,0.13,92
24823,William,2,Entire home/apt,95,13,1.22,108
24824,Gian Marco,1,Entire home/apt,280,84,0.39,364
24825,Chloe,2,Entire home/apt,275,0,0.08,275
24826,Laura,2,Private room,60,0,0.08,60
24827,Mischa,1,Private room,110,350,0.11,460
24829,Nicole,3,Private room,65,155,0.42,220
24831,Kate,1,Entire home/apt,200,0,0.38,200
24832,Shuly,3,Private room,59,342,4.19,401
24833,Shuly,3,Private room,55,332,2.93,387
24834,Shuly,3,Private room,60,320,3.35,380
24835,Jowelle,1,Entire home/apt,199,266,2.52,465
24836,Max,2,Entire home/apt,120,0,0.17,120
24837,Nate,2,Private room,35,0,0.05,35
24838,Lisa& Jonathan,2,Private room,79,353,3.53,432
24839,Laura,2,Private room,65,2,0.65,67
24840,Callie,2,Private room,65,0,0.34,65
24841,Luisa,2,Entire home/apt,85,49,0.32,134
24842,Victor,4,Entire home/apt,250,289,2.18,539
24843,Ethan,1,Private room,246,365,0.42,611
24844,Stanley,1,Entire home/apt,150,365,0.05,515
24845,Ryan,2,Entire home/apt,250,87,2.99,337
24846,Simranjeet,5,Private room,34,293,1.03,327
24847,Tatum,3,Entire home/apt,80,0,0.21,80
24848,Simranjeet,5,Private room,35,346,0.84,381
24850,Simranjeet,5,Private room,33,356,1.3,389
24851,Irina,1,Entire home/apt,130,337,0.37,467
24852,Tiffany,1,Entire home/apt,350,365,0.05,715
24853,Daniel,3,Private room,60,353,1.14,413
24855,Jesse,2,Private room,65,81,0.09,146
24857,Tanya,2,Private room,100,0,0.05,100
24858,Katie,1,Entire home/apt,219,338,2.82,557
24859,Lauren,2,Entire home/apt,90,0,0.17,90
24860,Peggy,2,Private room,46,4,0.17,50
24861,Victoria,1,Entire home/apt,200,35,3.13,235
24862,Christopher,2,Entire home/apt,160,123,5.6,283
24864,Charlie Manuel,1,Entire home/apt,350,54,0.21,404
24865,Elliott,2,Entire home/apt,88,0,0.08,88
24867,Zaher,2,Entire home/apt,175,24,1.28,199
24869,Aishling,1,Entire home/apt,105,19,0.22,124
24870,Irina,1,Entire home/apt,160,339,0.32,499
24872,Anne,2,Entire home/apt,200,0,0.31,200
24873,Philip,2,Private room,97,85,2.38,182
24874,Husain,1,Private room,89,0,0.04,89
24875,J,1,Entire home/apt,225,90,0.52,315
24876,Irina,1,Entire home/apt,130,311,0.34,441
24877,Liana,2,Private room,50,0,0.06,50
24878,Kristin,1,Private room,125,0,0.8,125
24879,Josh,2,Entire home/apt,149,74,0.38,223
24880,Kinser,2,Shared room,200,179,0.04,379
24881,Marino,2,Private room,60,0,0.04,60
24882,Jason,2,Entire home/apt,200,0,0.77,200
24884,Michelle,1,Private room,55,0,0.09,55
24885,Kizzie,2,Entire home/apt,78,237,0.17,315
24886,Liad,2,Entire home/apt,275,0,0.15,275
24887,Alain,2,Private room,140,0,0.21,140
24888,Robin,2,Entire home/apt,214,211,1.57,425
24889,Vladimir,3,Private room,65,328,0.56,393
24890,Shelley,2,Entire home/apt,75,0,0.13,75
24891,Shuly,3,Private room,45,296,3.13,341
24892,Sherry  W  X,2,Entire home/apt,95,338,1.97,433
24894,Edison,1,Private room,111,51,5.86,162
24895,Elaine,1,Entire home/apt,210,0,0.26,210
24896,Masaki,1,Private room,100,0,1.09,100
24897,Jane,2,Entire home/apt,145,333,0.49,478
24898,Bree,2,Entire home/apt,50,7,0.13,57
24900,Chris,2,Entire home/apt,136,0,0.09,136
24901,Katherine,2,Entire home/apt,585,225,0.42,810
24902,Dan,3,Entire home/apt,200,0,0.05,200
24903,Catinca,2,Entire home/apt,180,0,0.91,180
24904,Tonisha,2,Private room,40,37,2.37,77
24905,Tonisha,2,Private room,40,36,4.53,76
24906,Cathy,2,Entire home/apt,56,22,3.64,78
24907,Rebecca,1,Entire home/apt,795,268,0.42,1063
24908,Isa,3,Entire home/apt,135,310,0.81,445
24910,Madhu,3,Entire home/apt,80,0,0.56,80
24912,Sanjay,1,Entire home/apt,50,0,0.28,50
24913,John,2,Entire home/apt,298,192,0.36,490
24914,Caitlyn,1,Private room,55,0,0.76,55
24917,Glenna,1,Private room,87,0,0.43,87
24918,Anna,2,Entire home/apt,100,2,0.99,102
24919,Catherine,1,Entire home/apt,125,0,2.3,125
24920,Bojana,1,Entire home/apt,115,18,2.92,133
24921,Irene,2,Private room,50,11,1.0,61
24923,Ali,1,Entire home/apt,449,352,0.63,801
24924,Esteem,4,Shared room,26,342,0.78,368
24926,Alain,2,Private room,110,0,0.21,110
24928,Danielle,2,Entire home/apt,149,0,0.04,149
24929,Svetlana,2,Entire home/apt,130,142,1.77,272
24930,Claire,3,Private room,75,0,0.09,75
24931,Casey,1,Entire home/apt,350,0,0.09,350
24932,Adam,2,Private room,62,0,0.13,62
24933,Raschell,1,Entire home/apt,110,0,0.13,110
24934,Susanne,1,Private room,80,0,0.31,80
24935,George,1,Private room,120,0,0.59,120
24936,Cathy,2,Private room,57,0,0.17,57
24937,Erik,1,Entire home/apt,239,3,0.68,242
24938,Alberto,3,Private room,84,321,3.12,405
24939,Anna Chiara,1,Private room,44,153,0.19,197
24940,Kyle,1,Private room,100,58,2.79,158
24941,Victoria,1,Entire home/apt,500,276,1.7,776
24942,Anna Chiara,1,Private room,46,220,0.26,266
24943,Alan,3,Entire home/apt,140,244,0.14,384
24944,Anna Chiara,1,Private room,41,211,0.24,252
24945,Anthony,2,Private room,35,311,0.21,346
24946,Jonah_Soleil,2,Entire home/apt,114,140,3.02,254
24947,Brooke,3,Private room,57,3,4.34,60
24948,Mungyu,2,Private room,40,188,0.63,228
24949,Garland,2,Private room,60,58,2.78,118
24950,Peter And Helen,1,Entire home/apt,137,233,0.83,370
24951,Maurizio,1,Entire home/apt,150,5,0.08,155
24952,Raquel,2,Private room,80,2,0.51,82
24953,Crystal,2,Private room,33,63,0.13,96
24954,Renee,2,Private room,50,0,1.12,50
24956,Ashleigh,2,Private room,55,0,0.56,55
24957,David,3,Entire home/apt,39,0,0.08,39
24958,Aleksandar,3,Private room,150,0,0.17,150
24959,Jennifer,1,Entire home/apt,197,16,0.47,213
24960,Anisha,4,Private room,65,325,3.82,390
24962,Susy,2,Private room,50,341,1.22,391
24963,Jesse,2,Entire home/apt,130,0,0.04,130
24964,Alexandra,2,Entire home/apt,200,95,0.78,295
24965,Daphne,1,Private room,45,0,0.13,45
24966,S,2,Private room,66,0,0.09,66
24967,TamiandIvana,2,Private room,60,328,2.04,388
24968,Abraham,2,Entire home/apt,399,65,0.39,464
24971,Drew,1,Private room,75,0,0.13,75
24972,Joseph,1,Entire home/apt,279,174,5.73,453
24974,Anna Chiara,1,Private room,51,262,0.38,313
24975,Lara,1,Private room,130,239,0.19,369
24978,Sherry,2,Private room,47,59,1.52,106
24979,Xavier,2,Private room,85,0,0.61,85
24980,Aly,1,Private room,99,331,3.8,430
24982,Martial Loft,2,Private room,60,0,0.48,60
24983,Stella,4,Private room,29,137,2.65,166
24984,Svetlana,1,Entire home/apt,170,0,0.17,170
24985,Joshua,2,Private room,45,0,0.21,45
24986,Rachel,1,Private room,70,132,1.0,202
24987,Anne-Charlotte,1,Entire home/apt,198,0,0.38,198
24988,Johnny,2,Private room,87,0,0.04,87
24990,Victor,1,Entire home/apt,250,0,0.89,250
24991,Sara,2,Entire home/apt,152,146,3.11,298
24993,Allan,1,Entire home/apt,1795,116,1.65,1911
24994,Katy,1,Entire home/apt,210,0,0.22,210
24995,Jenny,2,Entire home/apt,135,247,2.97,382
24996,Molly,2,Entire home/apt,69,7,0.46,76
24997,Garland,2,Private room,55,88,2.31,143
24998,Laura,1,Entire home/apt,90,0,0.04,90
24999,Garland,2,Private room,45,79,2.08,124
25000,Wes,2,Entire home/apt,80,0,0.14,80
25001,Veronica,3,Shared room,37,365,1.1,402
25003,V Joe,3,Entire home/apt,275,335,1.02,610
25004,Michele,2,Entire home/apt,150,92,1.46,242
25005,Kenna,2,Entire home/apt,200,253,1.69,453
25006,Isabella,1,Entire home/apt,230,5,0.21,235
25008,Klaudia,2,Entire home/apt,149,0,0.14,149
25009,Laura,1,Entire home/apt,690,0,0.04,690
25010,Kat,1,Private room,53,0,0.04,53
25012,Derek,2,Private room,70,0,1.49,70
25013,Valentina,1,Entire home/apt,275,0,0.99,275
25015,Emily,3,Private room,56,0,0.81,56
25016,David,3,Entire home/apt,268,154,0.19,422
25017,Krysta,2,Private room,75,0,0.05,75
25018,Esther,1,Private room,82,0,1.02,82
25019,Rachel,2,Private room,65,0,0.45,65
25020,Nichole,2,Entire home/apt,71,0,0.51,71
25021,Maura,2,Private room,89,334,0.38,423
25022,Jonathan,5,Private room,59,351,1.11,410
25023,Funmilade,2,Private room,50,0,0.13,50
25024,Cindy,2,Entire home/apt,100,0,0.25,100
25025,Shakeria,1,Private room,55,0,0.04,55
25026,Ella,3,Entire home/apt,69,0,2.15,69
25027,K,1,Private room,35,0,0.11,35
25028,Myles,1,Private room,108,0,0.13,108
25029,Zam,2,Entire home/apt,100,0,0.13,100
25030,Maura,2,Private room,75,347,0.48,422
25031,Gabrielle,1,Entire home/apt,99,0,0.47,99
25033,Sarah,2,Entire home/apt,158,28,4.19,186
25034,Michael,2,Private room,50,0,0.21,50
25035,Catherine,1,Entire home/apt,250,0,0.27,250
25037,Elizabeth,1,Entire home/apt,299,116,2.57,415
25038,Sarah,1,Private room,65,0,0.04,65
25040,Diana,2,Entire home/apt,90,0,0.26,90
25041,Cristina,2,Private room,120,0,3.52,120
25042,Andy,2,Entire home/apt,150,25,1.22,175
25043,Shen,3,Private room,61,0,0.04,61
25044,Devon,1,Private room,175,22,2.89,197
25045,Melody,2,Entire home/apt,150,0,0.04,150
25046,Antonia,3,Private room,80,154,1.5,234
25047,Yvette,2,Entire home/apt,100,81,1.67,181
25048,Krystal,5,Entire home/apt,75,175,0.45,250
25049,Celeste,1,Private room,500,0,0.05,500
25050,Steve,3,Entire home/apt,115,0,0.18,115
25051,Mercy,1,Private room,150,0,0.36,150
25052,Maja,3,Entire home/apt,110,0,0.3,110
25053,Joannie,1,Private room,160,0,0.09,160
25054,Saimon,1,Entire home/apt,230,0,0.11,230
25055,Catherine,3,Entire home/apt,120,0,0.09,120
25056,Emanuella,3,Entire home/apt,110,305,1.49,415
25057,Sky,2,Entire home/apt,80,195,2.19,275
25058,Alex,1,Entire home/apt,199,0,1.21,199
25059,Tiiu,1,Entire home/apt,280,69,4.13,349
25060,Steven,1,Entire home/apt,140,0,0.17,140
25061,Will,2,Private room,50,188,0.34,238
25063,Victoria,2,Entire home/apt,200,2,1.07,202
25064,Tara,2,Entire home/apt,1095,240,1.01,1335
25065,Chadanut,2,Private room,56,16,2.48,72
25066,Kusang,3,Private room,80,95,1.19,175
25070,Abraham,2,Entire home/apt,99,91,1.72,190
25072,Erin,2,Private room,65,0,0.09,65
25073,Abraham,2,Entire home/apt,199,72,0.42,271
25074,Darshan,3,Private room,45,0,0.09,45
25075,Mark,1,Private room,69,0,0.13,69
25076,Eva,2,Private room,65,130,1.57,195
25078,Joica,2,Entire home/apt,249,177,0.38,426
25079,Gabriel,1,Entire home/apt,220,0,0.27,220
25080,Felipe,2,Entire home/apt,95,20,0.14,115
25081,Emily,2,Private room,34,71,0.35,105
25082,Danielle,2,Entire home/apt,190,215,1.11,405
25084,Eugene,1,Private room,85,0,0.43,85
25085,Stacy & Simon,2,Private room,38,193,1.87,231
25086,Tessa,1,Private room,58,0,0.04,58
25087,Jake,1,Entire home/apt,179,235,4.94,414
25088,Lynn L,3,Private room,40,164,2.37,204
25089,Selçuk,2,Private room,45,36,1.47,81
25090,Lydia,1,Entire home/apt,150,0,0.56,150
25091,Jeniffer,1,Entire home/apt,200,359,0.09,559
25092,James,1,Entire home/apt,125,0,0.23,125
25093,Jean,3,Private room,50,220,1.28,270
25095,Sam,1,Private room,70,0,7.27,70
25096,Bess,1,Private room,88,0,0.04,88
25099,Jack,1,Entire home/apt,122,0,0.17,122
25100,Mike,2,Private room,50,89,0.76,139
25101,Rusty,3,Shared room,60,248,2.26,308
25103,Sam,1,Private room,60,61,6.9,121
25104,Ozge,2,Private room,53,357,2.87,410
25105,Alayna,2,Entire home/apt,150,0,0.04,150
25106,Cici,1,Private room,75,11,0.13,86
25107,Abraham,2,Entire home/apt,129,74,1.04,203
25108,Julien,2,Entire home/apt,250,5,0.45,255
25109,Gabrielle,1,Private room,98,0,0.17,98
25110,Melanie,1,Entire home/apt,99,0,0.51,99
25111,Emily,3,Entire home/apt,120,6,0.48,126
25112,Apeksha,1,Private room,120,231,5.94,351
25113,Cansu,2,Private room,60,0,0.08,60
25115,Ociel,4,Private room,40,51,3.16,91
25117,Maura,2,Private room,89,359,0.16,448
25118,Luz,3,Entire home/apt,49,24,3.09,73
25119,Amanda,2,Private room,60,47,1.28,107
25120,Daniel,1,Entire home/apt,500,214,1.25,714
25121,Anisha,4,Private room,75,358,3.0,433
25123,Joseph,2,Entire home/apt,150,0,0.35,150
25124,Rory,1,Entire home/apt,120,4,2.23,124
25125,Brittany,2,Entire home/apt,165,0,0.55,165
25126,Michael,1,Private room,72,0,0.17,72
25127,David,1,Entire home/apt,120,3,1.39,123
25128,Cameron & Dione,2,Entire home/apt,275,35,0.96,310
25129,Femi,3,Entire home/apt,130,117,4.19,247
25130,Valeriy,5,Entire home/apt,90,179,0.4,269
25131,Val,5,Entire home/apt,105,358,1.05,463
25132,Emily,1,Entire home/apt,190,181,0.38,371
25133,Janelle,1,Entire home/apt,82,0,0.13,82
25134,Sara,2,Private room,69,166,0.22,235
25135,Vinko,1,Private room,99,0,0.09,99
25136,Sarah,2,Private room,58,0,0.04,58
25137,Althea,2,Entire home/apt,100,30,4.38,130
25138,Geoffrey,2,Entire home/apt,121,179,1.14,300
25139,Maryna,2,Private room,95,342,0.32,437
25140,Wendy,2,Entire home/apt,389,64,4.77,453
25142,Eugene,1,Private room,75,0,0.51,75
25143,Eva,2,Entire home/apt,150,4,0.34,154
25144,Petar,2,Private room,35,0,0.26,35
25145,Adi,2,Private room,45,0,0.09,45
25146,Yulia,5,Entire home/apt,150,0,0.09,150
25147,Emily,1,Entire home/apt,190,190,0.31,380
25148,Abraham,2,Entire home/apt,199,89,0.34,288
25149,Albena,4,Private room,35,284,0.96,319
25150,Marcia,3,Private room,75,342,0.71,417
25151,Antonio José,3,Private room,40,0,0.14,40
25152,Kristin,1,Private room,99,0,0.73,99
25153,Emmanuel,2,Private room,75,0,0.35,75
25154,Shuly,3,Private room,40,279,4.29,319
25156,Nitya,2,Private room,91,0,0.13,91
25157,Auset,2,Private room,55,0,0.28,55
25158,Beto,1,Private room,120,0,0.06,120
25159,Lisa,1,Private room,69,29,1.1,98
25160,Kaylie,1,Private room,60,0,0.04,60
25161,Mel,1,Entire home/apt,333,210,2.81,543
25162,Otto,3,Private room,50,246,3.19,296
25163,Lucky,3,Private room,60,90,4.49,150
25164,Anna,3,Entire home/apt,150,309,0.09,459
25165,Francesca,2,Entire home/apt,150,0,0.17,150
25166,Okela,2,Private room,89,364,0.62,453
25167,Jose,1,Entire home/apt,135,0,0.13,135
25168,Lauren,3,Entire home/apt,115,343,3.51,458
25169,Isabelle,3,Entire home/apt,100,324,0.17,424
25170,Ben,1,Private room,76,0,0.09,76
25171,Sophia,2,Entire home/apt,110,0,0.22,110
25172,Melissa,2,Private room,60,0,0.17,60
25173,Johanna,3,Private room,40,226,1.0,266
25174,Martina,2,Private room,50,0,0.04,50
25175,Nick & Nadia,3,Private room,49,0,1.55,49
25176,Lindsey,1,Entire home/apt,200,0,0.56,200
25177,Aj,1,Entire home/apt,65,0,0.4,65
25178,Andrew,2,Private room,68,0,0.04,68
25180,Hiroko,3,Private room,80,0,0.35,80
25181,Shuvo,3,Private room,50,0,0.17,50
25182,Leslie,3,Private room,78,291,2.66,369
25183,Elle,2,Private room,65,254,3.75,319
25184,S.A.,2,Private room,55,298,2.5,353
25185,Tiffany,1,Private room,63,315,3.01,378
25186,Jim&Lisa,3,Private room,43,364,2.87,407
25187,Larry Raul,1,Private room,140,0,2.36,140
25188,Monica,4,Entire home/apt,72,129,1.52,201
25189,Fernando,3,Entire home/apt,199,61,2.81,260
25190,Sarah,2,Private room,90,110,2.42,200
25191,Kevin And Kitty,3,Private room,55,248,3.68,303
25192,Samantha,2,Entire home/apt,120,0,0.09,120
25194,Sarah,2,Private room,80,116,2.73,196
25195,Isin,1,Private room,154,27,0.22,181
25196,Steven,1,Entire home/apt,175,0,0.09,175
25197,Justine,1,Entire home/apt,80,0,0.22,80
25198,Micah,2,Private room,50,2,0.13,52
25199,Monika,1,Entire home/apt,125,220,5.7,345
25201,Thomas,1,Private room,174,65,0.73,239
25202,Hans,2,Private room,40,0,0.18,40
25203,Winnie & Andy,4,Private room,45,325,1.47,370
25205,William,2,Private room,50,0,1.34,50
25206,Daniel,2,Entire home/apt,115,33,3.93,148
25208,Lex,1,Entire home/apt,130,361,1.63,491
25209,Harry,3,Entire home/apt,63,257,0.9,320
25211,Zachary,1,Entire home/apt,275,137,3.68,412
25212,Christina,1,Entire home/apt,130,275,1.76,405
25213,Melissa,1,Entire home/apt,154,0,0.09,154
25214,Nikita,2,Private room,43,14,6.59,57
25215,Ivana,2,Shared room,225,87,0.04,312
25216,Darlene,2,Private room,60,165,0.09,225
25217,Evrim,3,Private room,60,0,0.13,60
25218,Nathanael,1,Entire home/apt,180,0,0.13,180
25219,Sarah,2,Private room,150,102,0.21,252
25220,Allie,2,Entire home/apt,169,0,0.47,169
25221,Gloria,2,Entire home/apt,83,348,1.79,431
25222,Lynn L,3,Private room,40,354,2.52,394
25223,Sara,3,Private room,75,0,0.1,75
25224,Rubyn,2,Entire home/apt,89,0,0.34,89
25225,Alexandra,2,Entire home/apt,150,0,0.13,150
25226,Suzy,2,Entire home/apt,68,332,0.48,400
25227,Deo,1,Entire home/apt,200,280,0.26,480
25228,Jonathan,2,Entire home/apt,144,0,0.48,144
25230,Saket,1,Private room,75,0,0.09,75
25231,Asher,2,Entire home/apt,150,4,0.26,154
25232,Chi,1,Private room,105,75,1.31,180
25233,Deo,1,Entire home/apt,350,332,0.21,682
25235,Suzy,2,Entire home/apt,150,312,0.16,462
25236,Kaka,3,Private room,98,123,4.54,221
25237,Suzy,2,Entire home/apt,122,226,0.3,348
25238,Robert,2,Private room,90,0,0.04,90
25239,Peter,2,Entire home/apt,450,0,0.22,450
25241,Brady,1,Private room,185,103,5.19,288
25243,Oscar,3,Private room,39,327,7.57,366
25244,Nilufer,3,Private room,65,98,3.14,163
25245,FuKang,3,Private room,60,311,4.27,371
25246,Travis,2,Entire home/apt,170,280,2.7,450
25247,Samar,2,Private room,60,0,0.49,60
25248,Leah,1,Entire home/apt,200,0,0.14,200
25249,Louise,3,Entire home/apt,50,23,13.27,73
25251,Esther,3,Private room,50,0,0.04,50
25252,Stanley,1,Entire home/apt,222,365,0.09,587
25253,Stanley,1,Entire home/apt,175,342,0.21,517
25254,Lakiea,2,Entire home/apt,90,35,3.5,125
25255,Melissa,2,Entire home/apt,196,154,4.1,350
25256,Ken,1,Entire home/apt,170,278,0.05,448
25257,Lucky,3,Private room,70,75,3.92,145
25258,Tom,1,Entire home/apt,899,161,0.22,1060
25259,Kaka,3,Private room,78,88,3.19,166
25260,Sarah,1,Entire home/apt,399,0,0.14,399
25261,Camila,1,Entire home/apt,120,0,0.05,120
25262,Lacey,2,Private room,55,0,0.17,55
25264,Alexa,2,Entire home/apt,95,0,0.09,95
25265,Jacketta,3,Private room,70,0,0.26,70
25266,Robb,2,Private room,60,72,0.4,132
25267,Easton,2,Private room,45,0,1.35,45
25268,Alexandra,2,Entire home/apt,120,227,2.44,347
25269,Mervin (Michael),5,Private room,37,306,1.11,343
25270,Shawn,2,Entire home/apt,125,0,0.18,125
25271,Giulliana,2,Private room,50,9,2.6,59
25272,Ashley,2,Entire home/apt,75,0,0.04,75
25273,Bridge,1,Entire home/apt,80,311,0.14,391
25274,Laura,2,Private room,60,0,0.46,60
25275,Blan,1,Private room,68,253,1.69,321
25276,Tasha,2,Entire home/apt,300,31,0.35,331
25277,Max,2,Private room,75,0,0.22,75
25278,Mina,3,Private room,89,317,5.0,406
25280,Shuly,3,Private room,62,327,4.09,389
25281,Chaka,2,Entire home/apt,100,96,2.16,196
25282,Kara,1,Entire home/apt,300,12,0.81,312
25283,Kristin,2,Entire home/apt,83,0,3.74,83
25284,Seth,2,Private room,60,0,0.09,60
25285,John,2,Private room,30,0,0.17,30
25286,Fanny & Hong,3,Entire home/apt,118,87,5.2,205
25287,Mattias,2,Entire home/apt,150,0,0.04,150
25288,Joe,2,Private room,92,43,2.31,135
25289,Kristin,2,Entire home/apt,99,255,4.97,354
25290,Kate,2,Entire home/apt,124,0,0.39,124
25291,Leonard,3,Private room,45,133,0.55,178
25292,Kristin,2,Entire home/apt,175,0,0.09,175
25293,Yve,1,Entire home/apt,147,72,2.85,219
25294,Jenelle,2,Entire home/apt,75,72,0.06,147
25295,Mishay,3,Entire home/apt,99,267,2.34,366
25296,Sarah,3,Entire home/apt,120,0,0.09,120
25297,Jaafar,2,Private room,47,0,0.21,47
25298,Mia,2,Entire home/apt,157,223,3.06,380
25299,Dadrine,2,Private room,80,206,0.26,286
25300,Ora & Scout,2,Private room,69,0,0.33,69
25301,Sarah,2,Entire home/apt,250,312,2.7,562
25302,Osh,1,Entire home/apt,175,64,1.78,239
25303,Hiasselen,4,Private room,45,280,0.91,325
25304,Jessica,1,Entire home/apt,80,0,0.77,80
25305,Seth,2,Entire home/apt,217,14,1.05,231
25306,Nic,1,Entire home/apt,129,0,1.09,129
25307,Riley,1,Entire home/apt,199,0,1.5,199
25309,Michael Ray,2,Entire home/apt,195,0,0.18,195
25311,Mei-I,1,Entire home/apt,126,0,2.0,126
25314,Lou,2,Private room,59,0,1.47,59
25315,Andrew,1,Private room,51,0,0.09,51
25317,Xris,2,Private room,150,177,0.09,327
25318,Jaime,2,Entire home/apt,800,0,1.41,800
25319,Yubo,1,Private room,140,54,0.77,194
25320,Cristina,2,Private room,95,0,0.06,95
25321,Jacqueline,1,Entire home/apt,600,174,1.93,774
25322,Luis,1,Private room,40,0,1.03,40
25323,Kaka,3,Private room,85,76,4.94,161
25324,A.J.,1,Entire home/apt,150,4,0.79,154
25325,Jaafar,2,Private room,60,0,0.09,60
25327,David,2,Private room,40,0,0.18,40
25328,Desislava,1,Private room,69,0,0.68,69
25330,Micah,2,Entire home/apt,149,0,0.09,149
25331,Melissa,1,Private room,120,149,3.92,269
25332,Bryan,2,Private room,40,0,0.09,40
25334,Nicolas,1,Entire home/apt,200,10,0.61,210
25335,Lee,1,Entire home/apt,120,0,0.27,120
25336,Naz,2,Private room,50,93,1.76,143
25338,Edward,2,Entire home/apt,100,323,4.95,423
25339,Amy,2,Entire home/apt,250,133,0.32,383
25340,Nilufer,3,Private room,45,97,2.53,142
25341,Katharina,2,Entire home/apt,85,5,0.33,90
25342,Nivea And Jill,1,Entire home/apt,300,265,5.95,565
25343,Sol,3,Private room,35,0,0.13,35
25345,Ashley,2,Entire home/apt,225,67,5.88,292
25346,Kenneth,2,Entire home/apt,78,82,0.67,160
25347,Annette C,2,Private room,49,311,2.53,360
25348,Irina,1,Entire home/apt,130,332,0.19,462
25349,David,2,Entire home/apt,115,3,0.18,118
25350,Daniel And Elsa,2,Private room,59,0,0.15,59
25351,Lia,2,Private room,32,0,0.22,32
25352,Sadie,2,Private room,45,34,0.51,79
25353,Meghan,2,Private room,70,0,0.2,70
25354,Shean,2,Entire home/apt,99,311,0.11,410
25355,Natalia,3,Entire home/apt,105,285,3.08,390
25356,Alba,3,Entire home/apt,160,0,0.09,160
25357,Daniel,1,Entire home/apt,114,0,0.04,114
25358,James,2,Private room,55,0,0.34,55
25359,Jonathan,3,Entire home/apt,120,90,4.44,210
25360,Charles,2,Private room,55,151,0.85,206
25361,Eugenio,3,Private room,160,0,0.05,160
25362,Meredith,2,Entire home/apt,110,4,1.36,114
25363,Hannah,1,Private room,60,13,0.11,73
25364,Irina,1,Entire home/apt,130,310,0.41,440
25365,Nicholas,1,Shared room,115,7,4.09,122
25368,Kelsey,2,Private room,85,0,0.22,85
25369,Joey,3,Private room,55,57,2.66,112
25370,Shelley,2,Private room,55,30,2.77,85
25371,Allison,1,Private room,90,0,0.14,90
25373,Robert,2,Private room,150,0,0.26,150
25374,Luc,1,Entire home/apt,350,0,0.05,350
25375,Carol,2,Private room,110,365,0.07,475
25376,Anna,1,Entire home/apt,164,0,3.67,164
25377,Antoine,3,Private room,42,0,0.04,42
25378,Rodney,1,Entire home/apt,325,310,2.01,635
25379,Zoe,1,Entire home/apt,140,0,0.35,140
25380,Alex,3,Entire home/apt,75,0,0.04,75
25381,Qingming,2,Private room,66,180,0.6,246
25382,Qingming,2,Private room,66,170,1.25,236
25383,Joshua,1,Private room,95,15,1.56,110
25384,Jérôme,1,Private room,115,326,7.76,441
25387,Dara,2,Entire home/apt,200,1,1.84,201
25390,Andrew,3,Private room,84,356,4.01,440
25391,Andrew,3,Private room,62,0,6.21,62
25392,Bobby,2,Private room,35,0,0.22,35
25393,Andrew,3,Private room,62,354,5.74,416
25394,Min Hee,3,Entire home/apt,115,0,0.04,115
25395,Richard & Xio,4,Entire home/apt,155,285,0.61,440
25396,Polina,2,Entire home/apt,165,0,0.05,165
25397,Josie,2,Private room,60,0,0.26,60
25398,Oliver,2,Entire home/apt,400,14,0.37,414
25399,Jim,2,Entire home/apt,90,312,4.09,402
25400,Xiaomin,1,Private room,90,0,0.39,90
25401,Justin,2,Private room,75,0,0.27,75
25402,Puja,1,Entire home/apt,1500,186,0.11,1686
25403,Carla,2,Private room,55,0,0.3,55
25406,Yan,2,Private room,72,102,3.99,174
25407,Diego & Mike,2,Private room,120,0,0.37,120
25408,Tony,1,Entire home/apt,200,341,0.09,541
25409,Jen,2,Entire home/apt,99,0,0.22,99
25411,Edith,1,Entire home/apt,185,0,0.22,185
25412,Andre,1,Private room,90,60,0.67,150
25413,Christine,1,Entire home/apt,615,117,1.83,732
25414,Mark,1,Entire home/apt,180,20,0.14,200
25415,Dylan,2,Private room,75,0,0.13,75
25416,Lavonne,3,Entire home/apt,80,71,4.45,151
25417,Krzysztof,2,Entire home/apt,90,125,0.19,215
25419,Yusuf,2,Entire home/apt,269,0,0.04,269
25422,Kathy,4,Shared room,800,269,0.04,1069
25423,Aura,1,Private room,60,0,0.09,60
25424,David,1,Entire home/apt,219,45,1.29,264
25425,Ephraim,1,Entire home/apt,150,113,2.35,263
25426,Alana,1,Entire home/apt,289,0,0.13,289
25427,Nitzan,1,Private room,55,0,0.17,55
25428,Ben,1,Private room,139,0,0.04,139
25429,Naomi,3,Entire home/apt,65,105,4.13,170
25430,Ash,1,Entire home/apt,239,0,4.53,239
25431,Andrea,1,Private room,110,128,4.95,238
25432,Jina,1,Private room,89,248,0.44,337
25433,Anisha,4,Private room,0,127,2.56,127
25434,Jason & Kelly,2,Entire home/apt,150,86,0.86,236
25435,Veronica,3,Shared room,45,365,0.8,410
25437,Jazmin,1,Private room,55,91,0.95,146
25439,Portia,1,Shared room,65,365,0.16,430
25440,Cassia,2,Private room,63,6,2.89,69
25441,Janae,1,Private room,70,89,0.39,159
25442,Daniel,2,Entire home/apt,120,0,0.85,120
25443,Sam,1,Private room,82,75,7.27,157
25444,Stacy,1,Private room,56,0,0.17,56
25445,Remonia,2,Private room,80,0,0.19,80
25446,Jake,1,Entire home/apt,139,82,5.35,221
25447,Ming,3,Entire home/apt,110,295,2.22,405
25448,Isi,2,Private room,60,90,0.13,150
25449,Ronald,1,Private room,70,330,2.97,400
25450,Iza,1,Private room,69,26,4.1,95
25451,Yonette,2,Shared room,45,364,0.31,409
25454,Jason,1,Private room,80,179,0.17,259
25455,Witt,3,Private room,51,28,1.66,79
25456,Alex,2,Private room,50,0,2.89,50
25457,Nakia,1,Entire home/apt,273,116,0.6,389
25458,Leo,1,Entire home/apt,212,239,4.26,451
25459,Wesly/Jessica,2,Private room,54,345,2.05,399
25460,Sandy,2,Entire home/apt,170,164,4.11,334
25462,Nikki,2,Private room,50,0,0.69,50
25463,Carolina,2,Private room,85,164,0.49,249
25464,Alba,2,Private room,80,0,0.09,80
25465,Greg,2,Private room,50,0,0.13,50
25466,Jay,1,Private room,86,0,0.05,86
25468,Joica,2,Shared room,79,180,0.4,259
25469,Lila,2,Entire home/apt,211,0,0.53,211
25470,Monica,4,Entire home/apt,70,129,2.99,199
25471,Joica,2,Shared room,159,180,0.31,339
25473,Joica,2,Private room,119,180,1.28,299
25474,Stephanie,2,Entire home/apt,120,44,1.98,164
25475,Trinity,1,Entire home/apt,71,55,1.45,126
25476,Mitch,1,Entire home/apt,170,1,0.53,171
25477,Shay & Adam,2,Entire home/apt,70,61,0.18,131
25478,Samantha,2,Private room,80,0,0.04,80
25479,Lauren,1,Private room,50,97,4.01,147
25480,Emma,1,Private room,80,0,0.04,80
25481,Spencer,1,Entire home/apt,129,29,3.32,158
25482,Dario,1,Entire home/apt,99,3,0.27,102
25483,Mykola,1,Private room,49,0,0.04,49
25484,Charles,2,Entire home/apt,125,0,0.09,125
25485,Sheldon,1,Entire home/apt,150,0,0.04,150
25486,Joshua,3,Private room,30,0,0.18,30
25487,Mitch,2,Entire home/apt,144,43,0.93,187
25488,Anisha,4,Private room,55,171,2.59,226
25489,Thomas,2,Entire home/apt,170,267,2.43,437
25490,Kesina,1,Entire home/apt,185,0,0.26,185
25491,Eden,3,Entire home/apt,120,0,0.35,120
25492,Vikas,1,Entire home/apt,174,0,0.98,174
25493,Virginie,2,Entire home/apt,125,91,2.15,216
25494,Muneeza,1,Private room,60,0,0.04,60
25496,Anton,1,Private room,105,38,6.6,143
25497,James,2,Entire home/apt,85,6,0.44,91
25498,Emily,1,Entire home/apt,300,312,0.85,612
25499,Tommy,1,Private room,150,149,2.51,299
25501,Isadora,3,Private room,80,0,0.39,80
25502,Katie,2,Entire home/apt,140,0,1.38,140
25503,Valentina,2,Private room,75,129,1.08,204
25504,Sung Ae,2,Entire home/apt,300,239,1.55,539
25505,Carol,1,Shared room,69,196,1.37,265
25506,William,3,Private room,53,279,0.12,332
25507,Ela,1,Private room,79,0,1.13,79
25508,Val,1,Entire home/apt,409,40,3.86,449
25509,Angele,3,Entire home/apt,600,220,0.05,820
25510,Mana,2,Private room,38,5,4.91,43
25511,Kevin,1,Entire home/apt,185,11,0.77,196
25512,James,2,Entire home/apt,175,178,0.13,353
25513,Juan Ignacio,1,Entire home/apt,115,0,0.27,115
25514,Lesley / Eric,2,Private room,50,0,1.66,50
25515,Gina,2,Private room,75,41,6.58,116
25517,Leif,2,Entire home/apt,70,0,0.57,70
25518,Rachel,2,Private room,85,0,0.09,85
25519,Tobias,1,Entire home/apt,250,0,0.23,250
25520,Jenny,2,Private room,40,0,0.18,40
25521,Nikki,2,Private room,50,1,1.0,51
25522,Nick,1,Entire home/apt,162,0,0.18,162
25523,Javier,1,Entire home/apt,250,145,4.21,395
25524,Junghwee Bella,3,Private room,35,0,0.09,35
25525,Jamal,3,Entire home/apt,295,188,4.73,483
25526,Xie,2,Private room,75,259,1.95,334
25527,Veronica,3,Shared room,45,365,0.7,410
25528,Anthony,2,Private room,38,0,0.04,38
25529,Joshua,1,Private room,61,35,0.04,96
25531,Jonathan,1,Entire home/apt,170,213,4.48,383
25532,Jakelina,1,Private room,80,336,1.39,416
25534,Christopher,2,Private room,54,0,0.43,54
25535,Tolga,2,Private room,80,0,1.26,80
25536,Elle,4,Entire home/apt,58,0,0.04,58
25537,Matthew,1,Entire home/apt,120,0,0.27,120
25538,Leonard,3,Private room,45,226,0.55,271
25539,Morgan,2,Entire home/apt,120,193,5.42,313
25540,Farrel,4,Private room,70,77,1.85,147
25541,Jamie,2,Entire home/apt,215,0,0.14,215
25542,S,1,Entire home/apt,250,0,0.09,250
25543,Chelsea,2,Entire home/apt,72,21,0.04,93
25545,Cesar,1,Private room,85,355,1.17,440
25546,Denise,2,Private room,80,341,0.45,421
25548,Una,2,Private room,50,364,0.13,414
25549,James,2,Entire home/apt,255,326,0.41,581
25550,A & H,2,Entire home/apt,120,0,0.31,120
25551,Juan,2,Private room,61,0,0.09,61
25552,Ousmane,1,Private room,65,3,0.14,68
25553,Stephanie,2,Private room,55,0,0.18,55
25555,ResortShare5,1,Entire home/apt,672,266,0.23,938
25556,Taylor,4,Entire home/apt,100,10,2.0,110
25558,Rose,3,Private room,60,177,0.18,237
25561,Marissa,1,Entire home/apt,200,0,0.14,200
25562,Lorene,2,Private room,66,88,0.47,154
25563,Johny,2,Entire home/apt,165,226,3.16,391
25566,Katie,2,Entire home/apt,150,0,0.14,150
25567,Alan,3,Entire home/apt,100,294,0.34,394
25568,Kellie,1,Private room,90,63,2.99,153
25569,Imri,1,Private room,144,94,1.08,238
25571,Anthony,2,Entire home/apt,210,0,1.37,210
25572,Gavin,1,Entire home/apt,350,10,1.52,360
25573,Diana,5,Private room,68,57,1.3,125
25574,Fabiyan,3,Private room,60,0,0.31,60
25575,Rose,3,Private room,60,250,0.85,310
25577,Jean,3,Entire home/apt,60,273,4.42,333
25578,Vincent,1,Private room,60,0,0.22,60
25579,Jacqueline,2,Entire home/apt,110,81,3.57,191
25580,Eric,4,Entire home/apt,69,193,4.57,262
25582,Lauren,1,Entire home/apt,125,0,0.04,125
25583,Christian,2,Private room,59,0,0.09,59
25584,Francis,1,Entire home/apt,200,60,4.4,260
25585,Max And Heather,2,Private room,70,0,0.49,70
25588,Stephan,2,Private room,50,0,0.05,50
25589,Keyur,3,Private room,65,188,0.78,253
25590,Alfredo,1,Private room,120,76,5.63,196
25591,Bret,1,Private room,95,0,0.88,95
25592,Maddy,1,Private room,70,0,0.13,70
25593,Brooks,2,Entire home/apt,192,0,0.05,192
25594,Kevin,2,Private room,60,68,0.98,128
25595,Zachary,2,Entire home/apt,175,188,0.04,363
25596,Paula,2,Entire home/apt,295,208,2.48,503
25597,Rahwa,1,Private room,50,0,0.09,50
25598,Emilie,2,Private room,66,0,0.18,66
25599,Pong,1,Entire home/apt,226,56,3.35,282
25601,Luca,1,Private room,530,0,0.31,530
25602,Paco,3,Entire home/apt,106,0,0.04,106
25603,Banty,2,Private room,40,341,2.08,381
25604,Sergii,2,Shared room,34,365,0.11,399
25607,Javier,1,Private room,125,178,1.52,303
25608,Pieter,1,Entire home/apt,245,46,2.22,291
25610,Sandra,2,Entire home/apt,65,2,2.37,67
25611,Jean,1,Private room,65,0,1.07,65
25612,Cindy,3,Private room,50,0,0.09,50
25615,Maya,1,Private room,77,198,2.41,275
25616,Artem,1,Private room,99,140,0.27,239
25618,Janelle,3,Private room,39,164,0.66,203
25620,Kimberly,1,Entire home/apt,195,12,3.2,207
25621,Caleb,1,Private room,50,0,0.05,50
25622,Steve,3,Entire home/apt,99,90,0.67,189
25623,Nicholas,1,Private room,75,0,0.44,75
25624,Mike,2,Private room,89,246,2.35,335
25625,Jc,1,Entire home/apt,265,118,3.79,383
25626,Charmine,2,Entire home/apt,400,97,1.03,497
25627,Sharon,1,Entire home/apt,160,39,3.1,199
25628,Andrew,1,Shared room,75,0,0.04,75
25629,Rick,2,Entire home/apt,175,0,0.27,175
25630,Armando,2,Private room,55,0,0.4,55
25631,Laura,2,Entire home/apt,105,18,2.47,123
25632,Lisa,1,Entire home/apt,495,343,1.91,838
25633,Radhames,2,Entire home/apt,34,247,4.07,281
25634,Martial Loft,2,Private room,0,0,0.71,0
25636,Michael,1,Private room,85,305,0.55,390
25637,Cassidy,1,Private room,133,0,0.05,133
25638,Lay,2,Private room,70,324,2.54,394
25639,Lay,2,Private room,70,350,1.96,420
25640,Lay,2,Private room,60,355,2.62,415
25641,Lou,2,Entire home/apt,300,51,0.57,351
25642,Alex,2,Entire home/apt,150,0,0.35,150
25643,Shane,2,Private room,72,0,0.04,72
25644,Mary,1,Entire home/apt,200,0,0.18,200
25645,Josh,2,Entire home/apt,80,0,0.09,80
25646,John,2,Private room,74,49,0.25,123
25647,Daniel,1,Entire home/apt,190,0,0.09,190
25648,Kyle,1,Private room,78,0,0.35,78
25649,Delia,1,Entire home/apt,250,0,0.09,250
25650,ResortShare5,1,Private room,198,263,0.4,461
25651,Juel,3,Entire home/apt,220,0,0.22,220
25652,Jeanie,1,Private room,75,0,0.22,75
25653,Ben,2,Entire home/apt,110,0,0.04,110
25654,Will,4,Entire home/apt,105,6,1.02,111
25655,Alex,3,Entire home/apt,250,1,0.16,251
25656,Jeff,2,Private room,150,266,1.72,416
25657,Amardeep,5,Private room,32,333,2.09,365
25658,Sophie,1,Entire home/apt,260,26,3.35,286
25659,Elizabeth,1,Private room,70,0,0.05,70
25660,Brooks,1,Entire home/apt,115,0,0.24,115
25661,Norma,3,Private room,80,177,0.85,257
25663,Christopher,2,Private room,47,0,0.8,47
25664,Whitney,2,Entire home/apt,97,0,0.09,97
25665,Hanna,1,Private room,95,1,1.14,96
25666,Rosemarie,2,Private room,35,342,0.16,377
25667,Ronny,1,Private room,65,0,0.09,65
25668,Laura,2,Private room,45,342,0.21,387
25670,Maayan,3,Private room,99,0,0.14,99
25672,Bei Lei,3,Entire home/apt,150,0,0.83,150
25673,Seo Hee,1,Private room,50,0,0.09,50
25674,Anna,1,Private room,50,3,0.9,53
25675,Frank,1,Entire home/apt,151,0,0.09,151
25676,Abdul,3,Private room,44,0,0.53,44
25677,Emmy,3,Private room,38,0,3.5,38
25678,Lilian,1,Entire home/apt,325,156,0.68,481
25680,Jermaine,2,Entire home/apt,139,67,5.06,206
25681,Richard,4,Entire home/apt,175,0,0.54,175
25682,Gabriella,1,Entire home/apt,168,0,0.2,168
25684,Elizabeth,1,Entire home/apt,250,0,0.76,250
25685,Chukwudike,2,Entire home/apt,100,0,0.26,100
25686,Roya,2,Entire home/apt,160,0,0.13,160
25688,Pablo,2,Private room,90,0,0.16,90
25691,Tiara,1,Private room,55,164,0.19,219
25692,Sara,2,Private room,70,0,0.04,70
25693,Emilia And Michael,2,Entire home/apt,275,310,2.78,585
25694,Michele,1,Private room,79,0,3.02,79
25696,Dorian,1,Private room,40,0,0.46,40
25697,Dora,2,Entire home/apt,105,239,2.72,344
25698,Andrea,2,Private room,70,0,0.09,70
25700,William,2,Private room,64,0,0.7,64
25701,Naveed,3,Entire home/apt,250,311,0.27,561
25702,Denise,2,Private room,75,330,0.52,405
25704,Will,4,Entire home/apt,100,26,1.05,126
25705,Shera,4,Private room,50,148,5.76,198
25706,Lou,2,Private room,49,0,1.55,49
25708,Stanley,1,Entire home/apt,130,364,0.05,494
25709,Elizabeth,2,Entire home/apt,118,0,0.09,118
25710,Stanley,1,Entire home/apt,150,333,0.28,483
25711,Kelsi,1,Entire home/apt,300,58,1.44,358
25712,Lou,2,Private room,49,191,2.2,240
25713,Hod & Chaya,2,Entire home/apt,245,5,0.43,250
25714,Candi,2,Private room,60,0,1.01,60
25715,Maria Ines,2,Entire home/apt,160,0,0.18,160
25716,Emily,1,Entire home/apt,275,318,1.26,593
25717,Christford,1,Entire home/apt,120,1,2.67,121
25718,Carly,2,Entire home/apt,150,9,0.35,159
25719,Amos,1,Private room,59,0,0.84,59
25720,Jessica,1,Entire home/apt,150,0,0.09,150
25721,Scott,1,Entire home/apt,154,0,0.13,154
25722,Jonathan,2,Entire home/apt,174,0,0.23,174
25723,Emma,1,Entire home/apt,250,81,1.0,331
25724,Fernando,1,Entire home/apt,200,2,0.13,202
25725,Morgan,4,Shared room,60,0,0.09,60
25726,Elena,2,Private room,85,281,0.13,366
25727,Victoria,2,Entire home/apt,120,10,0.4,130
25728,Leigh,1,Entire home/apt,115,76,0.42,191
25729,Lawrence & Patrice,2,Private room,47,320,0.93,367
25730,Daniel,1,Entire home/apt,150,1,1.25,151
25731,Fabien,2,Entire home/apt,140,0,0.19,140
25732,Walker,2,Private room,65,64,3.61,129
25733,Alfredo,1,Private room,140,82,5.7,222
25734,Lawrence & Patrice,2,Private room,47,317,1.19,364
25735,Yannick,2,Entire home/apt,100,0,0.23,100
25737,Yvette,3,Entire home/apt,62,178,2.36,240
25738,Rik,1,Private room,188,0,0.09,188
25739,Christine,2,Entire home/apt,185,0,0.04,185
25740,ResortShare5,1,Private room,252,327,0.16,579
25741,Bruce & Cyrina,2,Private room,44,0,1.67,44
25742,Jonathan,2,Entire home/apt,180,0,0.05,180
25743,Holly,2,Private room,50,6,0.04,56
25744,Antonya,1,Entire home/apt,799,359,0.09,1158
25745,Sal,2,Entire home/apt,180,60,2.18,240
25746,Siria,1,Entire home/apt,180,0,0.79,180
25747,Jerry,2,Private room,170,354,0.7,524
25748,Tripp,1,Entire home/apt,186,0,0.41,186
25750,Erik,3,Private room,90,83,0.09,173
25751,Harlem,1,Entire home/apt,172,0,2.78,172
25752,Athina,2,Private room,60,254,0.14,314
25753,Lauren,2,Private room,0,0,0.53,0
25754,Lara,1,Private room,52,0,0.05,52
25755,Keverel,2,Entire home/apt,184,0,1.78,184
25756,Jaymie,1,Entire home/apt,145,68,0.6,213
25757,Rachel,2,Private room,65,0,0.04,65
25758,JimiBeth,1,Entire home/apt,100,0,1.51,100
25759,Jonathan,2,Entire home/apt,74,61,0.42,135
25760,Levi,1,Entire home/apt,200,38,0.15,238
25761,Russell,1,Entire home/apt,175,55,1.75,230
25762,Leo,1,Entire home/apt,130,0,0.18,130
25763,Bruce & Cyrina,2,Private room,48,9,2.63,57
25764,Galen,1,Private room,200,0,0.05,200
25765,Rated,1,Entire home/apt,205,332,0.11,537
25767,Gabe,2,Entire home/apt,130,295,2.63,425
25768,Ralph,2,Private room,149,0,0.22,149
25769,Aaron,1,Private room,389,357,0.13,746
25771,Aaron,1,Entire home/apt,699,324,0.2,1023
25772,Victoria,2,Private room,67,0,0.05,67
25773,Christopher,1,Entire home/apt,135,0,0.23,135
25775,Kyle,1,Private room,83,0,0.04,83
25776,Perin,2,Private room,37,71,0.7,108
25777,John,1,Private room,65,81,1.84,146
25778,Aymeric,2,Entire home/apt,0,73,0.15,73
25779,Mazdak,2,Entire home/apt,100,0,0.09,100
25780,Ian,1,Entire home/apt,270,234,6.78,504
25781,Rosemarie,2,Private room,35,263,0.22,298
25783,Duane,2,Private room,67,0,1.03,67
25784,Christina,1,Private room,85,0,0.09,85
25785,Michael,1,Entire home/apt,225,0,0.13,225
25786,Alison,2,Private room,200,179,0.51,379
25787,Aaron,1,Private room,389,357,0.09,746
25788,Christopher,2,Entire home/apt,182,28,2.83,210
25789,Jim&Lisa,3,Private room,54,361,2.88,415
25790,Nick,1,Entire home/apt,400,26,0.24,426
25791,Renaldy,3,Private room,50,0,0.05,50
25793,Jamie,3,Entire home/apt,140,42,1.76,182
25794,Adeyemi,2,Private room,0,176,4.28,176
25795,Adeyemi,2,Private room,0,232,4.37,232
25796,Adeyemi,2,Private room,0,222,4.35,222
25798,Eryka,2,Private room,105,46,2.14,151
25799,Danny,1,Entire home/apt,139,25,0.56,164
25800,Maria,2,Private room,100,74,5.88,174
25801,Michael,2,Entire home/apt,130,134,0.99,264
25803,Oscar,1,Private room,77,200,4.1,277
25804,Merrill,2,Private room,75,0,0.18,75
25806,Manuel,2,Private room,80,0,0.04,80
25808,Katharina,2,Private room,65,109,0.67,174
25809,Rammi,1,Entire home/apt,220,91,1.65,311
25811,Laure,2,Private room,60,365,0.04,425
25812,Linda,2,Entire home/apt,180,0,0.57,180
25813,Caitlin,1,Private room,165,0,0.18,165
25814,Lera,1,Private room,75,0,0.21,75
25815,Ayodeji,1,Private room,100,90,0.4,190
25816,Jim & Barbara,2,Entire home/apt,120,0,0.5,120
25817,Kenya & Paul,2,Entire home/apt,179,185,2.39,364
25819,Mizue,1,Shared room,49,26,4.13,75
25820,Mizue,1,Shared room,49,22,4.56,71
25821,Spenser,2,Private room,90,0,0.76,90
25822,Bruce & Cyrina,2,Private room,50,0,1.16,50
25823,Devin,1,Entire home/apt,499,240,0.75,739
25824,Qingming,2,Private room,36,231,0.59,267
25825,Sarah-2,2,Entire home/apt,5000,0,0.18,5000
25826,Kate,1,Entire home/apt,275,171,0.76,446
25827,Svetlana,2,Entire home/apt,80,54,2.05,134
25828,Jose,4,Private room,35,156,1.55,191
25830,Joica,2,Private room,50,179,0.13,229
25834,Jorge,2,Private room,50,244,0.88,294
25835,Cole,1,Private room,150,0,0.22,150
25836,Guille,2,Private room,59,0,0.13,59
25837,Jacqueline,2,Entire home/apt,85,5,0.53,90
25838,Damon & Yvonne,2,Private room,60,178,0.23,238
25839,Sarah,1,Private room,110,82,1.34,192
25840,Bryan,2,Private room,37,359,2.8,396
25841,Sarah,2,Private room,90,0,0.14,90
25842,Alexandra,1,Entire home/apt,180,0,0.41,180
25843,René,2,Entire home/apt,111,0,0.04,111
25845,Yassir,2,Entire home/apt,135,0,0.79,135
25846,Alpana,1,Private room,120,337,1.65,457
25847,Igor,2,Entire home/apt,241,0,0.18,241
25848,Lux,2,Private room,69,178,3.45,247
25850,Andrew,2,Entire home/apt,94,0,0.57,94
25851,Zoe,1,Entire home/apt,130,0,0.13,130
25852,Shaye,1,Entire home/apt,135,0,0.04,135
25853,Artem,1,Private room,70,225,0.41,295
25854,Sam,1,Entire home/apt,290,0,0.04,290
25855,Yaimara,2,Private room,95,0,0.94,95
25856,Jake,2,Private room,53,0,0.18,53
25857,Chase,2,Private room,58,0,0.22,58
25858,Nick,2,Private room,80,0,0.09,80
25859,Rosemarie,2,Private room,33,245,1.0,278
25860,Ali,3,Entire home/apt,198,365,0.18,563
25861,Mimi,5,Private room,55,114,4.73,169
25862,Johnny,2,Private room,150,169,0.8,319
25863,Aurélie,1,Private room,100,34,3.06,134
25864,Chyanne & Jermaine,2,Entire home/apt,129,211,5.02,340
25865,Richard,1,Entire home/apt,138,93,0.28,231
25866,Hyacinth,2,Private room,40,306,2.57,346
25867,Trudy,3,Private room,35,348,2.73,383
25868,Trudy,3,Private room,50,249,2.35,299
25869,Hyacinth,2,Private room,40,298,2.34,338
25870,Alyssa,2,Private room,57,0,0.13,57
25871,Js,1,Private room,115,0,1.49,115
25872,Queen,3,Entire home/apt,80,115,3.83,195
25874,Ali,1,Entire home/apt,379,365,0.14,744
25875,Prime,2,Private room,48,2,0.31,50
25876,Lior,1,Private room,37,0,0.22,37
25877,Jade,1,Entire home/apt,175,244,1.69,419
25878,Graziella,2,Entire home/apt,50,234,1.51,284
25880,W.,4,Entire home/apt,450,342,0.06,792
25882,Brian,4,Entire home/apt,80,56,3.04,136
25885,Connie,2,Private room,125,351,1.5,476
25887,Lauren,2,Entire home/apt,130,110,0.78,240
25888,Maria Teresa,1,Entire home/apt,104,212,0.16,316
25889,Ryan,1,Entire home/apt,225,33,4.55,258
25890,Rated,1,Entire home/apt,178,327,0.12,505
25891,Johanna,2,Entire home/apt,114,13,1.19,127
25892,Will,2,Entire home/apt,130,4,0.52,134
25893,Andy,2,Entire home/apt,230,354,0.59,584
25894,Shuly,3,Private room,60,129,0.13,189
25896,Jay,1,Private room,150,0,0.14,150
25897,Kayla,1,Entire home/apt,150,0,0.26,150
25898,Rahul,1,Private room,100,0,0.04,100
25899,Pedro,4,Private room,55,0,0.11,55
25900,Bels,2,Private room,75,35,0.64,110
25901,Lloyd,1,Entire home/apt,3900,180,0.32,4080
25902,Zaki,2,Private room,65,0,0.05,65
25903,Lidia,1,Private room,89,86,1.58,175
25904,George,2,Entire home/apt,159,2,1.6,161
25906,Antoine,2,Entire home/apt,115,0,0.22,115
25907,Kirk,3,Entire home/apt,125,0,0.22,125
25909,Wesly/Jessica,2,Entire home/apt,165,263,0.16,428
25910,Gary,2,Entire home/apt,129,43,4.15,172
25911,Gina,1,Entire home/apt,350,0,0.14,350
25912,Bridge,1,Entire home/apt,90,306,0.25,396
25914,James,4,Private room,50,118,2.04,168
25915,Henry,1,Private room,110,0,0.27,110
25916,Janelle,2,Private room,55,82,1.44,137
25917,Charlotte,1,Entire home/apt,300,0,1.14,300
25918,Bing,3,Private room,49,362,3.43,411
25919,Jana,1,Entire home/apt,158,0,0.18,158
25920,Natalie,2,Entire home/apt,97,2,0.33,99
25921,Taylor,1,Entire home/apt,95,70,0.48,165
25922,Jermaine,2,Private room,100,364,0.1,464
25923,Ella Jane,1,Private room,65,57,3.16,122
25924,Daniel,2,Entire home/apt,100,0,0.13,100
25925,Art,2,Private room,50,0,0.98,50
25926,Lin,2,Private room,75,84,2.01,159
25927,Eric,2,Private room,55,0,0.18,55
25928,Dike,1,Private room,55,156,0.28,211
25929,Jenny And Mark,2,Entire home/apt,175,336,2.2,511
25930,Danny,1,Private room,100,0,0.14,100
25931,Mark,2,Private room,75,0,0.05,75
25932,Chelsea,2,Private room,75,0,0.25,75
25933,Sophie,2,Private room,35,364,0.09,399
25935,Charles,1,Private room,95,0,1.9,95
25936,Philip,1,Entire home/apt,175,65,0.13,240
25937,Jessica,1,Entire home/apt,180,171,0.56,351
25938,Sandra,3,Private room,55,65,2.29,120
25939,Simon,3,Private room,79,48,1.64,127
25940,Audra,2,Private room,30,292,0.59,322
25941,Jose,1,Entire home/apt,50,0,0.09,50
25943,Corporate Housing,1,Entire home/apt,133,281,0.47,414
25944,Nicolas,2,Entire home/apt,496,313,0.92,809
25945,Elsa,1,Private room,75,188,0.17,263
25946,Sarah,1,Private room,100,124,1.62,224
25948,Michela,1,Private room,80,0,0.36,80
25949,David,1,Private room,123,0,2.44,123
25950,Marzian,2,Private room,30,0,0.4,30
25951,Alex,2,Private room,50,0,0.54,50
25952,Christopher,2,Entire home/apt,195,0,0.44,195
25953,Eliahu,1,Private room,69,112,0.62,181
25954,Nicole,3,Entire home/apt,150,153,2.01,303
25955,Hunter,2,Private room,49,56,0.23,105
25956,Sofia,2,Entire home/apt,95,22,2.64,117
25957,Karl,5,Entire home/apt,109,100,5.08,209
25958,Domingo,1,Entire home/apt,105,261,4.86,366
25959,Yunmi,3,Private room,49,0,0.19,49
25960,Morgan,2,Entire home/apt,120,0,0.35,120
25961,Eliahu,1,Private room,69,365,0.47,434
25962,Thomas,1,Private room,85,0,4.39,85
25964,Lily,2,Entire home/apt,135,15,0.95,150
25965,Tim,2,Private room,49,0,0.05,49
25966,Alina,2,Private room,100,0,0.6,100
25968,Bruce & Cyrina,2,Private room,48,4,0.4,52
25969,Lulu,1,Entire home/apt,87,20,0.23,107
25970,Khalif,1,Private room,85,61,0.59,146
25971,Alex,2,Private room,48,0,0.09,48
25972,Elias,1,Private room,90,66,2.52,156
25973,Maya,2,Private room,60,13,0.27,73
25974,Sarah,2,Private room,50,30,3.7,80
25975,Jennifer,2,Private room,85,61,2.71,146
25976,Dana,2,Private room,70,0,0.43,70
25977,Fourth,2,Entire home/apt,125,243,3.43,368
25978,Guelma,3,Private room,45,90,1.52,135
25980,Milica,1,Private room,89,18,1.03,107
25981,Guelma,3,Private room,42,297,0.94,339
25982,Mauro,2,Private room,50,178,0.97,228
25983,Alberto,3,Private room,120,356,2.81,476
25984,Ana,1,Private room,60,332,3.37,392
25985,Dana,1,Shared room,62,0,0.45,62
25987,Nate,2,Private room,76,310,0.4,386
25988,Beth,2,Private room,47,63,2.73,110
25990,Sebastian,1,Private room,60,0,0.49,60
25991,Shawn,2,Entire home/apt,200,0,0.09,200
25993,Juan David,3,Private room,55,6,0.46,61
25995,Hannah,1,Shared room,60,0,0.04,60
25996,Steven,2,Private room,50,0,0.04,50
25999,Jonathan,2,Entire home/apt,250,0,0.14,250
26000,Lindsay,2,Private room,85,0,0.62,85
26001,Brooke,1,Entire home/apt,174,0,0.19,174
26002,Jaime,2,Private room,100,0,0.28,100
26004,Mel & Ruth,3,Private room,75,48,0.95,123
26005,Roland,2,Entire home/apt,160,136,0.94,296
26006,Auni (Masroor),2,Private room,88,0,0.05,88
26007,Jonathan,3,Entire home/apt,170,141,0.64,311
26008,Brian,2,Private room,95,0,1.08,95
26009,Nick,2,Private room,62,108,2.3,170
26010,Bryan,3,Private room,45,16,0.89,61
26011,Jeniffer,1,Entire home/apt,100,270,0.21,370
26012,Dinara,3,Private room,60,0,0.05,60
26013,Hutch,1,Entire home/apt,211,237,1.34,448
26014,Maiya,2,Entire home/apt,100,0,0.18,100
26015,Tirinda,2,Entire home/apt,250,39,4.48,289
26016,Moya,1,Entire home/apt,125,0,0.36,125
26017,Frances,1,Entire home/apt,145,86,0.63,231
26018,Samantha,2,Private room,116,0,2.82,116
26019,Jennifer,1,Private room,50,39,0.62,89
26020,Yomi,2,Entire home/apt,175,0,0.81,175
26022,Joy,3,Entire home/apt,246,359,0.15,605
26023,Mariana,2,Private room,44,0,0.05,44
26024,Emily,1,Entire home/apt,99,269,1.5,368
26025,Nahuel,4,Private room,62,351,3.34,413
26026,Shera,4,Private room,55,318,7.0,373
26027,Eliahu,1,Private room,69,365,0.1,434
26028,David,1,Entire home/apt,150,16,0.67,166
26031,Nahuel,4,Private room,42,311,4.11,353
26032,Nahuel,4,Private room,42,1,2.76,43
26033,Susan,1,Private room,50,42,1.46,92
26034,Eliahu,1,Private room,69,116,0.7,185
26035,Andrew T,1,Entire home/apt,145,194,3.62,339
26036,Jennifer,2,Entire home/apt,58,0,0.45,58
26038,Mariarosa,1,Entire home/apt,175,0,0.09,175
26039,Kellie,1,Private room,100,87,0.96,187
26040,Micipsa,1,Entire home/apt,135,59,3.04,194
26041,Dominique,1,Private room,120,0,0.28,120
26042,Sarah,2,Private room,49,3,3.22,52
26043,Lindsay,2,Private room,48,0,0.14,48
26045,Conley,1,Entire home/apt,435,0,0.14,435
26046,Randy,1,Private room,93,0,0.32,93
26047,Joy,3,Private room,60,0,1.23,60
26048,Michael,2,Private room,42,0,0.27,42
26050,Zaza,1,Private room,88,86,1.53,174
26052,Wesly/Jessica,2,Private room,60,320,1.88,380
26053,Lux,2,Private room,58,178,3.56,236
26054,Audlyn,2,Entire home/apt,90,318,3.71,408
26055,Randy,1,Private room,65,112,0.23,177
26056,Fiona,2,Private room,76,0,0.27,76
26057,Jaweer,2,Entire home/apt,74,0,0.05,74
26058,Mauro,2,Private room,95,31,3.91,126
26059,Aaron,2,Entire home/apt,210,268,4.62,478
26060,Sydnee,1,Private room,50,0,0.09,50
26061,Avihay,3,Entire home/apt,93,0,0.05,93
26062,Christian,2,Entire home/apt,250,51,0.14,301
26063,Cyrus,1,Entire home/apt,269,10,0.47,279
26064,Cesar,1,Private room,70,169,1.65,239
26065,Ruben,2,Private room,90,0,0.14,90
26066,Patricia,1,Entire home/apt,422,339,2.6,761
26067,Tess,1,Entire home/apt,250,41,0.46,291
26068,Patricio,3,Private room,99,328,0.05,427
26069,Marvis,1,Private room,65,44,2.71,109
26070,Nicole,3,Private room,55,155,0.27,210
26071,Julia,1,Entire home/apt,149,0,0.23,149
26072,Michael,3,Private room,45,58,0.56,103
26073,Mercedes,4,Private room,40,156,0.46,196
26074,Michael,2,Private room,135,0,0.09,135
26076,Cait,1,Entire home/apt,75,0,0.14,75
26078,Tina,2,Entire home/apt,145,0,0.05,145
26079,Bradley,1,Entire home/apt,160,0,0.23,160
26080,Josh,2,Private room,100,42,3.67,142
26081,Daré,3,Private room,58,84,2.02,142
26082,Josh,2,Private room,120,0,0.23,120
26083,Ismail,3,Private room,80,364,1.18,444
26084,Elina,1,Private room,65,11,3.8,76
26085,Miguel,2,Entire home/apt,115,0,0.32,115
26088,Renee,3,Entire home/apt,100,0,0.82,100
26090,Omar,1,Entire home/apt,245,54,2.58,299
26091,Kyle,2,Entire home/apt,80,272,3.94,352
26092,Ainslie And John,2,Private room,110,182,1.94,292
26093,Kristin,1,Entire home/apt,183,37,0.13,220
26094,Beverley,3,Private room,55,354,5.23,409
26095,Haniel,1,Entire home/apt,250,0,0.05,250
26097,Andrea,2,Private room,120,135,1.71,255
26098,Marlon,1,Private room,89,0,0.05,89
26099,Maggy,2,Entire home/apt,100,89,1.64,189
26100,Eli,2,Private room,59,63,1.3,122
26101,Sam,2,Private room,50,8,2.53,58
26102,Justine,4,Private room,45,365,0.54,410
26103,Frankie,2,Private room,50,0,0.05,50
26104,Lise,3,Private room,49,96,0.51,145
26105,Carla,1,Private room,55,0,3.6,55
26106,Kimberly,3,Entire home/apt,69,140,7.5,209
26107,Sabrina,2,Entire home/apt,275,129,0.43,404
26108,Melissa,1,Entire home/apt,125,0,0.19,125
26109,Eric,1,Entire home/apt,300,179,0.91,479
26110,Chris,2,Entire home/apt,145,205,2.07,350
26111,Luz,1,Entire home/apt,170,291,6.18,461
26112,Ez,3,Entire home/apt,95,217,2.97,312
26114,Ez,1,Entire home/apt,150,199,3.03,349
26116,Brielle,2,Private room,60,0,0.06,60
26118,Denise,2,Private room,70,278,0.6,348
26119,Khalif,1,Private room,53,89,0.23,142
26120,Samantha,1,Private room,130,157,3.32,287
26121,Deo,1,Entire home/apt,350,151,0.15,501
26122,Farrel,4,Private room,60,179,1.38,239
26123,Bonissat,4,Private room,35,50,1.68,85
26124,Zachary,3,Entire home/apt,179,0,0.23,179
26125,Denise,2,Private room,65,303,0.76,368
26126,Rhianna,2,Private room,75,0,0.09,75
26127,Rubén,2,Entire home/apt,90,6,0.59,96
26128,Juliana,1,Private room,114,0,0.47,114
26129,M,3,Entire home/apt,111,96,0.99,207
26130,Daré,3,Private room,58,84,2.92,142
26131,Brandon,3,Entire home/apt,95,15,0.28,110
26132,Cat,1,Entire home/apt,220,0,0.05,220
26133,Jae,2,Private room,99,0,0.71,99
26134,Mirko,2,Private room,93,0,0.63,93
26135,Michelle,2,Private room,55,53,2.84,108
26136,Gulcin,1,Private room,50,257,1.91,307
26138,Sam,2,Entire home/apt,150,127,3.15,277
26139,Kennedy,2,Private room,35,0,0.05,35
26140,Jorge,1,Entire home/apt,150,0,0.69,150
26141,Stephon,2,Entire home/apt,75,0,0.9,75
26142,Abigail,1,Entire home/apt,150,27,1.08,177
26143,Ramonex,1,Private room,65,205,3.8,270
26145,Fay,2,Entire home/apt,125,15,5.31,140
26146,Tunzil,4,Private room,59,35,0.5,94
26148,Xie,2,Private room,75,331,1.23,406
26150,Malcolm,2,Entire home/apt,125,113,2.83,238
26151,Stanley,1,Entire home/apt,175,365,0.09,540
26152,Stanley,1,Entire home/apt,367,358,0.09,725
26153,Nikki,2,Private room,75,0,1.16,75
26155,Alex,2,Entire home/apt,137,350,0.3,487
26156,Jamal,1,Private room,95,0,0.78,95
26158,Ryan,1,Private room,150,94,4.71,244
26159,Frederick,2,Entire home/apt,115,0,1.01,115
26160,Liliana,3,Private room,45,80,0.83,125
26161,Elliot,4,Private room,55,46,2.16,101
26162,Stephanie,2,Entire home/apt,180,0,0.09,180
26164,Anh,1,Private room,99,14,2.54,113
26165,Elvis,1,Entire home/apt,200,288,1.81,488
26166,Sarah,2,Entire home/apt,70,0,0.69,70
26167,Samera,2,Entire home/apt,125,88,1.84,213
26168,Beth,1,Entire home/apt,150,25,0.8,175
26169,Arata,1,Entire home/apt,164,18,0.51,182
26171,Ashley,2,Private room,60,1,0.34,61
26172,Medea,2,Entire home/apt,130,357,1.59,487
26174,Nik,2,Entire home/apt,114,0,0.11,114
26175,Glenn,2,Entire home/apt,225,106,5.71,331
26176,Stefanie,2,Entire home/apt,250,0,0.16,250
26177,Qingming,2,Entire home/apt,99,153,1.45,252
26178,Sam,1,Entire home/apt,209,0,1.14,209
26179,Takanori,2,Private room,59,42,4.26,101
26180,Raul,1,Entire home/apt,300,30,0.37,330
26181,Trinh,1,Private room,160,0,0.27,160
26182,Cristina,3,Private room,45,314,0.79,359
26183,Su,2,Entire home/apt,250,184,0.14,434
26185,Haley,1,Shared room,120,365,2.2,485
26186,Oliver,3,Private room,47,0,0.09,47
26187,Mariaelena,1,Private room,53,0,2.16,53
26188,Fone,3,Private room,55,0,0.47,55
26189,Ramon,1,Entire home/apt,225,34,4.79,259
26190,Lidia,3,Private room,78,365,0.91,443
26191,Abe,5,Private room,52,78,3.34,130
26192,David,3,Private room,60,32,6.27,92
26193,Aura,1,Entire home/apt,161,63,4.73,224
26195,Karina,2,Private room,60,82,0.95,142
26196,Ayelet,1,Private room,75,0,0.09,75
26197,Charlene,2,Private room,38,29,1.92,67
26198,Jeny,3,Private room,35,95,1.37,130
26200,Sonya,2,Entire home/apt,130,10,2.53,140
26201,Amar,2,Entire home/apt,159,0,0.26,159
26202,Louisa,1,Private room,83,0,0.61,83
26203,Dylan,2,Entire home/apt,225,47,0.55,272
26204,Gabriella,2,Private room,70,0,0.32,70
26205,Liam,2,Private room,70,0,0.18,70
26206,Roselin,1,Entire home/apt,125,245,0.94,370
26207,Corporate Housing,1,Entire home/apt,125,314,0.29,439
26210,Nick,1,Entire home/apt,198,0,0.23,198
26211,Zoe,2,Entire home/apt,200,87,0.77,287
26212,Thomas,2,Entire home/apt,102,0,0.47,102
26213,Leah,2,Private room,80,0,0.05,80
26214,Ted,1,Private room,350,0,0.34,350
26216,Gilles,2,Entire home/apt,155,4,0.27,159
26217,Domonique,2,Entire home/apt,310,347,3.51,657
26218,Fred,1,Entire home/apt,525,34,2.19,559
26219,Vered,1,Entire home/apt,200,0,0.09,200
26220,Jason,2,Entire home/apt,95,0,0.19,95
26223,Pauline,2,Private room,98,0,0.34,98
26224,Sonia,1,Private room,79,0,0.05,79
26225,Journee,4,Entire home/apt,79,225,4.46,304
26226,Carmel,1,Private room,87,0,0.27,87
26227,Matthew,1,Entire home/apt,210,13,0.64,223
26228,Jed,1,Entire home/apt,150,24,1.47,174
26229,Michal,1,Entire home/apt,260,222,1.04,482
26230,Caryn,1,Entire home/apt,121,0,0.51,121
26231,Gal,1,Entire home/apt,129,310,0.05,439
26232,Deniz,2,Entire home/apt,90,157,0.23,247
26233,Semih,2,Private room,100,0,0.38,100
26234,Jj,2,Entire home/apt,250,354,0.28,604
26235,Marie L,2,Entire home/apt,250,360,1.7,610
26236,Daniel,2,Entire home/apt,225,43,2.2,268
26237,Melissa,2,Private room,45,44,0.05,89
26238,Jj,2,Entire home/apt,165,179,0.19,344
26239,Melrose,3,Entire home/apt,85,36,2.69,121
26240,Dine,5,Private room,29,178,2.81,207
26241,Sahar,2,Private room,85,19,0.7,104
26242,Haider & Galiya,2,Private room,75,0,1.81,75
26244,Kirstie,2,Private room,79,59,1.6,138
26245,David,1,Private room,125,0,3.24,125
26246,Alyssa,1,Private room,78,0,0.28,78
26248,LaToya,3,Entire home/apt,113,297,2.5,410
26249,Jeremy,2,Entire home/apt,370,171,1.25,541
26250,Michael,2,Entire home/apt,150,79,0.44,229
26251,Shuly,3,Private room,60,128,2.27,188
26252,Gustavo,1,Private room,65,0,1.18,65
26253,Gabrielle,1,Entire home/apt,103,0,0.84,103
26255,Eunice,1,Private room,65,0,0.46,65
26256,Devon,2,Private room,80,0,0.09,80
26257,Rhita,3,Private room,50,115,6.44,165
26258,Max,3,Private room,60,359,1.79,419
26260,Awilda,2,Private room,137,0,0.23,137
26261,Derek,2,Entire home/apt,150,83,0.23,233
26263,Nastya,1,Private room,120,50,3.38,170
26264,Doug,1,Entire home/apt,225,0,0.05,225
26265,Frances,2,Private room,50,0,0.1,50
26266,Billy,1,Entire home/apt,435,22,0.32,457
26267,Sorcha,1,Private room,100,0,0.19,100
26268,Men Yee,2,Entire home/apt,150,76,2.26,226
26270,Dylan,2,Private room,69,324,2.05,393
26272,Mayra,3,Private room,47,100,4.13,147
26273,Lara,1,Private room,134,316,0.11,450
26274,Daniela,2,Entire home/apt,200,0,0.27,200
26275,Lu,1,Entire home/apt,150,0,0.05,150
26276,Taka,3,Entire home/apt,99,5,0.23,104
26278,Marvin,1,Entire home/apt,148,98,3.09,246
26279,Eréz,2,Private room,30,180,0.11,210
26281,Leva,1,Entire home/apt,150,0,0.14,150
26283,Orain,3,Private room,45,0,1.37,45
26284,Wenqin,3,Private room,55,342,1.83,397
26285,Candi,2,Private room,105,89,0.38,194
26286,Laura,1,Private room,85,19,2.01,104
26287,Nina,2,Entire home/apt,131,5,1.46,136
26288,Sasha,2,Entire home/apt,169,16,0.56,185
26289,Jotham,2,Private room,58,49,0.42,107
26290,Nihad,4,Entire home/apt,140,291,3.45,431
26291,Tony,2,Entire home/apt,200,75,2.5,275
26292,Ghislain Serge,2,Private room,120,13,1.39,133
26293,Medea,2,Private room,75,342,0.16,417
26294,Amit,2,Entire home/apt,99,0,0.09,99
26295,Arina,2,Entire home/apt,120,0,0.14,120
26296,Nikki,2,Private room,45,17,2.06,62
26297,Dong Ming,3,Private room,89,179,0.2,268
26298,William,1,Entire home/apt,186,0,0.74,186
26299,Chimme,3,Private room,70,0,0.24,70
26300,Sheila,3,Entire home/apt,90,281,6.87,371
26302,Lilja,2,Entire home/apt,134,0,0.8,134
26303,Elan,3,Entire home/apt,99,38,0.39,137
26304,J. Beverly,2,Entire home/apt,85,1,0.64,86
26305,Marlice,2,Private room,80,336,2.79,416
26306,Marlice,2,Private room,45,312,3.67,357
26307,Marlice,2,Private room,110,347,1.21,457
26308,Leonor And Luca,2,Entire home/apt,139,37,0.33,176
26309,Petra,2,Entire home/apt,120,318,8.75,438
26310,Tiffany,1,Entire home/apt,110,0,0.38,110
26311,Nish,1,Private room,110,3,1.87,113
26312,Cleber,1,Private room,38,26,0.97,64
26313,Sonya,2,Private room,100,21,1.44,121
26314,Chris,2,Entire home/apt,250,0,0.27,250
26316,Petko,1,Entire home/apt,199,34,1.41,233
26317,Anna,2,Private room,40,0,0.36,40
26318,Glenn Thomas,1,Entire home/apt,195,47,0.42,242
26320,Linda,2,Private room,52,310,3.93,362
26321,Majar,2,Private room,75,352,0.14,427
26322,Martin,2,Entire home/apt,99,170,0.18,269
26323,Max,2,Private room,55,0,0.28,55
26324,David,2,Private room,54,0,0.07,54
26325,Paula,2,Private room,90,167,1.36,257
26326,Daniella,2,Private room,50,0,0.05,50
26327,Jotham,2,Private room,53,54,0.1,107
26328,Jotham,2,Private room,59,41,0.47,100
26329,Glenn,2,Private room,99,12,0.69,111
26330,Cezar,1,Entire home/apt,195,0,0.22,195
26331,Karen,2,Entire home/apt,160,36,0.18,196
26332,Wakahiu,1,Entire home/apt,250,0,0.33,250
26333,Ant,3,Entire home/apt,150,89,0.46,239
26335,Grace,2,Private room,45,0,0.05,45
26336,Faith,2,Entire home/apt,149,12,1.81,161
26337,Patrick,2,Private room,60,81,0.42,141
26338,Thomas,3,Entire home/apt,99,305,4.34,404
26339,Andrew,2,Private room,65,0,0.09,65
26340,Ruchi,1,Entire home/apt,225,311,1.0,536
26341,Angie,2,Private room,79,249,1.12,328
26343,Angie,2,Private room,79,333,0.69,412
26344,Angie,2,Private room,54,276,1.01,330
26346,Rinat,2,Entire home/apt,145,13,1.06,158
26347,Dan,2,Entire home/apt,300,75,2.33,375
26348,Tyshawn,1,Private room,58,248,3.0,306
26349,Zach,1,Private room,70,0,0.09,70
26350,Lara,2,Private room,50,0,0.23,50
26351,Max,3,Private room,55,365,3.58,420
26352,Rohit,2,Entire home/apt,170,288,4.79,458
26353,Rohit,2,Entire home/apt,124,272,4.4,396
26354,Hollis,1,Private room,40,0,0.28,40
26355,Grace,1,Private room,111,56,2.39,167
26356,Melinda,3,Private room,75,0,1.81,75
26357,Arnaud,1,Entire home/apt,325,86,0.37,411
26358,Maxim,1,Private room,107,9,6.08,116
26359,Carolina,4,Private room,60,0,0.74,60
26360,Alana,2,Private room,60,0,0.2,60
26361,Rahul,2,Private room,60,234,4.03,294
26364,Peter,1,Private room,135,363,0.82,498
26365,Victor,3,Shared room,41,125,0.51,166
26366,Brooke,2,Entire home/apt,160,0,0.05,160
26367,Claire,2,Private room,80,0,0.23,80
26368,Salome,2,Private room,100,39,0.28,139
26369,Ting,3,Private room,59,54,2.91,113
26370,Tiffany,4,Entire home/apt,65,0,0.55,65
26372,Adriana,1,Private room,175,239,1.08,414
26373,Leyla,1,Entire home/apt,100,168,2.3,268
26374,Roman,2,Private room,119,0,0.05,119
26377,Marc,3,Private room,32,0,2.91,32
26378,Nicola,1,Entire home/apt,245,50,0.61,295
26379,Anthony,1,Entire home/apt,700,258,0.65,958
26380,Taylor,1,Private room,90,0,1.91,90
26381,Kathryn,1,Private room,30,72,3.07,102
26382,Daniele,1,Entire home/apt,135,160,0.48,295
26383,Alek,1,Entire home/apt,200,29,0.72,229
26384,William,2,Entire home/apt,120,0,0.37,120
26385,Collin,2,Private room,119,78,0.64,197
26386,Mike,1,Entire home/apt,196,6,2.26,202
26387,Angie,2,Private room,80,324,0.14,404
26388,Max,3,Private room,55,340,1.9,395
26389,David,3,Entire home/apt,88,54,0.42,142
26390,柏润,1,Private room,78,0,0.5,78
26391,Chelsea,1,Private room,50,0,0.29,50
26392,Jewell,1,Entire home/apt,215,6,1.28,221
26393,Shawn,2,Entire home/apt,300,294,3.29,594
26395,Ashley,2,Entire home/apt,250,0,0.85,250
26397,Harvin,2,Entire home/apt,180,303,0.73,483
26398,Marcy,1,Entire home/apt,650,0,0.14,650
26399,Nazeer,4,Private room,60,283,3.55,343
26401,Emily,1,Entire home/apt,280,341,1.4,621
26402,Yves,3,Entire home/apt,100,0,0.14,100
26403,Thomas And Madalena,2,Entire home/apt,75,0,0.09,75
26404,Joe & Jay,2,Entire home/apt,135,139,4.14,274
26405,Laurel,2,Private room,50,18,2.68,68
26406,Raymond,1,Entire home/apt,175,161,0.15,336
26408,Leonard,3,Private room,50,94,0.31,144
26409,Adesh & Viviana,3,Entire home/apt,130,145,0.39,275
26410,Kyle,2,Private room,70,6,0.37,76
26411,Leonard,3,Private room,45,325,0.82,370
26412,Andrey,1,Private room,250,94,0.2,344
26413,Bryan,1,Private room,155,307,2.87,462
26414,Lory And Cindy,2,Entire home/apt,100,125,8.95,225
26415,Maxim,2,Private room,76,349,4.56,425
26416,Vegard,2,Entire home/apt,240,179,2.83,419
26418,Sachie,2,Private room,35,0,0.05,35
26419,Catalina,2,Private room,50,0,0.05,50
26420,Jacques,2,Private room,90,0,0.05,90
26421,Andre,2,Private room,65,70,1.51,135
26423,Carly,1,Private room,92,14,4.65,106
26425,Tiffany,2,Private room,58,21,5.48,79
26426,Fer,1,Entire home/apt,85,0,0.22,85
26427,Jesper,1,Entire home/apt,250,0,1.61,250
26428,Premshree,2,Entire home/apt,116,0,0.05,116
26429,Laney,2,Entire home/apt,120,0,0.23,120
26430,Alexandre,1,Private room,70,0,0.09,70
26431,Fred,2,Private room,100,2,1.58,102
26432,Jacquelin And,3,Private room,76,8,2.02,84
26433,Andrey,1,Entire home/apt,150,7,4.79,157
26434,Kathy,2,Entire home/apt,100,0,0.66,100
26435,Lauren,2,Private room,75,0,0.1,75
26437,Andrea,2,Entire home/apt,120,0,0.16,120
26438,Tanya,4,Private room,42,62,0.27,104
26439,Luigi,2,Entire home/apt,349,105,0.14,454
26441,Summer,4,Private room,30,361,0.23,391
26442,Whitney,2,Private room,70,46,0.25,116
26443,Ekaterina,1,Entire home/apt,1177,284,2.03,1461
26444,Adam,1,Private room,110,0,0.09,110
26445,Julie,2,Private room,65,0,0.05,65
26447,Alice,2,Entire home/apt,120,0,0.05,120
26448,Janelle,3,Private room,33,139,0.35,172
26449,Angela,3,Private room,38,175,0.19,213
26450,Aston,3,Entire home/apt,200,357,1.18,557
26451,Michael,1,Entire home/apt,790,36,1.99,826
26452,Chez,1,Entire home/apt,225,0,1.4,225
26453,Lisa,3,Private room,90,87,0.38,177
26454,Ricardo,3,Private room,100,0,0.05,100
26455,Janet,1,Private room,99,129,1.62,228
26456,Leo,3,Private room,55,229,3.56,284
26457,Leo,3,Private room,55,265,2.54,320
26458,Leo,3,Private room,58,279,2.87,337
26459,Alex,2,Entire home/apt,97,0,0.39,97
26460,Brittany,2,Entire home/apt,165,158,0.46,323
26461,Kevin,1,Entire home/apt,125,0,0.26,125
26462,Yoni,2,Entire home/apt,106,0,0.11,106
26463,Max,3,Private room,60,362,4.26,422
26464,Ahmed,2,Entire home/apt,99,69,1.36,168
26465,Seth,1,Entire home/apt,180,0,0.14,180
26466,Rob,1,Entire home/apt,129,40,0.35,169
26467,Neda,1,Entire home/apt,160,0,0.15,160
26468,Maria,1,Private room,86,170,7.33,256
26469,Lindsay,2,Private room,155,0,0.19,155
26470,Hadas,2,Entire home/apt,185,14,2.34,199
26471,Mark,1,Private room,210,0,0.22,210
26472,Felix,1,Private room,80,0,0.05,80
26473,Irina,1,Entire home/apt,130,272,0.23,402
26474,Paul,1,Entire home/apt,113,0,0.05,113
26475,Jacob,2,Entire home/apt,160,0,0.1,160
26476,Harrison,2,Entire home/apt,350,0,0.14,350
26477,Stanley,1,Entire home/apt,222,364,0.15,586
26478,Vigil,1,Private room,65,333,0.42,398
26479,Carissa,1,Private room,90,0,0.09,90
26480,Ivan,1,Private room,65,0,0.14,65
26481,Nelson Antonio,1,Private room,55,251,3.05,306
26482,James,2,Entire home/apt,94,12,1.15,106
26483,Corporate Housing,1,Entire home/apt,185,201,0.25,386
26484,Lucy & Rodo,3,Private room,49,64,6.05,113
26485,Sydney,1,Private room,80,0,0.42,80
26486,Dawn,2,Entire home/apt,139,358,3.11,497
26488,Alexandra,2,Entire home/apt,400,0,0.05,400
26489,Pedro J,3,Private room,45,0,0.05,45
26490,Michael,1,Private room,75,0,0.09,75
26491,Philip,1,Private room,100,0,0.05,100
26492,Zachary,1,Entire home/apt,150,182,0.87,332
26493,Shelliann,2,Entire home/apt,100,225,5.38,325
26494,Alexandra,1,Entire home/apt,139,0,0.1,139
26495,Mariana,4,Entire home/apt,40,35,1.81,75
26496,Bridge,1,Entire home/apt,80,272,0.26,352
26497,Jie,3,Private room,100,189,1.65,289
26498,Tori,2,Private room,100,0,0.1,100
26499,Chris,2,Entire home/apt,150,160,2.49,310
26500,Kadu,1,Entire home/apt,273,166,2.19,439
26501,Dawn,1,Entire home/apt,225,151,3.88,376
26503,Joe,2,Entire home/apt,135,0,0.84,135
26504,Amy,1,Entire home/apt,400,0,0.05,400
26505,Anne,2,Entire home/apt,125,62,4.61,187
26508,Stanley,1,Entire home/apt,175,364,0.08,539
26509,Keziah,1,Entire home/apt,70,4,1.83,74
26510,Stanley,1,Entire home/apt,175,364,0.19,539
26511,Stanley,1,Entire home/apt,130,364,0.16,494
26512,Jordan,1,Entire home/apt,150,6,0.05,156
26513,James &,3,Private room,45,164,10.39,209
26514,Lane,3,Private room,50,341,2.34,391
26515,Ben,2,Private room,100,0,0.05,100
26516,Edhar,1,Private room,90,10,2.68,100
26517,Tommy,2,Private room,45,0,0.43,45
26518,Zach,2,Entire home/apt,175,135,3.56,310
26519,Rachel,1,Private room,99,125,0.42,224
26520,Jaye,2,Private room,60,120,3.24,180
26521,Elise,2,Entire home/apt,158,283,0.42,441
26522,Sam,2,Private room,60,0,1.67,60
26524,Liz,1,Private room,145,197,2.01,342
26525,Alan,3,Entire home/apt,110,297,0.27,407
26526,Jeremiah,4,Entire home/apt,115,130,4.76,245
26527,Giovanni,2,Private room,50,0,1.08,50
26528,Jimmy &Cindy,3,Private room,45,349,3.16,394
26529,Russell,3,Entire home/apt,180,120,2.22,300
26530,Mimi,2,Entire home/apt,350,166,0.24,516
26531,Kevin,2,Entire home/apt,125,0,1.85,125
26532,Anthony,1,Entire home/apt,180,0,1.25,180
26533,John And Colleen,3,Private room,70,84,0.94,154
26534,Cameron,1,Entire home/apt,126,2,0.7,128
26535,Zsofia,1,Entire home/apt,190,0,0.71,190
26536,Michael,2,Private room,50,346,3.97,396
26537,Nikki,2,Private room,50,0,1.04,50
26538,Edhar,1,Private room,95,10,2.56,105
26540,Laurel,2,Entire home/apt,115,0,0.09,115
26541,Juan,3,Entire home/apt,85,179,1.62,264
26542,Kaila,4,Private room,40,148,0.19,188
26545,Qais,2,Private room,89,269,0.14,358
26546,Max,1,Shared room,32,341,0.25,373
26547,Dominique,4,Private room,28,214,1.32,242
26548,Jose,2,Private room,55,0,0.05,55
26549,Victor,3,Entire home/apt,100,220,1.97,320
26550,Christopher,2,Private room,125,0,2.79,125
26551,Anna,2,Entire home/apt,150,0,0.05,150
26552,Emily,1,Entire home/apt,300,313,0.38,613
26555,Bel And Camila,1,Private room,100,318,1.82,418
26557,Chris,3,Entire home/apt,150,364,0.86,514
26558,Ivan,1,Entire home/apt,199,335,1.34,534
26560,Dominique,1,Entire home/apt,275,196,0.79,471
26561,Gerard,2,Private room,75,0,0.52,75
26562,Jack,2,Entire home/apt,150,105,0.25,255
26563,Clover,2,Entire home/apt,180,175,0.69,355
26564,Jimmy &Cindy,3,Private room,43,365,1.99,408
26565,Chris,2,Private room,85,0,1.35,85
26566,Gane,1,Private room,115,15,7.43,130
26567,Christopher,2,Entire home/apt,105,188,0.38,293
26568,Guanchen,2,Private room,70,0,0.05,70
26569,Emily,1,Entire home/apt,290,281,0.22,571
26570,Luxi,3,Entire home/apt,148,77,1.15,225
26571,Erin,1,Private room,110,0,1.47,110
26573,Rayan,3,Private room,43,1,1.64,44
26574,James,1,Entire home/apt,170,0,2.23,170
26575,Liz And Cesar,2,Private room,65,297,0.26,362
26576,Shereen,1,Private room,90,0,0.15,90
26577,Ken,1,Entire home/apt,159,344,0.05,503
26578,Ari And Irin,3,Entire home/apt,175,0,0.11,175
26579,Sam,2,Private room,60,16,3.34,76
26580,Kristina,2,Private room,35,0,0.05,35
26581,Carmela,2,Entire home/apt,148,4,4.33,152
26582,Alexis,1,Entire home/apt,110,0,0.05,110
26583,Chris,1,Private room,115,0,0.83,115
26584,Kathy,1,Private room,85,344,1.43,429
26586,Margarette,1,Entire home/apt,120,0,0.33,120
26587,Eliasz,4,Private room,300,0,0.47,300
26588,Lauren,2,Entire home/apt,200,23,0.32,223
26589,Jessica,2,Private room,319,365,2.48,684
26590,Nathan,1,Private room,100,0,0.24,100
26592,G,2,Private room,80,0,0.24,80
26593,Adam,2,Entire home/apt,120,193,4.64,313
26594,Ayhan,1,Entire home/apt,239,185,3.76,424
26595,Thomas,1,Private room,71,129,5.22,200
26596,AJ And Freddy,1,Entire home/apt,120,0,0.36,120
26598,Sneha,2,Private room,95,0,0.19,95
26599,Bifan,3,Private room,100,0,0.05,100
26600,Kelly,3,Private room,65,89,0.98,154
26602,Franklin,1,Entire home/apt,100,1,0.28,101
26603,Evyiatar,3,Private room,47,303,0.38,350
26604,Mike,1,Entire home/apt,126,3,0.19,129
26605,Dominique,4,Private room,25,119,1.82,144
26606,Stephanie,1,Private room,114,67,6.23,181
26607,Jerry,1,Entire home/apt,185,0,1.66,185
26608,Victoria,1,Entire home/apt,165,0,1.03,165
26609,Ellen,2,Private room,60,0,0.05,60
26610,Thomas,1,Entire home/apt,225,3,3.66,228
26611,Dasha,1,Entire home/apt,150,0,0.05,150
26612,Yang,3,Private room,55,353,0.05,408
26613,Kenny,1,Private room,125,0,1.83,125
26614,Zakhar,2,Private room,59,109,0.33,168
26615,Emily,3,Private room,95,0,0.61,95
26616,Anthony,2,Private room,75,78,0.9,153
26617,Diane,1,Private room,1500,219,0.14,1719
26618,Judie And Steven,1,Private room,85,309,2.49,394
26619,Edward,2,Private room,75,0,0.05,75
26620,Amber,2,Private room,130,0,0.69,130
26621,Judie And Steven,1,Private room,70,292,1.36,362
26622,Seamus,1,Entire home/apt,128,0,0.6,128
26623,Francisco,1,Entire home/apt,130,116,4.41,246
26624,Danielle,1,Entire home/apt,120,0,0.26,120
26627,Jonathan,1,Entire home/apt,181,0,0.47,181
26628,Stephany,2,Private room,48,179,1.83,227
26630,Kelly,3,Private room,60,76,1.14,136
26631,Kelly,3,Private room,58,88,0.97,146
26632,Lexy,1,Private room,99,101,3.64,200
26633,Pao,3,Entire home/apt,150,200,4.59,350
26634,Scott,2,Entire home/apt,225,0,0.87,225
26635,Lo,2,Private room,40,364,0.33,404
26636,Anna,2,Entire home/apt,130,165,2.23,295
26637,Clara,3,Private room,35,318,4.3,353
26639,Bel And Camila,1,Private room,150,305,2.07,455
26640,Kara,1,Entire home/apt,169,282,0.05,451
26641,Nick,2,Private room,37,67,1.44,104
26642,Rlg,1,Entire home/apt,125,342,0.34,467
26643,Chelsea,2,Private room,62,0,1.34,62
26644,Ely,2,Entire home/apt,120,8,0.92,128
26645,Elijah,2,Private room,55,0,0.29,55
26647,Miki,2,Private room,45,0,0.09,45
26648,Lara,2,Private room,120,357,1.03,477
26649,Stephanie,2,Private room,55,0,0.11,55
26650,Rafael,1,Entire home/apt,140,0,0.11,140
26651,Joshua,2,Private room,100,0,0.11,100
26652,Victoria,1,Private room,80,28,1.1,108
26653,Lu&Ben,2,Entire home/apt,70,0,0.11,70
26654,Joy,2,Entire home/apt,189,17,3.66,206
26655,Wilson,3,Private room,200,35,0.64,235
26656,Lo,2,Private room,45,333,0.28,378
26658,Stanley,1,Entire home/apt,150,364,0.28,514
26659,Stanley,1,Entire home/apt,150,364,0.05,514
26660,Carol,2,Private room,65,365,0.19,430
26661,Stanley,1,Entire home/apt,150,364,0.21,514
26663,Thomas,2,Private room,59,0,0.24,59
26664,Stephanie,3,Private room,43,301,0.42,344
26666,Feng,3,Private room,95,0,1.12,95
26667,Magali,2,Entire home/apt,190,310,0.14,500
26668,Corporate Housing,1,Entire home/apt,125,347,0.26,472
26670,Marina,1,Private room,135,32,2.35,167
26671,Chris,2,Entire home/apt,225,72,0.61,297
26672,Natali,2,Entire home/apt,380,173,5.99,553
26674,Nicole,1,Entire home/apt,129,0,0.1,129
26675,Liron,2,Entire home/apt,133,87,4.93,220
26676,Braden,2,Private room,44,0,0.14,44
26677,John,1,Entire home/apt,142,0,1.04,142
26678,Phillip,1,Private room,55,11,4.69,66
26679,Golan,3,Entire home/apt,185,15,0.42,200
26680,Monica,3,Private room,110,0,0.24,110
26682,Stanley,1,Entire home/apt,222,364,0.21,586
26683,Stanley,1,Entire home/apt,175,344,0.37,519
26685,Mason,2,Entire home/apt,115,0,0.23,115
26686,Ron,2,Private room,180,0,0.05,180
26687,Tessa,1,Private room,80,0,0.09,80
26688,Katrina,1,Entire home/apt,125,323,0.15,448
26689,Paula,2,Entire home/apt,125,0,0.53,125
26690,Greg,2,Entire home/apt,475,123,1.72,598
26691,Sunny,2,Private room,750,89,0.22,839
26692,Nayef,3,Entire home/apt,86,0,0.15,86
26693,Emily,2,Private room,75,35,2.7,110
26694,Rated,1,Entire home/apt,153,365,0.05,518
26695,Charles,1,Entire home/apt,165,2,0.53,167
26696,Maria,3,Private room,55,75,2.58,130
26697,Nicole,3,Private room,50,155,0.38,205
26698,Devon,1,Private room,45,261,0.1,306
26699,Lashaya,3,Private room,35,0,0.05,35
26700,Carupano,3,Private room,90,157,1.34,247
26701,Kevin,1,Private room,149,274,0.89,423
26702,Emmanuel,1,Entire home/apt,175,101,3.31,276
26703,Yoni,3,Entire home/apt,90,0,0.26,90
26704,Dennis,1,Entire home/apt,108,213,0.23,321
26705,Sharif,2,Private room,78,0,1.46,78
26707,Kyle,2,Entire home/apt,250,0,0.05,250
26708,Vincent,1,Entire home/apt,95,0,0.24,95
26709,Leonardo,1,Private room,85,0,0.05,85
26710,Sarah,2,Private room,100,37,2.74,137
26712,Murphy,1,Entire home/apt,160,0,0.59,160
26713,Carmen,2,Private room,68,0,1.84,68
26714,Ladi,1,Private room,85,195,1.6,280
26715,Dasha,2,Entire home/apt,198,298,0.44,496
26716,Daniel,2,Entire home/apt,290,0,0.33,290
26717,Victoria,3,Private room,48,0,0.11,48
26719,Candy,2,Private room,75,35,1.62,110
26720,Sabrina,1,Entire home/apt,250,0,0.05,250
26721,Irini,1,Private room,50,188,0.39,238
26723,Bryan,1,Private room,155,304,2.72,459
26724,Luke A,1,Entire home/apt,220,0,0.33,220
26725,Hadas,1,Entire home/apt,250,89,1.04,339
26726,Dina,1,Entire home/apt,378,52,3.65,430
26728,Ashley,2,Private room,35,0,0.05,35
26729,Wilson,3,Private room,45,57,1.22,102
26730,Dennis,1,Entire home/apt,96,32,0.53,128
26731,Natalie,2,Private room,78,73,1.55,151
26732,Joseph,1,Private room,110,93,1.11,203
26733,Asia,2,Private room,37,0,0.05,37
26735,Chadanut,2,Private room,45,42,2.47,87
26736,Yi-Hsuan,1,Private room,60,0,0.47,60
26737,Stephen,1,Entire home/apt,125,0,0.05,125
26739,Sarah-B,2,Entire home/apt,5000,0,0.38,5000
26740,Parker,2,Entire home/apt,115,0,0.1,115
26742,Lina,2,Private room,179,0,0.3,179
26743,Tina,1,Entire home/apt,99,18,3.71,117
26744,Joseph,2,Private room,65,364,0.16,429
26746,Charles,2,Private room,75,161,0.16,236
26747,Vanessa,1,Entire home/apt,125,2,2.3,127
26748,Nals,1,Entire home/apt,295,365,0.33,660
26749,Monica,1,Entire home/apt,200,0,0.16,200
26750,Alexander,1,Private room,200,0,0.43,200
26751,Lana,2,Private room,60,0,0.05,60
26752,Hillside Hotel,3,Private room,135,365,0.05,500
26753,Hillside Hotel,3,Private room,135,365,0.09,500
26754,Stephanie,1,Private room,100,45,6.25,145
26755,Hugo,2,Entire home/apt,250,174,3.51,424
26756,Jessica,3,Private room,125,128,1.49,253
26757,Marc,2,Private room,38,0,0.73,38
26758,Greg,2,Entire home/apt,220,77,3.8,297
26759,Rebekah,1,Private room,100,0,0.33,100
26760,Max And Heather,2,Entire home/apt,150,0,0.1,150
26761,Ina,2,Private room,58,0,2.27,58
26762,Guillermo,1,Private room,160,162,1.55,322
26763,Melvin & Maya,2,Entire home/apt,130,0,0.39,130
26764,Lucy,1,Entire home/apt,200,0,0.05,200
26765,Summer,4,Private room,35,357,0.38,392
26766,Bobi,1,Private room,45,347,3.97,392
26767,Dan,2,Entire home/apt,235,121,3.64,356
26768,Lizzy,1,Private room,150,197,6.51,347
26770,Greg,2,Private room,40,8,1.25,48
26771,Bryan,1,Entire home/apt,525,292,1.13,817
26772,Mirko,3,Entire home/apt,85,0,0.05,85
26773,Eric,1,Entire home/apt,253,0,0.05,253
26774,Tim,1,Entire home/apt,275,0,0.05,275
26775,Taylor,1,Private room,110,0,0.1,110
26776,Tina,2,Entire home/apt,73,32,0.06,105
26777,Paul,1,Entire home/apt,573,0,0.11,573
26779,Andrew,1,Entire home/apt,170,33,2.44,203
26780,Damien,3,Entire home/apt,135,325,1.78,460
26781,Sudha,1,Entire home/apt,1100,333,1.94,1433
26782,Murah,1,Entire home/apt,120,341,1.04,461
26783,David,2,Entire home/apt,195,0,0.22,195
26784,Lana,5,Entire home/apt,115,71,1.41,186
26785,Joseph,2,Private room,70,0,0.48,70
26786,Sudha,1,Entire home/apt,766,352,0.66,1118
26787,Darien,1,Entire home/apt,200,0,1.8,200
26788,Francois,2,Entire home/apt,150,0,0.11,150
26789,Candice,1,Private room,125,54,1.8,179
26790,Elizabeth,3,Entire home/apt,75,0,0.45,75
26791,RaShaan,2,Entire home/apt,95,0,4.43,95
26792,Leslie,1,Private room,140,148,3.73,288
26793,Dennis,1,Entire home/apt,83,86,0.46,169
26794,Leslie,1,Private room,135,103,4.03,238
26795,Leslie,1,Private room,231,165,0.65,396
26796,Deona,2,Private room,95,89,0.59,184
26797,Carmela,2,Entire home/apt,84,6,5.92,90
26798,Cleonides,3,Entire home/apt,89,143,1.28,232
26799,Luis,2,Private room,55,146,2.15,201
26800,Thelma,1,Entire home/apt,155,7,1.04,162
26801,Anne-Laure And Enrique,4,Private room,77,5,1.81,82
26802,Ariadna,2,Private room,52,9,3.25,61
26803,Maritza,1,Entire home/apt,95,0,0.15,95
26804,Amar,1,Entire home/apt,250,43,0.3,293
26805,Kate,2,Shared room,45,0,0.09,45
26806,Shannon,1,Private room,75,182,3.25,257
26807,John,2,Entire home/apt,100,0,0.14,100
26808,Andy,3,Entire home/apt,100,154,4.73,254
26809,Fred,2,Entire home/apt,130,46,0.52,176
26810,Barbara,1,Entire home/apt,840,24,0.31,864
26811,Lena,1,Private room,250,365,0.09,615
26812,Veronica,1,Entire home/apt,250,0,0.75,250
26813,Charles,1,Entire home/apt,300,0,0.05,300
26814,Kennedy,1,Entire home/apt,100,2,1.57,102
26816,Andrew & Mary,2,Entire home/apt,120,90,2.59,210
26817,Saiful,3,Private room,55,359,1.32,414
26818,Dennis,1,Private room,160,236,0.52,396
26819,Rhyan,2,Private room,85,0,0.77,85
26820,Magali,2,Entire home/apt,100,24,0.1,124
26821,Esther,2,Entire home/apt,85,151,0.15,236
26822,Ruth,3,Private room,40,314,1.4,354
26823,Jacob,2,Entire home/apt,150,44,3.75,194
26824,Roxanne,1,Entire home/apt,230,0,0.1,230
26825,Syed,2,Private room,40,71,0.43,111
26826,Joe,1,Entire home/apt,130,7,2.06,137
26827,Iris,3,Private room,50,0,0.71,50
26828,Hannah,2,Entire home/apt,75,0,0.05,75
26829,Brooklyn P,3,Private room,43,119,3.63,162
26830,Jeannie,3,Private room,40,363,0.12,403
26831,Zain,3,Entire home/apt,255,285,3.09,540
26832,Darya,2,Private room,38,199,0.45,237
26833,Danielle,1,Private room,105,0,0.05,105
26834,Kenzi,2,Private room,130,64,1.08,194
26835,Amri,2,Entire home/apt,350,284,1.45,634
26836,Roland,3,Private room,35,52,3.2,87
26837,Clara,1,Private room,120,17,1.68,137
26838,Roland,3,Private room,68,13,1.23,81
26839,Paige,1,Private room,55,0,0.05,55
26840,Alain,2,Private room,49,0,0.76,49
26841,Sergii,2,Shared room,0,333,0.11,333
26842,Jack,2,Private room,55,30,6.62,85
26843,Imani,2,Entire home/apt,298,265,1.17,563
26844,Sergey,2,Shared room,29,324,0.1,353
26846,Sarita,3,Private room,40,0,0.09,40
26847,Michael,1,Private room,150,76,1.58,226
26848,Kelly,3,Entire home/apt,298,187,3.44,485
26851,Ele,1,Entire home/apt,250,0,0.06,250
26852,Peter,2,Private room,43,312,0.06,355
26853,Abby,2,Entire home/apt,265,144,0.77,409
26854,Jenn,2,Private room,60,126,0.48,186
26855,Lucas,2,Entire home/apt,400,0,0.1,400
26857,Alicia,2,Entire home/apt,235,0,0.25,235
26858,KaLema,2,Private room,52,89,0.15,141
26859,Rissala,1,Entire home/apt,250,3,0.21,253
26860,Levi,3,Entire home/apt,130,0,0.1,130
26861,Harry,1,Private room,150,60,7.19,210
26862,Joseph,3,Private room,50,108,2.37,158
26863,Britney,2,Entire home/apt,160,191,0.14,351
26864,Paul,2,Entire home/apt,300,347,0.26,647
26865,Sarah,1,Private room,70,80,1.2,150
26866,Sergii,2,Shared room,0,139,0.26,139
26869,Elgin,1,Entire home/apt,200,200,5.17,400
26870,Justin,2,Private room,80,0,0.05,80
26872,Jermaine,2,Private room,80,364,0.05,444
26873,Alonzo,3,Entire home/apt,65,65,3.64,130
26874,Yosef,2,Private room,60,0,0.1,60
26875,Adrien,2,Entire home/apt,400,329,2.77,729
26876,Clinton,1,Private room,100,25,3.06,125
26877,Kai Chieh,1,Shared room,68,0,0.24,68
26878,Isaac,2,Entire home/apt,120,276,2.4,396
26879,Mk,1,Private room,80,137,5.42,217
26880,Lara,1,Private room,100,0,0.05,100
26881,Jermaine,2,Private room,80,364,0.05,444
26882,Marcia,2,Entire home/apt,92,35,1.01,127
26884,Vickie,2,Entire home/apt,185,363,1.03,548
26885,Ismael,2,Entire home/apt,200,268,2.16,468
26886,Ben,1,Entire home/apt,300,99,1.57,399
26887,Gal,1,Entire home/apt,99,251,0.57,350
26888,Benny,3,Private room,50,178,4.31,228
26890,Gal,1,Entire home/apt,115,341,0.1,456
26893,Hillside Hotel,3,Private room,135,365,0.05,500
26900,Hillside Hotel,3,Private room,165,355,0.09,520
26901,Hillside Hotel,3,Private room,135,319,0.15,454
26903,Virginia,3,Private room,50,145,3.66,195
26904,Maxim,2,Private room,40,342,0.23,382
26905,Gregory,1,Entire home/apt,540,215,4.43,755
26906,Nastya,1,Private room,85,0,3.68,85
26907,Kendra,2,Entire home/apt,130,91,2.01,221
26908,Bryan,1,Entire home/apt,150,0,0.1,150
26909,Atanas,1,Private room,90,0,0.17,90
26910,Steven,1,Private room,121,0,2.42,121
26911,Mrs,4,Private room,29,322,0.43,351
26912,Taylor,3,Shared room,40,90,1.04,130
26914,Lorenzo,3,Entire home/apt,115,0,1.0,115
26915,Katherine,1,Entire home/apt,250,0,0.05,250
26916,Anthony,4,Entire home/apt,149,146,1.9,295
26917,Chris,2,Private room,50,0,0.5,50
26918,Whitney,2,Entire home/apt,85,99,0.08,184
26920,Thomas,2,Entire home/apt,100,0,0.05,100
26921,Chris,2,Entire home/apt,200,36,1.52,236
26922,Andrew,1,Entire home/apt,200,101,1.89,301
26924,Mayra,3,Entire home/apt,70,113,3.18,183
26925,Benny,3,Private room,55,171,3.52,226
26926,Allison,3,Entire home/apt,250,204,1.39,454
26927,Stan,1,Private room,75,0,0.05,75
26928,Christina,3,Private room,40,66,3.0,106
26929,Carina,1,Private room,50,0,0.2,50
26930,Veronica,3,Shared room,37,361,0.33,398
26931,Johnny,2,Private room,90,310,0.24,400
26932,Esther,2,Entire home/apt,150,59,2.6,209
26933,Julia And Marie,2,Entire home/apt,140,214,0.55,354
26934,Taylor,3,Shared room,48,90,1.02,138
26935,Sapir,3,Entire home/apt,80,0,0.05,80
26936,Christopher,1,Private room,125,63,0.38,188
26937,Mark,1,Entire home/apt,188,364,0.44,552
26938,Monica,3,Private room,130,34,0.06,164
26939,Robert,1,Entire home/apt,100,0,1.05,100
26941,Andrew,1,Entire home/apt,249,137,0.51,386
26942,Daniel,2,Entire home/apt,345,243,3.64,588
26943,Nick,1,Private room,130,145,2.04,275
26944,Grace,1,Private room,90,9,1.92,99
26945,Brianne,1,Private room,160,88,3.77,248
26947,Stephen,2,Entire home/apt,125,0,0.05,125
26949,Trevor,2,Entire home/apt,200,0,0.1,200
26950,Yi,3,Private room,200,365,0.41,565
26951,Henry,2,Private room,90,108,4.29,198
26952,Ena,1,Entire home/apt,148,0,0.52,148
26953,Kalina,2,Entire home/apt,99,137,3.97,236
26954,Daniel,2,Entire home/apt,148,272,3.63,420
26956,Daniel,2,Entire home/apt,585,229,2.01,814
26957,Kuei Mei,3,Entire home/apt,120,287,7.72,407
26958,Chérie,2,Private room,36,0,0.43,36
26959,Andrea,3,Private room,100,165,3.47,265
26962,Jae,2,Private room,200,42,1.18,242
26964,Jae,2,Private room,90,0,0.15,90
26965,Wilson,3,Private room,80,122,1.76,202
26966,Leslie,3,Private room,83,42,0.77,125
26967,Gabriella,2,Entire home/apt,71,0,0.67,71
26968,Brian,1,Entire home/apt,140,0,0.14,140
26969,Autumn,2,Entire home/apt,180,0,0.05,180
26971,Ashley,2,Private room,65,53,1.18,118
26972,Chris,2,Entire home/apt,69,5,0.37,74
26973,David,1,Entire home/apt,170,6,0.84,176
26974,Alex,2,Private room,70,0,0.44,70
26975,Lara & David,2,Private room,150,0,0.24,150
26976,Evens And Charlene,3,Entire home/apt,67,134,4.46,201
26977,Anabell,3,Entire home/apt,96,307,12.99,403
26978,Jose,1,Private room,57,242,3.73,299
26980,Mrs,4,Private room,29,360,0.25,389
26981,Gil,1,Entire home/apt,350,166,1.54,516
26982,Rosemarie,2,Entire home/apt,120,22,1.82,142
26983,Arlene,2,Private room,100,358,1.14,458
26984,Abena,2,Entire home/apt,190,24,2.86,214
26985,Kay,2,Entire home/apt,200,3,2.29,203
26986,Arlene,2,Private room,70,358,1.53,428
26987,Migdalia,4,Private room,49,184,1.32,233
26988,Arlene,2,Private room,70,60,2.8,130
26989,Ben,2,Private room,70,49,0.36,119
26990,Charles,1,Entire home/apt,237,89,2.18,326
26991,Chase,2,Private room,129,84,3.32,213
26992,Dmitry,1,Private room,72,0,0.05,72
26994,Catherine,2,Entire home/apt,800,246,0.11,1046
26995,Chris,2,Entire home/apt,130,5,0.22,135
26997,Stanley,1,Entire home/apt,175,365,0.11,540
26998,Ping,5,Entire home/apt,58,0,4.18,58
26999,Diane,1,Entire home/apt,115,0,1.81,115
27001,Ekaterina,1,Private room,577,293,0.1,870
27002,Natalia,1,Private room,104,0,0.05,104
27003,Melanie,1,Shared room,49,0,3.64,49
27004,Luequita,3,Private room,35,38,0.61,73
27005,Jonathan,2,Private room,85,0,0.15,85
27006,Bianca,1,Private room,91,181,1.59,272
27007,Jenifer,2,Private room,80,0,5.18,80
27008,Bianca,1,Entire home/apt,200,181,1.97,381
27009,Jenifer,2,Private room,80,0,4.75,80
27010,E,2,Entire home/apt,175,0,0.49,175
27011,Taylor,3,Shared room,45,88,0.77,133
27012,Daniel,1,Private room,96,0,0.19,96
27013,Kimberley,2,Entire home/apt,180,339,1.47,519
27014,Rachel,2,Entire home/apt,100,0,0.27,100
27015,Josh,2,Entire home/apt,129,144,3.88,273
27016,Diana,3,Private room,60,19,3.29,79
27018,Natalie,1,Private room,95,27,6.45,122
27020,Joseph,3,Private room,48,255,2.4,303
27021,Danielle,3,Entire home/apt,250,180,0.05,430
27022,Brianna,1,Private room,300,0,0.05,300
27023,Adrián,2,Private room,44,0,0.14,44
27024,J.R.,2,Private room,75,0,1.32,75
27025,Bethany,2,Entire home/apt,88,0,0.05,88
27026,Derek,2,Entire home/apt,125,99,3.38,224
27028,Selina,3,Entire home/apt,250,364,0.19,614
27029,Austin,2,Private room,44,7,4.66,51
27030,Jacob,1,Private room,174,244,5.37,418
27031,Igor,1,Entire home/apt,199,17,0.05,216
27032,Christine,2,Private room,128,144,0.05,272
27033,Corey,1,Private room,30,0,4.32,30
27034,Clare,2,Entire home/apt,150,0,0.15,150
27035,Bidya,3,Private room,65,7,8.87,72
27036,Alison,1,Private room,50,0,0.05,50
27037,Mary,4,Entire home/apt,175,89,3.34,264
27038,Tara,1,Private room,86,0,0.25,86
27039,Morgan,1,Private room,325,0,0.26,325
27040,Geraldine,1,Entire home/apt,95,0,2.96,95
27041,Dana  (& Justin),1,Private room,50,0,0.14,50
27042,Pascal,1,Entire home/apt,250,0,0.37,250
27043,Elise And Dave,2,Entire home/apt,165,73,0.25,238
27044,Marc,1,Entire home/apt,150,0,0.05,150
27045,Livia,2,Entire home/apt,90,158,0.92,248
27046,Yamile,1,Private room,156,68,4.11,224
27047,Shannon,3,Entire home/apt,110,0,0.1,110
27048,Lukasz,2,Private room,70,0,0.41,70
27049,Hupeto,2,Entire home/apt,154,341,1.41,495
27050,M,1,Private room,85,0,3.68,85
27051,Max,2,Entire home/apt,299,0,0.63,299
27052,Mercedes,4,Private room,40,365,0.46,405
27053,M,1,Private room,85,0,3.77,85
27054,Doug,1,Entire home/apt,127,0,0.15,127
27055,Jorge,4,Private room,80,0,0.05,80
27056,Jessica,1,Entire home/apt,195,0,0.11,195
27057,Corey,1,Shared room,25,7,2.99,32
27058,Richard,3,Private room,35,0,0.05,35
27059,Lauren,1,Entire home/apt,250,0,0.1,250
27060,Marta,2,Entire home/apt,120,0,0.1,120
27061,Amir,1,Entire home/apt,139,14,2.18,153
27062,Grace,2,Private room,100,0,0.05,100
27064,Zoey,1,Private room,150,365,0.1,515
27065,Maria,1,Private room,82,309,4.69,391
27066,Tania,4,Entire home/apt,125,6,1.59,131
27067,Santiago,1,Entire home/apt,350,0,0.05,350
27068,Adam,1,Private room,40,65,5.21,105
27069,Jaye,2,Private room,80,207,2.07,287
27070,Andy,2,Private room,40,0,0.05,40
27071,Andrea,3,Entire home/apt,85,0,0.68,85
27072,Valdo,1,Entire home/apt,185,172,4.08,357
27073,Emma,1,Entire home/apt,215,234,6.12,449
27074,Chelsea,3,Private room,45,0,1.67,45
27075,Deanna,2,Entire home/apt,150,135,1.41,285
27076,James,3,Private room,65,319,5.46,384
27077,Sasha,1,Entire home/apt,190,41,3.34,231
27078,Jill,1,Private room,60,55,0.16,115
27079,William,1,Entire home/apt,175,2,0.77,177
27080,Kristopher,2,Shared room,60,0,0.64,60
27081,Kelly,1,Entire home/apt,250,0,0.05,250
27082,Emily,1,Entire home/apt,288,300,3.42,588
27083,Joanna & Brian,2,Entire home/apt,100,65,4.67,165
27084,Samantha,1,Private room,95,0,0.1,95
27085,Johny,2,Private room,50,0,0.06,50
27086,Ian,1,Private room,200,0,0.46,200
27087,Tonie,2,Entire home/apt,110,130,1.91,240
27088,Matt,1,Shared room,60,77,4.35,137
27089,Chemme,1,Private room,143,365,0.89,508
27090,Alenka,2,Entire home/apt,97,0,0.1,97
27092,Sumitra,1,Entire home/apt,150,69,3.36,219
27093,Arturo,1,Entire home/apt,589,4,0.49,593
27094,Sean,1,Entire home/apt,138,188,0.09,326
27095,Anabel,1,Entire home/apt,200,0,0.15,200
27096,Giovanni,2,Entire home/apt,50,70,2.23,120
27097,Cat,2,Private room,65,70,1.99,135
27098,Matt,1,Entire home/apt,245,135,4.44,380
27099,Nat,2,Entire home/apt,100,0,0.35,100
27100,Sarah,2,Private room,60,13,2.3,73
27101,Ali,2,Entire home/apt,89,11,0.51,100
27102,Angie,1,Private room,51,0,0.31,51
27103,Johny,2,Entire home/apt,150,0,0.63,150
27104,Shem,2,Entire home/apt,110,0,1.0,110
27105,Emilio,1,Entire home/apt,230,0,0.05,230
27106,Alex,1,Private room,119,159,2.5,278
27107,Johny,2,Private room,44,0,0.05,44
27108,Rebecca,2,Private room,80,12,1.74,92
27109,Anthony,1,Entire home/apt,233,154,0.72,387
27110,Jenny,1,Entire home/apt,150,0,0.49,150
27112,Shea,2,Private room,60,0,0.1,60
27114,Jennifer,2,Private room,70,0,0.15,70
27115,Anthony,1,Private room,75,62,0.82,137
27116,Rachael,2,Entire home/apt,109,1,1.17,110
27117,Sally,2,Private room,65,66,3.59,131
27118,Elena,1,Entire home/apt,210,88,0.11,298
27119,Gina,1,Private room,145,0,1.27,145
27120,Austin,2,Private room,40,8,4.89,48
27121,Harold,1,Entire home/apt,180,41,0.16,221
27122,Mili,3,Private room,40,0,3.68,40
27124,Joseph,3,Private room,40,229,5.8,269
27125,Inyoung,1,Entire home/apt,128,0,0.3,128
27127,Kimberly,2,Entire home/apt,85,6,0.81,91
27128,Gregory,1,Entire home/apt,173,92,3.44,265
27129,Olga,2,Entire home/apt,150,41,0.11,191
27130,Rushna,2,Entire home/apt,200,0,0.24,200
27131,Donovan,3,Entire home/apt,98,356,3.45,454
27132,Yoshi,2,Private room,69,86,1.73,155
27133,Joseph,2,Entire home/apt,142,0,0.2,142
27134,Marie,1,Entire home/apt,180,0,0.05,180
27135,Laura,2,Entire home/apt,150,13,2.18,163
27136,Danielle,1,Private room,100,40,4.08,140
27137,Nubia,2,Entire home/apt,125,0,0.64,125
27138,Liam,2,Entire home/apt,175,0,0.05,175
27139,Hiro,2,Private room,66,0,0.15,66
27140,Muslum,1,Private room,150,88,0.44,238
27141,Val,1,Private room,79,26,4.14,105
27142,Hiro,2,Private room,66,0,0.05,66
27143,Cristiano,2,Private room,85,58,4.35,143
27144,Mike,1,Entire home/apt,125,25,0.79,150
27146,Kelly,2,Entire home/apt,105,0,0.36,105
27148,Natalia,1,Shared room,56,0,0.05,56
27149,Aly,1,Private room,129,365,4.0,494
27150,Jolie And Max,1,Entire home/apt,180,20,0.42,200
27152,Majer,1,Private room,130,0,0.44,130
27153,Kelly,2,Private room,35,29,1.89,64
27154,Kelly,2,Private room,25,3,1.8,28
27155,Laura,1,Entire home/apt,150,0,0.05,150
27156,Christina,2,Entire home/apt,120,0,0.83,120
27157,Sharif,2,Private room,60,0,0.34,60
27158,John And Colleen,3,Private room,90,84,0.14,174
27159,Meg,2,Entire home/apt,109,0,0.36,109
27160,Elliot,1,Private room,70,3,5.78,73
27161,Lizzie,1,Entire home/apt,145,7,1.33,152
27163,Kai Chieh,1,Entire home/apt,225,0,0.05,225
27164,Andrew,1,Entire home/apt,200,0,0.25,200
27165,Leonard,3,Private room,40,252,0.49,292
27166,Majar,2,Private room,75,365,1.2,440
27167,Maria,1,Private room,85,292,5.5,377
27168,Emily,2,Entire home/apt,145,0,0.05,145
27169,Fan,1,Entire home/apt,150,2,1.14,152
27170,Sophia,2,Entire home/apt,100,0,0.15,100
27171,Gina,3,Entire home/apt,100,0,0.19,100
27172,Kevin,2,Private room,42,0,1.69,42
27173,Aspen,1,Entire home/apt,299,0,0.05,299
27174,Zach,2,Private room,50,12,3.58,62
27175,Ken,1,Entire home/apt,200,364,0.07,564
27176,Doron,1,Entire home/apt,105,195,0.28,300
27177,Damary,2,Private room,60,141,0.24,201
27178,Pascale,1,Entire home/apt,175,1,1.61,176
27179,Sharon,4,Entire home/apt,114,283,3.88,397
27181,Oscar,1,Entire home/apt,160,327,2.44,487
27182,Travis,2,Private room,184,0,0.05,184
27183,Jowelle,1,Shared room,299,188,1.8,487
27184,Annie,1,Private room,103,0,2.0,103
27185,Oren,1,Entire home/apt,225,0,0.37,225
27187,Kyle,1,Entire home/apt,249,0,0.21,249
27188,Esther,2,Entire home/apt,75,151,1.42,226
27189,Graham,1,Entire home/apt,175,0,0.05,175
27190,Sofia,2,Private room,58,88,0.73,146
27191,David,1,Entire home/apt,250,0,0.43,250
27192,Shang,1,Entire home/apt,110,0,0.19,110
27195,Larry,2,Entire home/apt,65,305,3.19,370
27197,David,2,Private room,80,0,1.66,80
27198,Gaby,2,Private room,25,34,0.19,59
27199,Mike,2,Entire home/apt,150,0,1.45,150
27200,Aniko,1,Entire home/apt,170,0,1.66,170
27201,Kay,3,Entire home/apt,70,225,1.47,295
27202,Tia,2,Private room,65,37,0.39,102
27203,Thelma,5,Private room,55,355,0.2,410
27204,Joshua,1,Entire home/apt,550,295,4.22,845
27206,Helena,2,Entire home/apt,90,253,1.83,343
27207,Caroline,3,Entire home/apt,110,170,2.24,280
27209,Mario,1,Entire home/apt,95,41,6.9,136
27210,Jaqui And Mark,2,Private room,35,52,2.42,87
27211,Hongyan,3,Private room,70,93,1.67,163
27212,Sandra,1,Private room,150,24,2.67,174
27213,Nicole,2,Entire home/apt,80,12,0.88,92
27214,Ryan,1,Entire home/apt,160,0,0.59,160
27216,Erin,2,Entire home/apt,196,96,2.0,292
27217,Sander,2,Private room,62,0,0.39,62
27218,Joao,2,Private room,36,326,3.43,362
27219,Alejandra,1,Private room,143,0,0.15,143
27220,Rodrigue,1,Entire home/apt,120,0,1.14,120
27221,V,2,Entire home/apt,129,12,0.38,141
27222,Andrea,2,Private room,32,0,0.15,32
27223,Rebecca And Jolie,3,Private room,48,231,1.91,279
27224,Brian,1,Entire home/apt,150,26,2.95,176
27225,Claudia,1,Entire home/apt,250,0,0.26,250
27226,Leon,1,Private room,70,0,0.05,70
27227,Camille,2,Private room,100,89,0.97,189
27228,Dean,3,Private room,40,0,0.29,40
27229,Mary,1,Entire home/apt,110,15,1.73,125
27230,Lyjah,1,Entire home/apt,200,158,2.06,358
27231,George,1,Entire home/apt,250,253,0.41,503
27232,Kayla,2,Private room,60,0,0.1,60
27233,Jessamine,2,Private room,60,0,0.1,60
27234,Gary,5,Entire home/apt,125,319,5.41,444
27235,Nick,3,Entire home/apt,85,46,6.03,131
27236,Tom,2,Entire home/apt,140,0,0.1,140
27237,Melissa,1,Private room,67,160,1.66,227
27240,Ismael,2,Private room,75,307,0.3,382
27241,Cat,3,Entire home/apt,140,230,2.82,370
27242,Eren,2,Entire home/apt,165,10,1.63,175
27243,Chris,1,Private room,100,0,0.15,100
27244,Sonia,2,Entire home/apt,100,332,0.15,432
27245,Leo,3,Private room,55,285,3.21,340
27246,Sonia,2,Entire home/apt,100,323,0.2,423
27247,Chandley,3,Entire home/apt,108,0,0.56,108
27248,Robert,2,Shared room,42,365,0.65,407
27250,Michelle,2,Entire home/apt,100,189,1.5,289
27251,Emily,2,Entire home/apt,95,34,3.08,129
27252,Sara,1,Entire home/apt,140,29,0.99,169
27253,Robert,2,Entire home/apt,110,0,0.24,110
27254,Kelly,3,Entire home/apt,300,221,3.27,521
27255,Niecia,2,Entire home/apt,70,64,4.41,134
27256,Lucy,3,Private room,85,171,0.74,256
27257,Alex,2,Entire home/apt,55,5,3.64,60
27258,Jeff & Kelly,1,Private room,949,8,0.36,957
27261,Yanna,3,Entire home/apt,125,83,2.9,208
27262,Janet,1,Private room,80,0,0.11,80
27263,Daisy,1,Entire home/apt,300,0,0.05,300
27264,Mitchell,1,Entire home/apt,99,0,0.61,99
27265,Alberto,3,Private room,71,360,3.19,431
27266,Gerard,2,Entire home/apt,95,4,2.04,99
27267,Anna,3,Entire home/apt,123,126,2.73,249
27268,Linda,2,Entire home/apt,80,248,3.52,328
27269,Karen,3,Entire home/apt,95,168,2.29,263
27270,Mike,4,Entire home/apt,110,0,0.97,110
27272,Angelo,2,Entire home/apt,100,0,0.05,100
27273,Jose,1,Private room,75,56,0.45,131
27274,Mendy,2,Private room,150,66,0.87,216
27276,Tamara,2,Private room,55,0,0.15,55
27277,Alex,2,Entire home/apt,120,0,0.05,120
27278,Leila,1,Entire home/apt,165,0,0.69,165
27279,Channing,2,Entire home/apt,150,0,0.53,150
27280,Carlos,3,Private room,58,257,2.56,315
27281,Patricio,2,Entire home/apt,150,160,0.73,310
27282,Bea And Eloise,2,Private room,60,6,1.09,66
27283,Adam,2,Entire home/apt,250,0,0.15,250
27284,Lorena,1,Entire home/apt,315,7,0.84,322
27286,Kelly,2,Entire home/apt,125,11,0.55,136
27287,Nalicia,3,Private room,80,26,19.75,106
27288,Amarjit S,5,Private room,32,315,1.33,347
27290,Gigi,1,Private room,80,39,1.64,119
27291,Boris,1,Private room,69,28,3.47,97
27292,Cynthia,1,Entire home/apt,200,1,0.36,201
27293,Jennifer,1,Entire home/apt,350,80,0.54,430
27294,Trevor,1,Private room,150,63,1.33,213
27295,J.,2,Private room,50,174,1.8,224
27296,Ron,2,Private room,48,0,0.15,48
27298,Sibel,1,Shared room,150,14,1.17,164
27299,Karlos,1,Entire home/apt,230,120,1.09,350
27300,Enrique,2,Private room,90,117,0.55,207
27301,Páidi,1,Private room,75,27,0.65,102
27302,Peter Alex,2,Private room,89,74,1.14,163
27303,Denisse,3,Entire home/apt,150,51,2.66,201
27305,Harymir,3,Private room,65,60,3.46,125
27306,Keren,2,Private room,94,0,0.46,94
27307,Su,2,Entire home/apt,95,0,0.05,95
27308,Alejandro,2,Entire home/apt,159,352,2.15,511
27309,Olivier,2,Entire home/apt,150,0,0.16,150
27310,Alejandro,2,Entire home/apt,159,357,2.49,516
27311,Ryan,1,Private room,80,0,0.05,80
27312,Richard,1,Entire home/apt,190,61,0.07,251
27314,Mia,2,Private room,59,0,1.67,59
27315,Richard,1,Entire home/apt,190,328,0.22,518
27316,Sarah,2,Entire home/apt,200,0,0.34,200
27317,Tom,3,Private room,69,349,6.29,418
27318,Lewis,2,Private room,70,0,0.05,70
27319,Thomas,1,Entire home/apt,170,0,0.41,170
27320,Corporate Housing,1,Entire home/apt,133,4,0.11,137
27321,Tian,2,Private room,60,0,1.46,60
27322,Giovanni,2,Private room,50,4,0.75,54
27323,Islandgetawayz,3,Entire home/apt,90,283,2.69,373
27324,Elise And Dave,2,Entire home/apt,235,219,2.22,454
27325,Salman,1,Shared room,59,0,0.34,59
27326,Brooke,2,Entire home/apt,100,1,0.66,101
27327,Lakisha,2,Private room,51,175,0.94,226
27328,IndraRisma,3,Private room,65,364,0.28,429
27329,Johnny,2,Private room,95,0,0.3,95
27330,Patricia,3,Private room,50,363,0.05,413
27331,Sandra,1,Shared room,68,0,0.45,68
27332,Alexa,2,Private room,35,0,0.16,35
27333,Starling,1,Entire home/apt,110,19,0.77,129
27334,Tessa,2,Private room,70,0,0.07,70
27335,Maka,2,Private room,65,310,0.66,375
27336,Allison,1,Entire home/apt,145,110,3.73,255
27337,Joe,1,Private room,125,95,3.02,220
27338,Heather,2,Entire home/apt,250,2,2.38,252
27339,Jamie,1,Entire home/apt,275,66,4.61,341
27340,Tajah,2,Private room,31,0,0.05,31
27341,Joe,1,Private room,125,74,2.36,199
27342,Nick,3,Private room,55,0,0.1,55
27345,Mary,2,Private room,75,66,1.88,141
27346,Asad,3,Private room,65,336,9.41,401
27347,Gillian,2,Entire home/apt,84,224,4.51,308
27348,Conor,1,Private room,90,0,1.0,90
27349,Efren,2,Entire home/apt,150,0,0.1,150
27350,Gene,1,Entire home/apt,185,65,3.98,250
27351,Carole,2,Private room,47,0,0.49,47
27352,Thomas,1,Private room,85,0,4.52,85
27353,Billy,3,Private room,60,0,0.12,60
27354,Yaacov,1,Entire home/apt,200,325,0.29,525
27355,Yaacov,1,Entire home/apt,160,324,0.19,484
27356,Giovanni,2,Private room,50,10,0.61,60
27357,Eliza,2,Entire home/apt,107,9,0.85,116
27359,Cemi,2,Entire home/apt,150,48,1.38,198
27360,Merrily,2,Private room,65,249,3.65,314
27361,Emilia,2,Private room,40,0,0.05,40
27362,Garland,2,Private room,52,0,0.1,52
27363,Leslie,2,Entire home/apt,358,182,2.89,540
27364,Maya,2,Entire home/apt,219,257,3.48,476
27365,Jonathan,1,Private room,130,8,1.63,138
27368,Adriana,3,Private room,48,39,2.19,87
27369,Asad,3,Private room,60,351,12.54,411
27370,Sonia,2,Entire home/apt,100,233,0.31,333
27372,Andrew,2,Private room,48,235,5.65,283
27374,Justin,2,Private room,125,2,0.05,127
27375,Eri,1,Entire home/apt,118,0,0.1,118
27376,Page,1,Entire home/apt,116,0,0.77,116
27377,Shareef,1,Private room,55,95,6.1,150
27378,Ada,3,Private room,55,78,1.73,133
27379,Ada,3,Private room,85,85,0.27,170
27381,Laura,1,Private room,80,97,0.52,177
27382,Aidana,3,Entire home/apt,40,44,1.47,84
27384,Kay,4,Entire home/apt,75,148,3.02,223
27385,Bérénice,2,Private room,69,0,0.25,69
27388,Samantha,2,Private room,70,29,3.01,99
27390,Victor,1,Private room,35,2,3.61,37
27391,Brandi,1,Private room,50,0,0.4,50
27392,Zoe,2,Entire home/apt,100,0,0.05,100
27393,Kasey,1,Entire home/apt,80,47,4.44,127
27395,J.R.,2,Private room,75,0,2.16,75
27396,Andrew,2,Private room,48,243,5.26,291
27397,Tony,3,Private room,40,343,6.64,383
27398,Muni,1,Entire home/apt,379,238,3.17,617
27399,Devi,4,Private room,50,283,0.79,333
27402,Amy,2,Private room,62,63,2.76,125
27404,Shannon,4,Private room,54,0,0.46,54
27405,Patricia,3,Private room,75,83,0.2,158
27406,Stephen,2,Entire home/apt,66,44,0.9,110
27407,Megan,2,Private room,44,0,0.05,44
27408,Kelly,2,Private room,65,52,1.8,117
27409,Andres,2,Private room,70,189,0.61,259
27411,Sydney,3,Entire home/apt,128,164,7.24,292
27412,Taelyr,2,Entire home/apt,128,0,0.4,128
27413,Jason,2,Private room,50,0,0.1,50
27414,Edgar,1,Entire home/apt,150,0,4.62,150
27415,Lea,2,Private room,75,0,0.05,75
27416,James,2,Private room,60,0,0.05,60
27417,Christian,1,Private room,80,0,0.05,80
27418,Ana,3,Private room,40,332,1.12,372
27419,Jake,1,Private room,60,0,0.89,60
27420,Chantal,3,Entire home/apt,125,0,0.11,125
27421,Kah,1,Private room,75,0,0.1,75
27422,Faye,5,Private room,30,176,0.7,206
27423,Gabriella,1,Entire home/apt,199,12,1.35,211
27424,Mariya,2,Private room,100,179,0.21,279
27425,Jordan,1,Entire home/apt,385,89,0.05,474
27426,Julia,1,Private room,47,0,0.23,47
27427,Daeun,2,Entire home/apt,70,0,0.15,70
27428,Melissa,2,Entire home/apt,265,309,1.49,574
27429,Matt,1,Shared room,60,88,3.65,148
27432,Matt,1,Shared room,60,81,3.31,141
27433,Max,1,Shared room,33,201,0.11,234
27434,Andrea,2,Entire home/apt,219,0,0.11,219
27435,Jessica,1,Private room,80,65,1.74,145
27436,Emily,3,Entire home/apt,150,0,0.16,150
27437,Tania,1,Private room,80,0,0.26,80
27438,Marisol,3,Private room,60,30,2.29,90
27441,Justin,2,Entire home/apt,125,0,0.16,125
27442,Art,2,Private room,72,0,0.05,72
27443,John,2,Private room,64,94,1.62,158
27444,Jon & Tina,2,Entire home/apt,149,1,0.86,150
27445,Linda,3,Entire home/apt,99,5,2.56,104
27446,John,1,Entire home/apt,225,133,3.5,358
27447,Matt Ryan,1,Entire home/apt,265,147,4.07,412
27448,Sam S.,1,Entire home/apt,200,140,2.7,340
27449,Al,1,Entire home/apt,80,0,0.05,80
27450,Ishai,1,Entire home/apt,111,8,0.28,119
27451,Lauren,2,Entire home/apt,150,0,0.25,150
27452,Keisy,1,Private room,55,13,5.34,68
27453,Merida,2,Private room,85,0,0.1,85
27454,Kym,1,Entire home/apt,400,91,1.1,491
27455,Patrick,2,Private room,60,8,0.36,68
27456,David,2,Entire home/apt,90,287,2.48,377
27458,Jake,2,Entire home/apt,220,0,0.76,220
27459,Fiona,2,Entire home/apt,120,240,5.03,360
27460,Ian,1,Private room,64,0,0.35,64
27461,James,2,Private room,40,0,0.05,40
27462,Efe,2,Private room,70,67,2.19,137
27463,Karma,1,Private room,169,69,1.54,238
27464,Jeanette,1,Private room,75,230,3.9,305
27465,Danilo,1,Entire home/apt,139,125,4.21,264
27467,Marco,2,Shared room,38,346,1.6,384
27469,Carlos,3,Private room,58,288,1.96,346
27470,Anna,2,Private room,43,0,1.97,43
27471,Wesley,2,Private room,60,0,0.36,60
27472,Malachi,2,Private room,32,90,1.62,122
27473,George,3,Private room,55,55,0.15,110
27474,Agnese,2,Private room,100,96,0.11,196
27475,Jeffrey,2,Entire home/apt,99,0,0.25,99
27476,Chika,1,Private room,50,0,0.15,50
27477,Jeannie,3,Private room,47,90,0.05,137
27479,Asad,3,Private room,55,352,10.28,407
27481,Gabriele,1,Entire home/apt,190,9,0.06,199
27482,Wael,2,Private room,50,0,0.16,50
27483,Rasmus,2,Private room,80,65,0.27,145
27484,Vika,1,Entire home/apt,150,0,1.13,150
27486,Yvette,2,Entire home/apt,500,0,0.05,500
27487,Rebecca,1,Entire home/apt,225,177,0.22,402
27488,Nicholas,2,Private room,41,0,0.05,41
27489,Simona & Matther,1,Entire home/apt,140,0,1.41,140
27490,Sawyeh,2,Entire home/apt,85,0,0.15,85
27491,Aleksey,1,Private room,105,68,6.78,173
27492,Monica,2,Entire home/apt,115,0,0.1,115
27494,Sascha,2,Entire home/apt,120,58,0.16,178
27495,Rabia,1,Private room,100,0,0.8,100
27496,Alex,1,Entire home/apt,250,22,0.57,272
27497,Sergii,2,Shared room,28,281,0.25,309
27498,Marine,2,Private room,150,0,0.2,150
27499,Sergii,2,Shared room,30,365,0.25,395
27500,Alexander,2,Shared room,30,325,0.11,355
27501,Cecilia,3,Shared room,60,125,3.62,185
27502,Isaies,1,Entire home/apt,75,3,0.63,78
27504,Jingjing,2,Private room,50,0,0.05,50
27505,Mikaela,2,Private room,50,5,0.33,55
27506,Emily,2,Entire home/apt,160,0,0.36,160
27507,Alexa,1,Entire home/apt,125,0,0.05,125
27509,Laura,1,Entire home/apt,250,188,1.71,438
27510,Donalda,2,Entire home/apt,110,309,1.91,419
27511,Matteo,2,Private room,95,59,2.54,154
27513,Tamosin,2,Entire home/apt,160,14,0.59,174
27514,Jotham,2,Private room,118,45,0.11,163
27515,Michael,2,Private room,70,17,4.67,87
27516,Karen,2,Entire home/apt,125,0,0.11,125
27518,Karin,2,Entire home/apt,130,106,0.3,236
27519,Amaad,1,Private room,80,339,0.32,419
27520,Anthony,1,Entire home/apt,248,0,0.96,248
27521,Sasha,2,Private room,48,6,0.32,54
27523,Taya,2,Entire home/apt,175,0,1.43,175
27524,Ramond,2,Private room,67,127,1.66,194
27525,Eddie,2,Private room,80,363,0.05,443
27527,Guillermo,1,Entire home/apt,180,10,0.42,190
27529,Jamie,2,Entire home/apt,98,0,0.62,98
27530,Kristina,2,Private room,40,0,0.3,40
27532,Aliza,1,Entire home/apt,200,0,2.36,200
27533,Carleigh,2,Entire home/apt,125,0,0.05,125
27534,Paul,2,Entire home/apt,90,0,0.37,90
27536,Victoria,2,Entire home/apt,100,0,0.25,100
27537,Patty,1,Entire home/apt,485,1,0.32,486
27538,Anushua,3,Private room,43,340,2.09,383
27539,Wendy,1,Entire home/apt,175,3,0.05,178
27541,Natalie,1,Entire home/apt,108,20,0.16,128
27542,Yan Sze,2,Entire home/apt,80,0,0.21,80
27543,Sarah,2,Private room,100,125,2.11,225
27544,Valerie,1,Entire home/apt,89,0,0.11,89
27545,Natalie,2,Entire home/apt,95,19,1.51,114
27547,Liane,2,Private room,46,81,2.51,127
27548,Robbie & Apples,2,Entire home/apt,200,15,0.11,215
27550,Bora,2,Private room,120,0,0.2,120
27552,Kevin,1,Private room,130,0,0.55,130
27553,JohnR,1,Entire home/apt,225,0,0.4,225
27554,K.C.,1,Entire home/apt,125,166,1.18,291
27557,Kristin,2,Entire home/apt,55,0,0.29,55
27559,Ken,2,Entire home/apt,175,0,0.05,175
27560,Meline,2,Private room,75,0,0.05,75
27561,Johana,2,Private room,80,17,0.25,97
27562,Stephen,1,Entire home/apt,320,93,0.09,413
27563,Toto,2,Entire home/apt,300,0,0.05,300
27564,Andrew,2,Private room,78,30,1.52,108
27565,Apostolos,1,Entire home/apt,100,0,0.57,100
27566,Nigel,2,Entire home/apt,213,0,0.05,213
27567,Matt,1,Private room,141,0,0.25,141
27568,Alex,3,Entire home/apt,100,0,0.12,100
27569,Elizabeth And Timothee,2,Entire home/apt,175,357,1.93,532
27570,Matt,1,Entire home/apt,225,0,0.05,225
27571,Brady,2,Entire home/apt,87,0,0.05,87
27573,Stephanie,1,Entire home/apt,78,0,0.2,78
27574,Shae,1,Entire home/apt,199,3,0.81,202
27576,Adele,2,Entire home/apt,125,0,2.02,125
27577,Amy,2,Private room,100,23,2.07,123
27578,John,2,Private room,37,90,0.81,127
27579,Ada,3,Private room,78,82,0.87,160
27580,Mike & Kevin,1,Private room,98,117,4.65,215
27583,Analia,2,Private room,70,43,4.12,113
27584,Jen,2,Private room,188,83,0.05,271
27585,Shalom,2,Private room,75,0,0.11,75
27586,Kai,2,Private room,60,0,1.06,60
27587,Dawn,1,Private room,63,0,0.1,63
27589,Cristina,1,Entire home/apt,175,147,0.1,322
27590,Lisa,1,Entire home/apt,2200,217,0.35,2417
27591,Sedef,2,Private room,95,28,0.36,123
27592,Yamile,1,Private room,135,70,3.47,205
27593,Yamile,1,Private room,126,45,3.98,171
27594,Mark,3,Private room,70,306,1.8,376
27596,Guy,2,Entire home/apt,150,13,0.42,163
27597,Brian,1,Entire home/apt,395,0,0.05,395
27598,Jeffrey,1,Entire home/apt,165,0,0.1,165
27599,Johnny,2,Private room,69,0,0.46,69
27600,Richard,1,Entire home/apt,850,178,0.22,1028
27601,Beverly,1,Private room,47,49,3.28,96
27602,Sarah,2,Entire home/apt,200,101,1.52,301
27604,Gaby,2,Entire home/apt,58,0,0.32,58
27605,Robert,2,Entire home/apt,90,45,1.63,135
27606,Beverly,1,Private room,47,49,3.38,96
27607,Ekta,2,Entire home/apt,95,167,1.46,262
27608,Kaitlin,2,Entire home/apt,180,0,0.22,180
27609,Rachel,2,Private room,54,0,0.56,54
27610,Ben,1,Entire home/apt,400,0,1.09,400
27611,Chryssie,1,Entire home/apt,175,176,1.93,351
27612,Viktor,1,Entire home/apt,138,0,0.05,138
27613,Jahmil,1,Entire home/apt,110,0,0.31,110
27614,Jerry,3,Entire home/apt,245,40,2.51,285
27616,Franco,2,Entire home/apt,125,83,3.92,208
27617,Kira,2,Private room,45,0,0.65,45
27618,Federico,2,Private room,100,107,0.39,207
27619,Kathryn,1,Entire home/apt,195,0,0.21,195
27620,Evan,1,Entire home/apt,101,0,1.09,101
27621,Gabriela,3,Private room,49,0,0.96,49
27622,Kamyar,4,Private room,70,0,0.43,70
27624,Johnny,2,Private room,100,170,1.7,270
27625,Amber,2,Entire home/apt,100,7,0.91,107
27626,Rob,2,Entire home/apt,249,17,0.71,266
27627,Ashley,1,Entire home/apt,99,0,0.2,99
27628,Aaron,2,Private room,60,85,2.41,145
27629,Abraham,2,Entire home/apt,459,87,1.0,546
27630,Lorna,2,Private room,70,264,0.66,334
27631,Camila,2,Private room,60,85,0.94,145
27632,Gipsy Properties,1,Entire home/apt,497,0,0.25,497
27633,Nicolas,2,Private room,130,0,0.52,130
27634,Abraham,2,Entire home/apt,59,49,2.13,108
27635,Alejandra,2,Private room,60,42,1.53,102
27636,Gipsy Properties,1,Entire home/apt,350,181,1.08,531
27637,Caitlin,2,Private room,75,0,0.95,75
27638,Aspen,2,Entire home/apt,160,15,0.54,175
27639,Bridget,1,Entire home/apt,550,7,0.27,557
27640,Annie,2,Private room,60,0,0.27,60
27641,Lorraine,2,Entire home/apt,100,140,3.72,240
27642,Adam,2,Private room,100,85,3.55,185
27646,Karalyn,2,Entire home/apt,105,3,0.2,108
27648,Michael,2,Private room,75,25,4.97,100
27649,Asad,3,Private room,52,325,10.38,377
27650,Reina,2,Private room,42,248,4.44,290
27652,Ameyo,2,Entire home/apt,120,189,0.42,309
27653,Sybilla Michelle,1,Private room,175,133,2.26,308
27654,Jamie,2,Entire home/apt,80,229,0.41,309
27655,Chris & Celia,2,Entire home/apt,220,349,0.5,569
27656,Amelia,2,Private room,101,0,0.76,101
27658,Sam,2,Entire home/apt,73,43,0.11,116
27660,Kizzie,2,Entire home/apt,110,6,0.17,116
27661,Jessica,1,Entire home/apt,125,28,1.27,153
27662,Paige,1,Private room,75,0,0.11,75
27663,Caitlin,2,Entire home/apt,130,0,0.16,130
27665,Hayden,2,Private room,25,0,0.45,25
27666,Astor,1,Entire home/apt,185,252,8.92,437
27667,Hollye,2,Private room,60,23,3.78,83
27669,Silvia,2,Entire home/apt,150,0,0.05,150
27670,Ilfir,1,Private room,175,0,0.21,175
27671,Leslie,1,Entire home/apt,500,85,0.78,585
27672,Jonathan,1,Entire home/apt,130,89,0.56,219
27673,Muhammad,2,Private room,67,143,1.79,210
27674,Victor,3,Private room,65,349,1.14,414
27675,Rashida,4,Private room,70,365,1.16,435
27676,Rebecca,2,Entire home/apt,130,28,2.39,158
27678,Jason,2,Private room,51,130,1.08,181
27679,Siyi,2,Private room,45,0,0.1,45
27681,Ina,2,Entire home/apt,43,0,0.38,43
27682,Jason,2,Private room,55,140,0.4,195
27683,Ted,2,Entire home/apt,175,138,4.85,313
27684,Marvin,2,Private room,45,269,0.76,314
27685,Dinorah,2,Entire home/apt,70,0,0.21,70
27686,Lucy,2,Entire home/apt,150,0,0.31,150
27687,Paul,2,Private room,65,0,0.05,65
27688,Betsy And Dan,2,Private room,140,156,0.85,296
27689,James,1,Entire home/apt,200,0,0.05,200
27690,Artemisia,1,Entire home/apt,195,282,0.3,477
27692,Rachel,1,Entire home/apt,225,6,0.49,231
27693,Florencia,1,Entire home/apt,150,0,0.05,150
27694,Aura Angelica,2,Private room,40,0,0.16,40
27695,Sarah,2,Entire home/apt,105,0,0.16,105
27697,Julia & Estuardo,2,Entire home/apt,195,55,2.39,250
27698,Alex,2,Entire home/apt,225,0,0.47,225
27699,Enrique,2,Private room,94,0,0.1,94
27700,Rod,1,Entire home/apt,220,0,0.05,220
27701,John,2,Private room,30,90,1.43,120
27702,Agnes,1,Entire home/apt,187,4,0.64,191
27704,John,2,Private room,45,90,1.57,135
27706,Alejandro,1,Shared room,89,0,0.05,89
27707,Nadia,1,Private room,97,365,0.26,462
27708,Gerry,2,Private room,49,62,1.62,111
27709,Kim,1,Private room,147,0,0.05,147
27710,Jess,2,Private room,26,0,0.05,26
27711,Georgia,3,Private room,31,0,0.1,31
27712,Sonia,2,Entire home/apt,100,333,0.44,433
27713,Brad,1,Entire home/apt,120,210,0.07,330
27714,Su,2,Entire home/apt,700,303,0.42,1003
27715,Maria,2,Entire home/apt,100,0,2.07,100
27716,Juan Luis,1,Private room,80,0,0.11,80
27717,Marilyn,3,Entire home/apt,83,365,0.68,448
27718,Marco,2,Shared room,35,301,0.78,336
27719,Sausan,1,Entire home/apt,133,211,0.54,344
27720,Sonia,2,Entire home/apt,92,0,0.21,92
27721,Marco,2,Shared room,35,274,0.81,309
27722,Steven,1,Private room,95,9,1.83,104
27723,Alexes,4,Private room,73,0,0.08,73
27724,Cindy,1,Entire home/apt,255,0,0.26,255
27725,Sunil,2,Entire home/apt,200,31,1.0,231
27726,Claire,1,Entire home/apt,225,1,0.13,226
27728,Sara,1,Entire home/apt,159,0,0.16,159
27729,Richard,2,Entire home/apt,195,0,2.44,195
27730,Ethan,1,Entire home/apt,495,2,0.17,497
27731,Irina,1,Entire home/apt,130,268,0.43,398
27732,Jenny,2,Entire home/apt,135,255,2.36,390
27733,Payal,3,Entire home/apt,100,2,1.78,102
27734,Sweden,2,Private room,59,347,5.2,406
27735,Ezra,2,Private room,150,364,0.1,514
27736,Sweden,2,Private room,65,334,5.03,399
27737,David & Mallory,2,Entire home/apt,175,0,1.96,175
27738,Julia,2,Entire home/apt,380,8,0.98,388
27739,Carol & Darcy,3,Entire home/apt,170,0,0.09,170
27740,Brown,3,Private room,50,95,0.2,145
27741,Javier,2,Entire home/apt,78,0,0.11,78
27742,Michelle,2,Private room,30,0,0.36,30
27743,Boris,1,Entire home/apt,200,0,0.16,200
27744,Juan Carlos,2,Entire home/apt,80,28,2.11,108
27745,Chris,2,Entire home/apt,99,306,2.37,405
27746,Brittany,2,Entire home/apt,125,0,0.1,125
27747,Mike,1,Entire home/apt,165,2,0.11,167
27748,Megan,1,Entire home/apt,159,12,0.31,171
27749,W.,4,Entire home/apt,99,349,0.06,448
27750,Leigha,1,Private room,50,0,0.05,50
27751,Sarah,2,Entire home/apt,96,0,0.06,96
27752,Savanah,2,Private room,65,0,0.07,65
27754,Elizabeth,2,Private room,65,305,1.55,370
27755,Christian,1,Private room,250,0,0.05,250
27756,Cedar,1,Entire home/apt,193,105,3.84,298
27757,Michael,2,Private room,110,336,1.37,446
27759,Jen,1,Entire home/apt,220,0,0.1,220
27760,Elizabeth,2,Private room,70,236,0.77,306
27761,Andrea,2,Entire home/apt,80,0,0.5,80
27762,Elizabeth,2,Private room,70,315,1.22,385
27763,Greg,1,Entire home/apt,200,194,4.24,394
27766,Ty,2,Entire home/apt,170,0,0.45,170
27767,Nicholas,1,Private room,135,76,1.7,211
27768,Daniela,2,Private room,65,0,0.05,65
27769,Mary,2,Private room,60,49,3.11,109
27770,Gipsy Properties,1,Entire home/apt,339,335,0.53,674
27771,Abigail,2,Entire home/apt,125,0,0.11,125
27773,Andrea,1,Private room,60,0,0.05,60
27774,★The Local Apple★,1,Entire home/apt,750,332,0.61,1082
27776,Sharon,2,Entire home/apt,250,52,2.33,302
27778,Louise,3,Entire home/apt,75,0,8.24,75
27779,Nick,1,Private room,129,153,0.31,282
27780,Louise,2,Private room,85,0,0.18,85
27782,Devi,4,Private room,35,1,0.7,36
27783,Kim,3,Entire home/apt,99,64,2.17,163
27784,Ben,2,Entire home/apt,140,0,0.1,140
27785,Trish,1,Entire home/apt,1000,310,2.07,1310
27786,On,2,Entire home/apt,116,0,0.11,116
27787,Jimena,2,Private room,60,0,0.1,60
27788,Ebada,2,Entire home/apt,130,324,0.22,454
27789,Sam,2,Entire home/apt,350,362,0.26,712
27790,Paula,2,Entire home/apt,95,277,1.25,372
27791,Iris,3,Shared room,21,0,0.55,21
27793,Moises,1,Entire home/apt,108,0,0.05,108
27794,Franz,3,Entire home/apt,50,40,2.38,90
27795,Isabella,1,Entire home/apt,175,0,0.62,175
27796,Max,1,Entire home/apt,230,0,0.16,230
27797,Anne-Katrin,2,Private room,60,0,0.05,60
27798,Amelia,2,Entire home/apt,130,0,0.05,130
27799,Erin,1,Entire home/apt,299,2,1.08,301
27800,Sydney,2,Private room,40,67,0.7,107
27801,Tia,2,Private room,40,37,0.22,77
27803,Dina,1,Private room,48,0,0.05,48
27804,Nicole,1,Entire home/apt,300,39,1.46,339
27805,Ali,3,Entire home/apt,228,178,2.63,406
27806,Nelima,2,Private room,60,42,0.83,102
27807,Sandra,1,Private room,99,25,2.49,124
27808,Dee,1,Private room,65,0,0.69,65
27810,Samuel,2,Entire home/apt,90,255,2.84,345
27813,Marlene,2,Entire home/apt,60,300,2.34,360
27814,Victor,2,Entire home/apt,110,18,2.31,128
27816,Maxwell,1,Entire home/apt,500,0,0.05,500
27817,Jack,1,Entire home/apt,600,169,1.09,769
27818,Emma,1,Entire home/apt,125,0,0.16,125
27819,Janice,4,Entire home/apt,62,68,3.22,130
27820,Kevin,1,Entire home/apt,196,0,0.36,196
27821,Umar,1,Entire home/apt,299,199,4.01,498
27822,Rasmus,2,Private room,80,5,0.11,85
27823,Josephine,1,Private room,111,0,0.05,111
27824,Rasmus,2,Private room,80,88,0.16,168
27825,Tim And Reuben,1,Entire home/apt,184,313,0.61,497
27826,Helen,2,Private room,60,302,0.22,362
27827,Thomas,2,Private room,75,0,2.11,75
27828,Katelynn,1,Entire home/apt,70,3,0.2,73
27829,Emma,1,Entire home/apt,210,78,0.65,288
27830,Bryan,2,Entire home/apt,165,0,0.37,165
27831,Diego,2,Private room,40,184,0.65,224
27832,Hamza,1,Private room,170,0,0.15,170
27833,Yarden,2,Entire home/apt,93,0,0.13,93
27834,Julia,2,Private room,47,0,0.25,47
27836,Elliot,1,Entire home/apt,175,0,1.03,175
27837,Stephanie,1,Private room,120,179,0.22,299
27838,Victoria,2,Entire home/apt,70,0,0.61,70
27840,Evan,1,Entire home/apt,105,0,0.71,105
27841,Daphne & Jonathan,2,Entire home/apt,275,325,4.06,600
27842,Adrianne,1,Entire home/apt,165,0,0.05,165
27843,Michelle,3,Private room,48,171,0.72,219
27844,Alexander,1,Entire home/apt,195,0,0.16,195
27845,Bert,2,Entire home/apt,280,0,0.11,280
27847,Hugh,3,Entire home/apt,80,307,10.86,387
27848,JoaoLinda,2,Private room,48,349,3.04,397
27849,Rachel,1,Entire home/apt,228,0,0.08,228
27851,Dániel,2,Entire home/apt,60,0,0.11,60
27852,Alan,3,Entire home/apt,90,281,0.3,371
27853,Melissa,2,Private room,139,355,4.16,494
27854,Michael,3,Entire home/apt,95,0,0.26,95
27855,Melissa,2,Private room,129,364,0.36,493
27857,Melissa,2,Private room,119,364,0.46,483
27858,Sylvia,1,Private room,90,0,0.05,90
27859,Jade,1,Entire home/apt,125,0,0.26,125
27860,Charles,2,Private room,55,0,0.05,55
27861,Iquane,2,Entire home/apt,79,92,3.78,171
27862,Ariel,1,Entire home/apt,120,153,0.24,273
27863,Andrea,1,Private room,138,60,4.65,198
27864,Kaleisha,1,Entire home/apt,126,0,0.1,126
27865,Chuhan,1,Private room,35,0,0.11,35
27866,Yoleni,1,Private room,46,0,0.25,46
27868,Marion,2,Private room,50,0,1.21,50
27870,Ana Y Victor,2,Private room,400,77,1.36,477
27873,Mateo,2,Private room,45,0,0.05,45
27875,Nicole,2,Private room,50,0,0.21,50
27876,Brian,2,Private room,300,0,0.2,300
27877,Caro,3,Entire home/apt,95,3,0.67,98
27878,Ronak,1,Private room,150,0,0.05,150
27879,Antrice,4,Entire home/apt,70,0,0.36,70
27880,Catherine,2,Private room,45,0,0.08,45
27881,David,2,Entire home/apt,280,0,0.99,280
27882,Laura,1,Private room,45,0,0.15,45
27885,Lee,3,Entire home/apt,245,201,4.79,446
27886,Merisa,2,Private room,50,0,0.05,50
27887,Andrea,2,Entire home/apt,125,9,0.73,134
27888,Shirley,2,Entire home/apt,95,0,2.13,95
27889,Jennifer,2,Entire home/apt,150,0,0.54,150
27890,Brittney,2,Entire home/apt,100,0,1.08,100
27892,Elsa,1,Entire home/apt,125,0,0.15,125
27894,Jeff,2,Private room,105,139,3.95,244
27895,Josh,2,Private room,59,0,0.05,59
27896,John,1,Private room,99,11,1.02,110
27898,Charlotte,2,Entire home/apt,115,0,0.11,115
27899,Lakisha,2,Private room,53,177,1.03,230
27900,Amy,3,Private room,45,0,0.4,45
27901,Dadrine,2,Private room,80,364,0.36,444
27902,Lauren,2,Shared room,43,104,1.86,147
27903,Stacey-Ann,1,Entire home/apt,275,0,0.11,275
27904,Aj,2,Entire home/apt,200,336,2.67,536
27906,Emily,1,Entire home/apt,96,0,0.1,96
27907,Noah,2,Private room,65,0,0.19,65
27908,Julien,1,Entire home/apt,180,0,0.11,180
27910,Patrick,1,Private room,125,42,3.0,167
27912,Katie,2,Private room,95,77,2.63,172
27913,Ashley,1,Entire home/apt,150,0,0.05,150
27914,Taylor,2,Private room,85,0,1.62,85
27915,Shachar,1,Entire home/apt,190,0,0.05,190
27916,Matan,2,Private room,61,7,1.27,68
27917,Nompakamiso,1,Entire home/apt,130,7,0.33,137
27918,Hugo,1,Entire home/apt,180,0,0.22,180
27919,Heeran,3,Private room,60,34,4.1,94
27920,Tara,3,Entire home/apt,200,202,1.3,402
27921,Antonio,2,Private room,65,0,0.06,65
27922,Christopher,1,Entire home/apt,1066,365,0.2,1431
27923,Sasha,1,Entire home/apt,200,18,1.58,218
27924,Kelsy,1,Entire home/apt,130,155,1.36,285
27925,Thomas,1,Private room,70,0,0.4,70
27926,Heini,2,Entire home/apt,95,1,0.21,96
27927,Felix,2,Entire home/apt,400,46,2.22,446
27928,Chelsea,1,Entire home/apt,150,13,0.48,163
27929,Melissa,2,Entire home/apt,115,0,0.86,115
27930,Thiru,2,Entire home/apt,80,0,0.05,80
27931,Alex,1,Entire home/apt,345,150,3.17,495
27932,Agnes,1,Entire home/apt,110,52,4.4,162
27933,Stephanie,1,Entire home/apt,150,0,1.18,150
27934,Kevin,1,Entire home/apt,265,257,3.34,522
27935,Leah,2,Private room,42,53,0.22,95
27936,Jonathan,1,Entire home/apt,95,0,0.27,95
27937,Nicky,1,Entire home/apt,130,0,0.41,130
27938,Mariana,2,Entire home/apt,99,0,0.22,99
27939,Chahine,2,Private room,51,0,0.05,51
27940,V,2,Entire home/apt,300,318,1.04,618
27941,Numi,2,Entire home/apt,259,355,1.3,614
27942,Nicole,1,Entire home/apt,250,4,0.25,254
27943,Nicole,1,Private room,71,17,0.31,88
27944,Danish,1,Private room,155,0,0.36,155
27945,Steven,1,Entire home/apt,135,21,2.03,156
27946,Judie And Steven,1,Private room,89,84,5.33,173
27950,Jon,2,Private room,75,88,0.06,163
27951,Francesca,2,Private room,50,298,2.29,348
27952,Rebecca,2,Private room,70,3,0.85,73
27954,Hongye,3,Private room,68,51,3.54,119
27955,Kaya,2,Private room,80,0,0.05,80
27956,Curtis,1,Private room,200,0,0.1,200
27960,Leslie,2,Entire home/apt,41,0,0.05,41
27961,Arianne,1,Entire home/apt,200,1,0.67,201
27963,Sheba,1,Entire home/apt,160,23,1.12,183
27964,Karina,2,Private room,55,0,0.1,55
27966,Karina,2,Private room,60,0,0.71,60
27967,Taeho,2,Entire home/apt,135,2,0.36,137
27968,Ioanna,3,Entire home/apt,95,0,0.1,95
27969,Natasha,2,Entire home/apt,350,0,0.82,350
27970,Justine,1,Entire home/apt,245,0,0.62,245
27971,Joyce,1,Entire home/apt,150,49,3.07,199
27972,Vishanti & Jeremy,2,Entire home/apt,10,32,4.73,42
27973,Lucile,1,Private room,69,0,4.0,69
27974,Tara,1,Entire home/apt,250,82,3.23,332
27975,Sharon,1,Private room,88,0,0.15,88
27976,Kenneth,1,Private room,200,0,0.05,200
27977,Shirley,2,Entire home/apt,160,230,2.83,390
27979,Karen,1,Entire home/apt,150,226,0.1,376
27980,Wene,2,Entire home/apt,280,343,0.44,623
27981,Chad Michael,2,Entire home/apt,65,1,2.16,66
27982,Ken,2,Entire home/apt,150,0,0.1,150
27983,Alexandra,2,Entire home/apt,159,89,2.57,248
27984,Stanley,1,Entire home/apt,150,365,0.21,515
27986,Annie,1,Entire home/apt,200,3,0.19,203
27987,Jon,2,Entire home/apt,100,31,0.12,131
27988,WeWork,1,Entire home/apt,425,253,6.68,678
27989,Mary,2,Entire home/apt,115,2,0.21,117
27990,Amon,1,Private room,50,0,0.71,50
27992,Angelica,1,Private room,93,0,0.05,93
27993,Lisa,1,Entire home/apt,160,27,2.66,187
27995,Tina,1,Entire home/apt,210,0,0.39,210
27996,Alejandro,1,Entire home/apt,250,0,2.97,250
27998,WeWork,1,Private room,225,290,2.18,515
27999,Claudia,3,Private room,40,0,0.05,40
28000,WeWork,1,Entire home/apt,215,339,7.9,554
28002,Cedar,1,Private room,90,217,0.1,307
28003,Anjelica,1,Entire home/apt,170,1,1.4,171
28005,Kaity,2,Entire home/apt,80,0,0.05,80
28007,Yngridd,1,Entire home/apt,200,268,4.03,468
28008,Joshua,2,Private room,43,0,0.31,43
28009,Nicholas,2,Entire home/apt,100,0,3.23,100
28010,Karanja,2,Private room,55,137,0.1,192
28011,Vanessa,2,Private room,55,65,0.16,120
28012,Cindy,1,Private room,95,0,0.16,95
28014,Ana,2,Private room,42,0,0.05,42
28015,Lauren,1,Entire home/apt,125,0,0.68,125
28016,Andre,2,Private room,80,0,1.51,80
28017,Corporate Housing,1,Entire home/apt,133,301,0.43,434
28018,Stanley,1,Entire home/apt,150,365,0.14,515
28019,Dante,1,Private room,12,37,0.59,49
28020,Laura,2,Entire home/apt,120,0,0.05,120
28021,Thomas,2,Private room,50,0,1.46,50
28022,Christopher,2,Entire home/apt,250,0,0.8,250
28023,Camila,2,Private room,70,0,0.67,70
28025,Rawad,1,Private room,40,0,0.05,40
28026,Besnik,2,Entire home/apt,79,153,8.57,232
28027,Amelia,1,Entire home/apt,120,0,0.16,120
28028,Nickelous,2,Entire home/apt,139,0,0.05,139
28029,Oh,2,Private room,66,5,2.6,71
28030,Musieka,4,Private room,40,17,1.23,57
28031,Mark,2,Entire home/apt,100,0,0.21,100
28032,Lizzie,2,Private room,50,0,0.21,50
28033,Angelo,2,Entire home/apt,185,0,0.91,185
28035,Tom,1,Private room,160,0,0.1,160
28036,Jared,1,Private room,80,0,0.22,80
28037,Milana,2,Entire home/apt,119,135,1.02,254
28039,Mondell,2,Entire home/apt,155,287,3.41,442
28041,Spiritchild,5,Private room,100,336,3.9,436
28043,Sergii,2,Private room,38,365,0.21,403
28044,Dani,2,Entire home/apt,80,0,0.11,80
28046,Melissa,2,Private room,119,363,0.71,482
28047,Melissa,2,Private room,119,354,1.02,473
28049,Melissa,2,Private room,119,364,0.57,483
28050,Melissa,2,Private room,119,355,0.97,474
28051,Stanley,1,Entire home/apt,195,365,0.09,560
28052,Melissa,2,Private room,119,363,1.32,482
28053,Gary,1,Entire home/apt,200,0,0.1,200
28054,Dan Hua,3,Entire home/apt,143,0,0.15,143
28055,Lily,1,Private room,45,149,1.89,194
28056,"Yumi, Chizu",1,Entire home/apt,350,89,0.74,439
28057,Adeel,3,Entire home/apt,99,320,6.0,419
28058,Reese,1,Private room,65,0,0.31,65
28059,Marc,1,Entire home/apt,85,66,1.45,151
28060,Johny,2,Entire home/apt,160,3,1.64,163
28061,Patricia,1,Entire home/apt,400,306,2.13,706
28063,Laurence,1,Private room,85,0,0.21,85
28064,Tina,1,Entire home/apt,89,3,2.75,92
28066,Dewey,2,Private room,39,0,0.46,39
28067,Fabiana,2,Entire home/apt,50,47,2.65,97
28068,Emilyn,2,Private room,37,0,0.16,37
28070,Jamiel,2,Entire home/apt,150,1,0.76,151
28071,Maria,2,Entire home/apt,85,125,0.32,210
28072,Rebecca,2,Entire home/apt,99,64,0.71,163
28073,Trent,2,Entire home/apt,100,0,0.11,100
28074,Nancy,2,Entire home/apt,165,82,1.9,247
28076,Rocio,2,Entire home/apt,100,177,0.11,277
28077,Jordan,2,Entire home/apt,130,0,0.12,130
28080,Lucas,1,Private room,50,26,2.63,76
28081,Stavros,1,Entire home/apt,130,0,0.1,130
28082,Naomi,1,Entire home/apt,250,0,0.1,250
28083,Erik,2,Entire home/apt,90,0,0.42,90
28084,WeiWei,2,Entire home/apt,110,0,0.21,110
28085,Xizi,1,Private room,40,0,0.06,40
28087,Haijiao,3,Entire home/apt,100,156,10.15,256
28089,Seeranie,3,Private room,35,359,3.0,394
28090,Fifi,1,Private room,85,121,3.93,206
28091,Sergii,2,Private room,50,365,0.2,415
28092,Melanie,3,Private room,50,0,0.31,50
28093,Rasul,3,Private room,38,353,1.82,391
28094,Rafael,2,Private room,65,0,0.05,65
28098,Christopher,1,Entire home/apt,250,20,0.97,270
28100,Melissa,2,Private room,129,361,0.67,490
28101,Melissa,2,Private room,129,363,1.62,492
28102,John,2,Private room,41,0,0.93,41
28103,Agus,2,Private room,65,238,2.47,303
28104,Melissa,2,Private room,129,338,0.46,467
28105,Melissa,2,Private room,129,362,1.44,491
28106,Emily,2,Private room,70,0,0.05,70
28107,Stanley,1,Entire home/apt,150,364,0.3,514
28108,Bridget,1,Private room,89,0,0.15,89
28109,Natalie,1,Private room,100,0,0.05,100
28110,Lee,1,Entire home/apt,175,107,0.79,282
28111,Charles,1,Private room,20,291,1.1,311
28112,Noemie,2,Entire home/apt,300,0,0.39,300
28113,BonnieAnn,1,Entire home/apt,275,51,0.65,326
28114,Marc,1,Shared room,185,0,0.11,185
28115,Haijiao,3,Entire home/apt,120,79,6.05,199
28116,Degelis,1,Entire home/apt,220,189,0.65,409
28117,Justin,2,Private room,50,363,0.32,413
28118,Melissa,3,Private room,30,249,0.77,279
28119,诗月,1,Private room,70,0,0.08,70
28120,Bridget,3,Private room,600,0,0.27,600
28122,Paulina,1,Entire home/apt,200,0,0.37,200
28123,Michael,2,Private room,60,31,3.98,91
28124,Ryan,3,Entire home/apt,125,64,0.54,189
28125,Ms. Edith,2,Private room,50,90,0.14,140
28126,Hasan,3,Private room,75,89,0.05,164
28127,Josh,1,Entire home/apt,150,18,0.22,168
28129,Elaine,1,Entire home/apt,200,0,0.05,200
28130,Josh,2,Entire home/apt,199,302,2.34,501
28131,Celine,2,Private room,70,0,0.2,70
28132,Gilana,2,Entire home/apt,115,5,0.38,120
28133,Helena,2,Entire home/apt,250,0,0.05,250
28134,Kimberly,2,Entire home/apt,142,0,0.25,142
28135,Mo,2,Private room,67,179,0.16,246
28136,Nora,1,Private room,40,0,0.1,40
28137,Russ,1,Entire home/apt,350,0,0.05,350
28138,Patrick,2,Entire home/apt,160,81,3.28,241
28139,Amado,2,Entire home/apt,149,115,5.35,264
28141,Brad,1,Entire home/apt,850,174,0.83,1024
28142,Vic,3,Private room,75,48,1.3,123
28143,Russ,1,Entire home/apt,400,0,0.05,400
28144,Tomislav,1,Private room,95,18,5.35,113
28145,Jonathan,2,Entire home/apt,85,0,0.28,85
28146,Taylor,1,Shared room,130,0,0.05,130
28147,Andrew,2,Entire home/apt,149,235,3.03,384
28149,Bess,2,Entire home/apt,95,0,0.1,95
28150,Sofia,1,Entire home/apt,850,36,0.76,886
28151,Ervita,2,Private room,60,276,2.55,336
28152,Helen,3,Private room,65,0,0.52,65
28154,Dova,1,Entire home/apt,105,0,0.05,105
28155,Joaquin,1,Entire home/apt,395,0,0.05,395
28156,Anne,2,Entire home/apt,550,14,0.42,564
28157,Magdalena,2,Private room,50,0,0.1,50
28159,Charlie,1,Entire home/apt,160,1,0.27,161
28160,Anna,3,Entire home/apt,51,0,0.21,51
28161,Bec,1,Entire home/apt,220,0,0.16,220
28164,Shirley,3,Private room,45,291,2.03,336
28165,Tina,2,Private room,79,175,0.62,254
28166,Andy,1,Private room,55,0,0.81,55
28167,Nina,2,Private room,45,0,0.05,45
28169,Dean,1,Entire home/apt,200,0,0.1,200
28170,Giulia,2,Entire home/apt,103,105,3.2,208
28171,Melissa,2,Private room,139,358,0.31,497
28172,Nguyen,4,Private room,69,365,1.7,434
28173,Lacy,2,Private room,60,0,0.11,60
28174,Yuanwen,1,Entire home/apt,150,0,0.05,150
28175,Laurene,2,Private room,31,302,0.36,333
28176,Corin,1,Private room,100,0,0.26,100
28177,Chandler,2,Entire home/apt,650,0,0.16,650
28178,Jose,1,Entire home/apt,210,209,1.11,419
28179,Kathryn,4,Private room,49,0,3.08,49
28180,David,2,Private room,30,0,0.11,30
28181,Angelo,3,Entire home/apt,140,0,0.21,140
28182,Sharif,2,Private room,71,0,1.6,71
28183,Peter,2,Entire home/apt,60,6,1.13,66
28184,Rebecca,2,Entire home/apt,90,116,0.18,206
28185,Mahayla,2,Private room,80,0,0.1,80
28186,Myah,2,Entire home/apt,60,0,2.04,60
28187,Jesse,2,Private room,109,0,0.21,109
28188,Zoe,2,Private room,75,0,0.48,75
28189,Melissa,2,Private room,139,364,0.51,503
28190,Melissa,2,Private room,139,337,2.85,476
28191,Troi,2,Entire home/apt,350,353,0.76,703
28193,Luis,2,Entire home/apt,100,337,3.17,437
28194,Alexander,2,Private room,120,0,0.1,120
28195,Melissa,2,Private room,139,342,2.36,481
28197,Adrián,1,Entire home/apt,161,0,0.16,161
28198,Jane,1,Entire home/apt,245,141,2.27,386
28199,Alesia,1,Entire home/apt,800,0,0.56,800
28201,Christie,2,Entire home/apt,135,0,0.16,135
28203,Jamesetta,1,Private room,35,0,0.37,35
28204,Tina,2,Private room,79,176,1.44,255
28207,Frankie,2,Entire home/apt,200,0,0.16,200
28208,Jeffrey,2,Entire home/apt,225,0,0.06,225
28210,Kim,1,Entire home/apt,300,272,2.42,572
28211,Vicente,1,Private room,130,0,2.08,130
28213,Marcia,2,Entire home/apt,90,52,2.18,142
28214,Sergii,2,Private room,50,361,0.11,411
28215,Max,1,Shared room,35,322,0.25,357
28216,Sergii,2,Private room,50,365,0.15,415
28217,Sergii,2,Private room,50,364,0.21,414
28219,Elizabeth,1,Entire home/apt,250,0,0.33,250
28220,Alexandra,2,Entire home/apt,180,0,0.53,180
28221,Mark,1,Entire home/apt,485,203,2.36,688
28222,Justin,2,Entire home/apt,350,132,1.15,482
28223,Adam,2,Entire home/apt,99,68,6.07,167
28225,Jen,1,Entire home/apt,150,0,0.05,150
28226,Alana,1,Entire home/apt,300,0,0.46,300
28227,Kristina,2,Private room,40,0,0.16,40
28228,Su,2,Private room,60,0,0.46,60
28229,Musa,1,Entire home/apt,100,0,0.05,100
28230,Grace,1,Entire home/apt,275,0,0.05,275
28231,Noel,2,Entire home/apt,70,0,0.05,70
28232,Rup,1,Entire home/apt,100,0,0.46,100
28233,Lauren,2,Entire home/apt,66,0,0.17,66
28234,Peter,3,Entire home/apt,250,183,2.16,433
28237,Whitney,2,Entire home/apt,100,3,1.0,103
28238,Alysee,2,Entire home/apt,55,0,0.77,55
28239,David,1,Entire home/apt,650,301,1.35,951
28240,Leena,1,Entire home/apt,100,0,0.32,100
28241,Anne,2,Entire home/apt,120,0,0.05,120
28243,Angie,1,Private room,88,73,2.25,161
28244,Raquel,5,Private room,27,287,1.14,314
28246,Angele,1,Entire home/apt,150,1,1.1,151
28248,Leland,2,Private room,50,172,2.19,222
28249,Emily,2,Entire home/apt,125,0,0.05,125
28250,Jonathan,1,Private room,43,0,0.05,43
28251,Christopher,2,Entire home/apt,90,0,0.36,90
28252,Anthony,1,Entire home/apt,150,0,0.16,150
28253,Heather,2,Entire home/apt,110,3,0.83,113
28254,Nikos,3,Entire home/apt,150,0,1.48,150
28255,Maria,2,Private room,80,0,0.05,80
28257,M,1,Private room,130,31,0.14,161
28258,Pierre Yves,2,Entire home/apt,196,3,0.22,199
28259,Frank,2,Entire home/apt,115,292,0.25,407
28260,Andy,1,Entire home/apt,225,257,2.0,482
28261,Marika,1,Entire home/apt,274,7,0.22,281
28262,Meng-Mei,1,Entire home/apt,107,0,0.06,107
28264,Jay,1,Entire home/apt,250,265,0.58,515
28265,Michael,2,Private room,41,0,0.11,41
28267,Melissa,2,Private room,169,364,0.62,533
28268,Jason,2,Private room,43,0,0.26,43
28269,Cassie,1,Private room,99,0,0.1,99
28270,Colin,3,Entire home/apt,66,173,0.47,239
28271,Luna,2,Private room,38,0,0.05,38
28272,Junior,2,Entire home/apt,150,105,2.82,255
28273,Jammie,2,Shared room,49,5,1.67,54
28275,Rei,1,Private room,75,0,0.05,75
28276,Frank,1,Private room,88,0,0.09,88
28277,Julien,1,Private room,300,19,5.59,319
28278,Amanda,1,Entire home/apt,205,0,0.1,205
28279,Sara,2,Entire home/apt,199,297,1.03,496
28280,Rena,3,Private room,50,0,0.16,50
28281,Jerome,1,Private room,69,0,0.11,69
28282,Alexander,2,Entire home/apt,85,139,1.3,224
28283,Stephanie,1,Private room,150,0,0.22,150
28290,Oliver,1,Entire home/apt,150,7,0.05,157
28291,Rodrigo,2,Private room,75,313,4.03,388
28292,Kelvin,1,Private room,60,50,4.48,110
28293,Kate,2,Private room,75,0,1.08,75
28294,Kem,1,Private room,150,365,5.55,515
28295,Angela,3,Entire home/apt,460,160,2.55,620
28296,Ken,1,Entire home/apt,125,14,3.71,139
28297,John,1,Private room,65,101,3.08,166
28299,Pierre,1,Private room,85,311,0.11,396
28300,Nargis,2,Private room,75,0,0.16,75
28302,Gabriele,2,Entire home/apt,159,56,1.67,215
28303,Stephen,2,Entire home/apt,60,0,0.05,60
28304,Cecilia,1,Entire home/apt,135,145,1.0,280
28305,Roxanne,2,Private room,50,0,0.7,50
28306,Merida,3,Private room,65,125,0.07,190
28310,Jamel,2,Entire home/apt,85,149,1.25,234
28311,Nicole,1,Private room,54,5,0.31,59
28312,Tri,1,Entire home/apt,120,0,0.16,120
28313,Shay,2,Private room,75,0,0.42,75
28315,Nicole,1,Entire home/apt,73,6,0.61,79
28316,Mike,1,Entire home/apt,94,155,0.16,249
28317,Sarah,2,Entire home/apt,300,82,0.7,382
28320,Saoirse,1,Entire home/apt,186,8,1.33,194
28321,Brandon,3,Entire home/apt,113,0,0.49,113
28322,Ottilia,3,Private room,50,49,0.84,99
28323,Scarlett,1,Private room,70,0,0.11,70
28324,Jacqueline,1,Entire home/apt,325,0,0.21,325
28325,Shir,2,Private room,49,0,0.17,49
28326,Elena,2,Private room,85,5,3.14,90
28327,Mo,1,Entire home/apt,487,198,2.61,685
28328,Annette,2,Entire home/apt,49,141,4.27,190
28329,Doo,2,Entire home/apt,150,84,0.74,234
28332,Theis,3,Entire home/apt,90,0,0.05,90
28333,Caeli,1,Private room,34,0,0.22,34
28334,Lakisha,2,Private room,51,177,1.02,228
28335,Dez,1,Entire home/apt,200,0,0.05,200
28336,Dana,1,Private room,45,3,2.69,48
28337,Jenny,2,Private room,45,0,0.16,45
28338,Jason,1,Entire home/apt,115,282,0.21,397
28339,Lakisha,2,Private room,60,177,1.35,237
28340,Joëlle,1,Entire home/apt,150,0,0.21,150
28341,Silvia,2,Private room,33,305,3.19,338
28342,Mike,2,Entire home/apt,100,0,0.81,100
28343,Cheryl,1,Entire home/apt,200,0,0.16,200
28344,Koryn,2,Entire home/apt,150,334,1.17,484
28345,Mike,2,Entire home/apt,131,61,3.94,192
28346,Tina,3,Private room,58,0,0.26,58
28348,Holly,2,Entire home/apt,300,350,0.47,650
28349,Rebecca,2,Entire home/apt,102,0,0.14,102
28350,Kim,3,Entire home/apt,88,39,2.33,127
28352,Emily & Mathias,2,Entire home/apt,209,0,0.05,209
28353,Benjamin,2,Entire home/apt,200,1,1.0,201
28354,Po,3,Entire home/apt,120,0,0.16,120
28356,Miller,2,Entire home/apt,58,0,1.46,58
28357,Dorothy,1,Private room,200,0,0.05,200
28358,Miguel,1,Private room,120,32,4.1,152
28360,Kyrié,2,Private room,60,0,0.43,60
28362,Cooper,1,Entire home/apt,145,173,0.84,318
28363,Carly,2,Private room,35,0,0.11,35
28364,Cyrille,2,Private room,75,132,0.5,207
28366,Amanda,2,Entire home/apt,325,14,1.1,339
28367,Alvaro Luis,1,Entire home/apt,200,0,0.33,200
28368,Jenny,4,Entire home/apt,50,0,0.1,50
28370,Fabian,3,Private room,53,151,8.74,204
28371,Vera,1,Entire home/apt,90,31,0.31,121
28372,Catherine,1,Entire home/apt,110,6,1.74,116
28373,Adeola,3,Entire home/apt,250,347,2.12,597
28375,Luis,4,Private room,39,8,1.93,47
28376,Maurine,1,Entire home/apt,150,0,0.32,150
28378,Jay,2,Private room,105,173,0.8,278
28379,Kseniya,1,Entire home/apt,100,65,5.99,165
28381,Daniel,2,Private room,50,0,0.42,50
28382,Liam,1,Entire home/apt,455,332,1.77,787
28384,Andy,1,Private room,58,0,0.1,58
28385,Daniel,1,Entire home/apt,125,7,0.27,132
28386,Janine,2,Private room,75,179,2.8,254
28387,David,1,Private room,55,0,0.21,55
28388,Joycelyn,2,Shared room,29,1,0.22,30
28389,Joana,2,Private room,37,0,0.22,37
28390,Benjamin,2,Entire home/apt,90,38,4.67,128
28391,Vicente,1,Shared room,65,0,3.97,65
28393,Peter,3,Entire home/apt,95,96,3.43,191
28394,Angela,3,Private room,98,3,0.06,101
28395,Angela,3,Private room,120,6,0.05,126
28396,Stella,1,Private room,90,67,2.7,157
28398,Ibrahim Maiga,4,Private room,45,313,2.94,358
28399,Jessica,3,Shared room,41,27,1.01,68
28400,Stanton,1,Entire home/apt,175,3,0.15,178
28401,Tariq,2,Entire home/apt,150,0,0.11,150
28402,Laura,1,Entire home/apt,200,9,0.38,209
28403,Ervita,2,Private room,60,180,3.82,240
28404,Ahyoung,2,Entire home/apt,80,0,0.16,80
28405,Kimberle,2,Entire home/apt,81,0,0.06,81
28406,Juan,3,Private room,31,0,0.15,31
28409,Jake,1,Private room,50,0,0.26,50
28410,Nadia,2,Private room,130,179,0.19,309
28411,Semhar,1,Entire home/apt,105,0,0.65,105
28412,Caroline,2,Private room,50,0,0.22,50
28413,Cristina,2,Private room,35,61,0.05,96
28414,Gabrielle,1,Entire home/apt,115,0,0.26,115
28416,Walter,1,Entire home/apt,170,4,2.19,174
28417,Herminia,3,Entire home/apt,90,0,0.43,90
28418,Simon,2,Entire home/apt,130,0,0.43,130
28420,Stanley,1,Entire home/apt,150,364,0.4,514
28423,Jeff,1,Private room,55,0,0.16,55
28424,Rui Guang,3,Private room,59,79,5.01,138
28425,Eliana,1,Private room,65,1,1.12,66
28426,Angie,1,Private room,50,0,0.05,50
28427,Houman,2,Entire home/apt,148,64,0.58,212
28430,Jenna,1,Entire home/apt,250,0,0.11,250
28433,David,2,Entire home/apt,90,285,2.85,375
28434,Elizabeth,3,Private room,120,0,0.21,120
28435,Roy,2,Private room,47,0,1.73,47
28436,Martin,2,Private room,75,0,0.05,75
28437,Kristina,2,Private room,80,95,1.28,175
28438,Anne-Laure,2,Private room,110,0,0.05,110
28439,Holyfield,3,Private room,45,328,0.48,373
28441,Virginia,1,Entire home/apt,150,0,0.11,150
28442,Brian,1,Entire home/apt,80,0,0.05,80
28444,Anna,2,Entire home/apt,250,0,0.22,250
28445,Melissa,2,Private room,57,80,2.89,137
28446,Sergii,2,Private room,50,364,0.17,414
28447,Maytal And Ken,2,Entire home/apt,399,308,2.25,707
28448,Klara,1,Entire home/apt,132,12,5.67,144
28449,Sherry,2,Entire home/apt,150,0,1.46,150
28450,Olivia,2,Private room,40,0,0.32,40
28452,Luis,1,Entire home/apt,189,0,0.1,189
28453,R,1,Entire home/apt,400,37,0.88,437
28454,Josh,2,Entire home/apt,65,0,0.05,65
28456,Brian,1,Entire home/apt,250,5,1.1,255
28458,Zanni,2,Private room,51,0,0.1,51
28459,Mario,1,Entire home/apt,299,274,1.57,573
28460,Amy,1,Private room,125,0,0.09,125
28462,Sarah,2,Private room,65,0,0.1,65
28463,Danny,2,Entire home/apt,295,0,0.05,295
28464,Kelvin,1,Private room,60,78,2.11,138
28466,L,2,Entire home/apt,80,0,0.83,80
28467,Luna Maria,2,Private room,75,11,0.39,86
28468,Doron,1,Entire home/apt,91,216,0.47,307
28469,David,2,Private room,30,0,0.15,30
28471,Carrie,2,Entire home/apt,160,2,1.99,162
28472,Malcolm,1,Entire home/apt,400,2,0.05,402
28473,Melinda,1,Private room,100,0,0.47,100
28476,Kathleen,2,Private room,40,0,0.05,40
28477,Michelle,1,Entire home/apt,400,0,0.39,400
28479,Lauren,1,Private room,250,0,0.11,250
28480,Sheena,4,Entire home/apt,100,89,5.1,189
28481,Jeff,4,Private room,55,127,0.76,182
28482,Linda,5,Entire home/apt,65,300,8.43,365
28483,V,3,Private room,425,0,0.58,425
28484,Brian & Jonathan,1,Private room,49,211,0.99,260
28485,Zach,1,Entire home/apt,175,0,0.47,175
28486,Dylan,2,Entire home/apt,129,295,1.03,424
28487,Cory,4,Private room,87,0,0.05,87
28488,Janique,2,Private room,42,0,0.37,42
28489,Sarah,2,Entire home/apt,115,0,0.11,115
28490,Anh,1,Entire home/apt,150,0,0.16,150
28491,Silvio,2,Private room,50,0,0.15,50
28493,Chloe,2,Private room,70,0,0.05,70
28494,Laura,2,Private room,50,358,0.19,408
28495,Isaac,1,Private room,75,0,0.1,75
28497,Jonathan,1,Entire home/apt,143,29,4.9,172
28498,Hannah,1,Entire home/apt,170,0,0.05,170
28501,Melissa,2,Private room,65,289,1.64,354
28502,Theresa,3,Entire home/apt,112,0,0.11,112
28503,Sara,2,Entire home/apt,150,3,0.27,153
28504,Daniel,1,Entire home/apt,200,30,0.26,230
28505,Simone,1,Private room,100,341,0.16,441
28506,Corporate Housing,1,Entire home/apt,142,281,0.42,423
28507,Christine,2,Private room,55,0,1.34,55
28508,Joy,3,Private room,50,348,1.4,398
28510,Elaine,2,Entire home/apt,185,181,4.68,366
28511,Dustin,2,Private room,45,0,0.16,45
28512,Nancy,2,Entire home/apt,160,71,1.95,231
28513,Jamie And John,1,Entire home/apt,179,201,6.51,380
28514,Felicita,3,Private room,55,365,0.49,420
28517,Dee,2,Entire home/apt,22,312,1.83,334
28518,Kaylan,2,Entire home/apt,175,0,0.56,175
28519,Joshua,2,Entire home/apt,225,1,0.86,226
28520,Isaac,1,Private room,99,0,0.1,99
28521,Genevieve,2,Entire home/apt,150,231,2.65,381
28522,Matias,2,Entire home/apt,100,95,0.11,195
28523,John,2,Entire home/apt,88,0,0.21,88
28524,Lalit,3,Private room,29,156,0.59,185
28525,Denis,2,Entire home/apt,400,0,0.05,400
28526,Rasha,2,Entire home/apt,85,2,0.63,87
28529,Adelle,2,Entire home/apt,150,267,2.32,417
28530,Yusra,1,Entire home/apt,70,156,0.38,226
28532,Ler,1,Private room,99,130,0.87,229
28533,Claudia,3,Shared room,45,347,0.53,392
28534,Soumya,1,Entire home/apt,189,0,0.16,189
28535,Daniela,2,Private room,70,0,0.49,70
28536,Miller,2,Private room,27,0,0.23,27
28537,Christina,2,Private room,80,0,0.11,80
28540,Lizzie,1,Entire home/apt,175,0,0.54,175
28541,Tok,2,Private room,35,0,0.21,35
28542,Carmen,2,Private room,41,0,0.05,41
28543,Victor,2,Shared room,50,179,0.42,229
28545,Charlotte,2,Entire home/apt,150,128,0.83,278
28546,Marko,1,Entire home/apt,400,0,0.08,400
28547,Matthew,1,Private room,85,0,0.31,85
28548,Hazel,2,Private room,100,0,0.1,100
28549,Santiago,1,Entire home/apt,150,36,1.08,186
28550,Thelma,5,Entire home/apt,149,354,0.34,503
28551,Mukaram,1,Entire home/apt,210,276,1.68,486
28552,Tyge,1,Entire home/apt,150,109,1.61,259
28554,Allison,2,Entire home/apt,350,275,2.23,625
28555,Nicholas,1,Private room,130,0,1.35,130
28557,Analise,2,Shared room,45,0,0.05,45
28558,Sergio,4,Private room,30,0,0.16,30
28559,Amber,2,Private room,50,53,2.28,103
28560,Janine,2,Private room,50,89,2.26,139
28561,Vera,1,Private room,250,55,0.08,305
28562,Ghazi,1,Entire home/apt,110,0,0.2,110
28563,Sara,3,Entire home/apt,125,62,1.65,187
28567,Uttara,1,Shared room,53,0,0.38,53
28568,Katelyn,2,Private room,55,0,0.99,55
28569,Crina,2,Entire home/apt,647,166,0.25,813
28572,Shahriq And Patty,1,Entire home/apt,485,0,0.05,485
28573,Assaf,2,Entire home/apt,160,83,0.97,243
28574,Scott,1,Entire home/apt,150,353,0.76,503
28575,Marie,1,Entire home/apt,200,63,2.34,263
28576,Giulia,2,Private room,58,0,0.48,58
28577,Alex,1,Entire home/apt,109,4,3.95,113
28578,Leslie,1,Private room,75,7,2.34,82
28579,Kaitlin,1,Private room,50,0,0.05,50
28580,Neide,1,Entire home/apt,215,0,0.11,215
28581,Rashida,1,Entire home/apt,249,293,2.35,542
28583,Stanley,2,Private room,56,348,0.65,404
28585,Ashley,2,Entire home/apt,127,34,0.49,161
28586,Desmond,3,Entire home/apt,83,22,4.05,105
28587,Jermaine,2,Entire home/apt,290,364,0.39,654
28589,Oscar,3,Private room,39,351,2.28,390
28590,Elena,3,Shared room,27,0,0.05,27
28591,Stanley,2,Private room,56,333,0.65,389
28592,Helo.,1,Entire home/apt,200,5,0.34,205
28593,Jose H.,4,Entire home/apt,65,0,2.52,65
28594,Nicole,2,Private room,50,0,0.1,50
28595,Tamer,2,Entire home/apt,195,236,3.51,431
28596,Abee,1,Entire home/apt,625,0,0.59,625
28597,Ava,1,Private room,69,0,0.21,69
28598,Jerry,2,Entire home/apt,125,24,1.67,149
28599,Shawn,2,Entire home/apt,160,0,0.05,160
28600,Michael,1,Entire home/apt,195,217,1.27,412
28601,Rob,2,Entire home/apt,250,0,0.05,250
28602,Christopher,1,Entire home/apt,125,0,0.26,125
28603,Conor,2,Private room,100,0,0.06,100
28604,Geoff,2,Entire home/apt,180,15,0.99,195
28605,Emily,1,Entire home/apt,175,0,0.18,175
28606,Arielle,2,Private room,90,0,0.33,90
28607,Rachel,1,Private room,50,20,3.54,70
28608,Mukaram,1,Entire home/apt,200,251,1.73,451
28609,Sheila,2,Entire home/apt,90,3,0.59,93
28610,Mama Batata,2,Private room,70,8,4.58,78
28611,Carolyn,2,Entire home/apt,115,0,0.22,115
28612,Charlotte,1,Private room,75,0,0.96,75
28613,Emily,1,Entire home/apt,190,363,0.63,553
28614,Emily,1,Entire home/apt,200,0,0.11,200
28615,Janine,2,Private room,125,89,0.68,214
28616,June,2,Private room,33,32,1.53,65
28617,Erin,2,Entire home/apt,130,0,0.82,130
28618,Justin,1,Entire home/apt,149,0,0.32,149
28619,Lev,1,Entire home/apt,195,0,0.11,195
28621,Marco,2,Shared room,40,299,0.39,339
28622,Kyle,2,Private room,28,0,0.05,28
28624,Annette,2,Entire home/apt,68,179,3.33,247
28625,Myles,2,Entire home/apt,150,128,3.1,278
28627,Lilia,1,Entire home/apt,260,259,4.59,519
28628,Xavier,1,Private room,79,51,3.28,130
28629,Silvia,1,Entire home/apt,130,354,1.76,484
28630,Nata,1,Entire home/apt,90,83,1.1,173
28631,Min,1,Entire home/apt,250,0,0.05,250
28633,Chad Antonio,2,Entire home/apt,55,57,3.02,112
28634,Niki,3,Entire home/apt,280,307,3.68,587
28635,Guy,2,Private room,43,0,0.16,43
28636,Jessica,1,Entire home/apt,200,0,0.73,200
28637,Edmarine,3,Private room,41,0,0.11,41
28638,Laura,2,Entire home/apt,89,25,0.77,114
28639,Bibi,2,Private room,50,0,0.8,50
28641,Alena,2,Private room,42,80,4.9,122
28642,Caroline & Adriaan,2,Private room,85,127,2.12,212
28643,Jammie,2,Private room,45,0,1.63,45
28644,Xavier,1,Shared room,39,0,0.36,39
28645,Stanley,2,Private room,56,321,0.81,377
28646,Agustin,1,Entire home/apt,295,0,0.11,295
28647,Nelson,3,Entire home/apt,110,0,0.37,110
28648,Erica,1,Entire home/apt,170,0,0.65,170
28649,Eric,1,Entire home/apt,90,1,1.69,91
28650,Hugo B.,2,Private room,40,0,0.21,40
28651,Nalicia,3,Private room,50,25,17.82,75
28654,Alba,3,Private room,100,95,1.23,195
28655,Brittney,2,Private room,25,174,0.37,199
28656,Journey,3,Entire home/apt,135,138,6.8,273
28657,Jessamine,2,Entire home/apt,120,89,0.16,209
28658,Andy,4,Entire home/apt,200,326,4.76,526
28659,Susana,2,Private room,35,292,0.28,327
28660,Natalia,1,Private room,70,0,0.05,70
28661,Brennan,2,Private room,99,155,2.47,254
28662,Tori,2,Private room,75,0,0.11,75
28663,Sechul,1,Private room,150,14,7.19,164
28664,Jason,1,Private room,220,0,0.05,220
28665,Eli,2,Entire home/apt,175,0,0.11,175
28667,Sylvia,2,Entire home/apt,120,1,0.25,121
28668,Peter,1,Entire home/apt,320,0,0.22,320
28669,Pierre,2,Entire home/apt,250,0,0.14,250
28670,Vicente,1,Private room,199,0,0.48,199
28671,Cody,2,Entire home/apt,105,0,0.11,105
28672,Michael,2,Entire home/apt,110,0,0.11,110
28674,Miguel,3,Entire home/apt,80,340,0.05,420
28675,Jessie,3,Private room,59,35,0.9,94
28678,Abhishek,1,Private room,85,86,0.27,171
28679,Kenneth,2,Entire home/apt,150,0,0.05,150
28680,Jessica,2,Entire home/apt,180,0,0.16,180
28681,Danyelle,1,Private room,75,0,0.05,75
28682,Liza,1,Entire home/apt,229,206,0.11,435
28683,Christian,3,Private room,50,359,1.96,409
28684,Nona,1,Entire home/apt,248,0,0.11,248
28685,Stacy,1,Private room,299,0,0.21,299
28686,Rahel,1,Private room,67,3,0.42,70
28687,Sarah,1,Entire home/apt,150,0,0.35,150
28688,Steph,1,Entire home/apt,200,59,4.36,259
28689,Kendrick,1,Entire home/apt,277,75,3.66,352
28690,Jammie,2,Entire home/apt,99,14,2.05,113
28692,Annalise,2,Private room,80,0,0.28,80
28693,Liana,1,Entire home/apt,500,173,0.27,673
28694,Sabrina,2,Private room,175,0,0.11,175
28695,Suah,3,Entire home/apt,150,0,0.16,150
28698,ChaYa LoVe,2,Entire home/apt,320,312,4.16,632
28699,Emee,2,Entire home/apt,125,16,0.37,141
28700,Estefani,3,Private room,31,0,0.05,31
28701,Bulent,2,Entire home/apt,189,70,1.14,259
28702,Lauren,1,Private room,200,0,0.05,200
28703,Christine,2,Entire home/apt,120,86,2.89,206
28704,Spencer,1,Entire home/apt,150,0,0.65,150
28705,Abhi,3,Entire home/apt,70,0,0.05,70
28707,Hillai,2,Private room,38,0,0.08,38
28708,Steve & Irina,3,Entire home/apt,135,365,1.46,500
28710,Jessica,2,Private room,50,0,0.11,50
28712,Mar,1,Private room,50,63,0.8,113
28713,Mia,1,Entire home/apt,110,12,1.55,122
28714,Mariam,1,Shared room,70,0,0.05,70
28715,Casey,2,Entire home/apt,140,67,1.67,207
28716,Stanley,2,Entire home/apt,149,308,1.47,457
28717,Hazel,2,Private room,100,0,0.16,100
28720,Faziah,2,Private room,40,0,0.32,40
28721,Isaac,1,Entire home/apt,220,0,0.16,220
28722,Sonia,3,Private room,25,258,6.18,283
28723,Ben,2,Private room,39,0,0.05,39
28724,Grace,1,Entire home/apt,350,0,0.05,350
28725,Vanessa,1,Entire home/apt,90,5,0.22,95
28726,Brad,2,Private room,30,0,0.21,30
28728,Ahmed,3,Entire home/apt,359,281,0.66,640
28729,Jean,2,Private room,65,0,3.15,65
28730,David,2,Entire home/apt,109,0,0.31,109
28731,Nicole,2,Private room,70,0,0.16,70
28732,Kaitlin,1,Private room,75,0,0.05,75
28734,Laureta,3,Private room,40,123,1.75,163
28735,Olya,2,Private room,98,73,1.4,171
28736,Richie,1,Entire home/apt,110,0,0.11,110
28740,O. Xavier,2,Private room,85,333,3.18,418
28741,Courtney,1,Entire home/apt,300,0,0.06,300
28743,Farideh,2,Entire home/apt,100,9,0.64,109
28746,Colette,1,Entire home/apt,91,0,0.05,91
28747,Gary,3,Entire home/apt,59,147,5.92,206
28748,Brandon,2,Private room,74,0,0.12,74
28749,Saarthak,1,Private room,33,0,0.16,33
28750,Dee,1,Private room,42,0,0.11,42
28751,Aissa,1,Entire home/apt,75,0,0.28,75
28753,Miller,2,Private room,39,0,0.5,39
28755,Cecile,1,Entire home/apt,225,343,0.09,568
28757,Michael,2,Entire home/apt,66,219,3.3,285
28758,J C,2,Private room,50,354,1.3,404
28759,Sergii,2,Shared room,32,365,0.17,397
28760,Sergii,2,Private room,50,325,0.21,375
28762,Bruna,1,Entire home/apt,250,38,1.58,288
28763,Amira,2,Entire home/apt,95,0,0.21,95
28764,Rita,1,Entire home/apt,80,31,0.1,111
28766,Keren & Mikey,2,Entire home/apt,220,67,5.02,287
28767,Chris,1,Private room,105,89,0.11,194
28768,Hugh,1,Private room,199,80,4.04,279
28769,Yu,2,Private room,53,0,0.05,53
28770,Victor,3,Entire home/apt,125,69,0.33,194
28771,Andrew,1,Entire home/apt,400,64,0.56,464
28772,Sam,2,Private room,70,0,0.11,70
28773,Gabriela,3,Private room,50,7,3.36,57
28774,Julian,1,Private room,20,0,0.48,20
28775,Emily & Joseph,2,Entire home/apt,300,279,2.27,579
28776,Patricia,2,Entire home/apt,89,30,1.14,119
28777,Nebojsa,2,Private room,59,14,2.23,73
28778,Adam,1,Entire home/apt,221,1,0.38,222
28779,Mercedes,2,Private room,100,365,0.06,465
28780,Michael,1,Private room,69,0,3.78,69
28781,Cindy,3,Entire home/apt,150,317,4.38,467
28782,Devin,2,Private room,275,72,0.92,347
28783,Atthaphon,2,Private room,55,279,3.67,334
28784,Atthaphon,2,Private room,65,282,1.68,347
28785,Ryder,1,Entire home/apt,250,0,0.1,250
28787,Natasha,1,Entire home/apt,135,75,1.13,210
28788,Bradley,2,Entire home/apt,90,5,0.7,95
28793,Darwin,1,Private room,75,0,0.11,75
28794,James,1,Entire home/apt,225,0,0.08,225
28795,Axelle,1,Private room,34,0,0.21,34
28796,Deborah,3,Shared room,19,138,1.4,157
28797,Sergii,2,Shared room,35,327,0.22,362
28800,Carlos,1,Entire home/apt,249,0,0.16,249
28801,Anna,1,Private room,115,312,8.68,427
28803,Anna,1,Private room,105,321,7.39,426
28804,Diane,2,Entire home/apt,69,3,2.0,72
28805,Sean,1,Private room,79,0,0.05,79
28806,Augustine,2,Private room,100,0,0.3,100
28807,Gabriel,2,Private room,80,0,0.21,80
28809,Grey,2,Entire home/apt,92,0,0.11,92
28810,Heather,2,Entire home/apt,100,88,3.05,188
28814,Yola,3,Private room,35,0,0.83,35
28816,Ben,2,Private room,70,0,0.16,70
28818,Alexandra,1,Entire home/apt,237,0,0.45,237
28819,Imani,2,Private room,30,0,0.38,30
28820,Michael,1,Entire home/apt,250,0,0.05,250
28823,Stella,1,Entire home/apt,210,0,0.11,210
28824,Andrey,3,Private room,50,179,0.11,229
28825,Camila,2,Private room,75,0,0.16,75
28826,Alicia,2,Private room,65,0,0.16,65
28827,Adetoro,2,Entire home/apt,85,0,0.14,85
28829,Benny,1,Entire home/apt,290,0,0.63,290
28830,Cristian,1,Entire home/apt,165,0,0.05,165
28831,Ben,1,Private room,180,0,0.06,180
28832,Finnían,2,Private room,40,0,0.11,40
28833,Hugh,1,Entire home/apt,325,141,1.84,466
28834,Andrei,2,Entire home/apt,190,239,2.97,429
28835,Lawrence,3,Private room,90,0,0.05,90
28836,Calvin,1,Private room,70,0,0.42,70
28837,Shawn,1,Entire home/apt,167,0,0.16,167
28838,Susana,2,Private room,33,354,0.1,387
28839,Valentin,3,Shared room,33,7,0.05,40
28840,Dina,1,Entire home/apt,151,72,0.97,223
28841,Sergii,2,Shared room,15,344,0.16,359
28842,Timothy,2,Private room,72,112,1.21,184
28843,Salma,1,Private room,150,0,0.11,150
28844,Marie,2,Entire home/apt,145,146,3.63,291
28847,Andrew,2,Private room,48,0,0.05,48
28848,Dan,2,Private room,50,0,0.85,50
28849,Alvina Da Silva,4,Private room,30,90,0.11,120
28850,Inna,1,Entire home/apt,125,284,0.09,409
28851,Sylvain,3,Entire home/apt,81,6,0.32,87
28852,Megan,1,Entire home/apt,115,3,1.21,118
28854,Luis,1,Private room,128,0,0.36,128
28855,Anda,1,Private room,65,107,1.51,172
28856,Henry,2,Private room,80,0,0.05,80
28857,Hafou,1,Entire home/apt,135,66,3.11,201
28858,Stephanie,1,Entire home/apt,3000,325,1.0,3325
28859,Panos,1,Entire home/apt,240,216,0.54,456
28861,Timothy,2,Private room,100,0,0.16,100
28862,Izi,1,Entire home/apt,150,155,0.31,305
28863,Joanna,1,Private room,65,0,0.37,65
28864,Izi,1,Entire home/apt,150,140,0.29,290
28865,Marco,1,Entire home/apt,180,0,0.26,180
28866,Andrew,1,Private room,50,34,1.15,84
28867,Alyson,1,Entire home/apt,329,89,0.06,418
28869,Bobby,2,Private room,54,0,0.22,54
28870,Samantha,4,Private room,50,0,0.21,50
28871,Sophia,2,Entire home/apt,63,281,0.26,344
28872,Edward,2,Entire home/apt,150,0,2.78,150
28873,Darlene,1,Private room,43,6,0.72,49
28874,Katarina,2,Entire home/apt,145,0,0.32,145
28876,Jeremy,2,Private room,60,0,0.05,60
28877,Devito,1,Private room,85,75,0.82,160
28878,Sophia,1,Entire home/apt,149,38,0.42,187
28879,Joo,1,Private room,69,4,7.64,73
28882,Dorothy,3,Private room,150,72,0.92,222
28883,Martin,1,Entire home/apt,350,0,0.18,350
28884,Mathew,2,Private room,90,0,0.87,90
28885,Berk,1,Entire home/apt,140,190,0.22,330
28886,Dorota,3,Private room,80,68,2.08,148
28887,Biggi,1,Private room,129,0,1.73,129
28888,Tamar,1,Entire home/apt,60,0,0.59,60
28890,Rosa,5,Private room,75,207,0.53,282
28891,Catiana,2,Private room,150,179,0.32,329
28892,Karly,2,Private room,45,0,0.05,45
28893,Katie,2,Entire home/apt,64,0,0.21,64
28895,Bethany,1,Entire home/apt,135,0,0.05,135
28896,Lee,2,Private room,100,0,0.53,100
28897,Cr,1,Shared room,30,0,0.06,30
28898,Cj,2,Entire home/apt,110,0,1.53,110
28899,Ri.,1,Private room,200,8,2.33,208
28900,Eugene,1,Private room,200,1,1.84,201
28901,Alexander,2,Private room,30,0,2.58,30
28902,Storm,1,Private room,65,0,0.33,65
28903,Will,2,Entire home/apt,100,108,1.35,208
28904,Kevin,1,Entire home/apt,109,0,1.46,109
28906,Karina,2,Private room,70,0,0.16,70
28907,MaTT,1,Private room,70,42,0.17,112
28909,Eugene,1,Private room,100,0,2.43,100
28910,Shelley,3,Private room,83,361,1.35,444
28911,Omowumi,2,Entire home/apt,169,196,1.36,365
28912,Andres,3,Private room,50,365,0.11,415
28913,Nat,2,Private room,55,74,1.03,129
28914,Nate,2,Private room,65,319,1.25,384
28915,Alexandra,1,Entire home/apt,110,9,3.64,119
28916,Harutoshi,1,Entire home/apt,285,0,0.05,285
28917,Aurora,1,Entire home/apt,180,0,1.79,180
28918,Xavier,1,Private room,69,0,2.91,69
28919,Julia,1,Entire home/apt,199,177,0.08,376
28920,Osei,2,Entire home/apt,95,73,4.79,168
28922,Abhi,1,Private room,99,0,0.05,99
28923,Wenqin,3,Private room,79,320,1.71,399
28924,Ken,1,Entire home/apt,225,11,2.2,236
28925,Etienne,2,Entire home/apt,149,29,0.86,178
28926,Hannah,2,Private room,60,0,0.06,60
28927,Glenn,2,Private room,85,11,0.73,96
28928,Masha,1,Entire home/apt,130,21,4.16,151
28929,Mrs.,2,Entire home/apt,150,335,2.96,485
28930,Hector,3,Private room,75,0,0.22,75
28931,Amira,1,Entire home/apt,150,0,0.11,150
28932,Diana,3,Private room,60,0,0.11,60
28933,Renata,1,Private room,80,102,3.65,182
28934,Nicole,1,Entire home/apt,220,0,0.81,220
28936,Yaacov,1,Entire home/apt,245,342,0.29,587
28938,Yaacov,1,Entire home/apt,135,338,0.11,473
28939,Christine,2,Private room,190,354,3.08,544
28940,Nicola,2,Entire home/apt,100,281,1.57,381
28941,Rahul,1,Private room,80,0,0.11,80
28942,Natia,2,Entire home/apt,200,0,0.26,200
28943,Cami,1,Entire home/apt,150,0,0.9,150
28944,Cristina,3,Entire home/apt,120,27,4.31,147
28948,Will,2,Entire home/apt,117,0,0.05,117
28949,Marie,2,Entire home/apt,125,142,3.65,267
28950,Bonny,2,Private room,70,8,0.98,78
28952,Cynthia,1,Entire home/apt,1046,365,0.54,1411
28954,Simone,1,Entire home/apt,152,0,0.21,152
28955,Jaqui And Mark,2,Entire home/apt,65,53,3.07,118
28956,Sky,2,Private room,195,165,3.93,360
28958,Alice,2,Entire home/apt,225,59,3.08,284
28959,Elma,2,Private room,57,77,0.11,134
28960,Erika,3,Entire home/apt,160,0,0.11,160
28962,Theresa,2,Private room,29,0,0.38,29
28964,Jacob,2,Entire home/apt,149,309,4.48,458
28966,Isaac And Izzy,2,Private room,45,0,0.05,45
28967,Juliana,1,Entire home/apt,162,0,0.49,162
28968,Bartolomeo,2,Entire home/apt,50,0,0.11,50
28970,Brian & Akiko,3,Entire home/apt,110,0,0.16,110
28971,Margaret,1,Entire home/apt,90,0,0.17,90
28972,Joseph,2,Entire home/apt,38,0,0.27,38
28973,Diego,2,Entire home/apt,59,35,2.33,94
28974,Rachel,1,Entire home/apt,105,0,0.21,105
28975,Juno,1,Entire home/apt,210,0,0.05,210
28977,Alex,2,Private room,250,0,0.43,250
28980,Meryl,1,Entire home/apt,150,0,0.05,150
28982,Julio,1,Shared room,42,1,3.02,43
28983,Md,3,Entire home/apt,125,348,4.5,473
28987,David,2,Private room,59,39,2.88,98
28988,Raquel,1,Entire home/apt,199,349,0.82,548
28989,Norman,1,Private room,84,20,6.44,104
28990,Ilse,1,Entire home/apt,80,0,0.05,80
28991,Larasati,1,Private room,70,0,0.11,70
28992,Kwame,2,Entire home/apt,90,0,0.84,90
28994,Carol,1,Entire home/apt,150,0,0.05,150
28995,Ariel,1,Private room,87,0,0.13,87
28996,Pedro,1,Entire home/apt,140,0,0.05,140
28997,Manca,3,Private room,49,0,0.55,49
28998,Pema,3,Entire home/apt,105,314,3.6,419
28999,Stefanie,2,Entire home/apt,60,0,0.05,60
29001,Anda,1,Private room,65,153,0.94,218
29002,Flávio,2,Entire home/apt,150,0,0.77,150
29003,Alexandra,2,Entire home/apt,125,14,1.1,139
29004,Gorm,1,Private room,41,0,0.16,41
29006,Mona,1,Entire home/apt,249,175,0.48,424
29008,Myriam,3,Private room,45,81,7.47,126
29009,Gina,1,Private room,150,68,1.49,218
29011,Kathleen,2,Entire home/apt,170,0,0.05,170
29012,Sohel,1,Entire home/apt,299,0,0.16,299
29013,Liz,2,Private room,55,66,0.81,121
29014,Crispy,3,Private room,45,320,0.99,365
29015,Joao,2,Private room,49,115,1.41,164
29016,V,3,Private room,475,0,0.37,475
29017,Shemel,1,Private room,34,0,0.05,34
29018,Sivan,2,Entire home/apt,129,0,0.16,129
29019,Scarlet,1,Private room,75,0,0.22,75
29020,Lina,2,Private room,95,23,0.11,118
29021,Eric,1,Entire home/apt,180,61,2.58,241
29022,Pierre,2,Private room,100,0,0.55,100
29025,Cassi,2,Private room,100,163,0.27,263
29026,Tina,2,Entire home/apt,112,151,3.33,263
29027,Jimmy,4,Private room,125,0,1.34,125
29028,Stephen,2,Entire home/apt,102,0,0.33,102
29030,Miao,2,Private room,65,0,2.2,65
29031,Morgan,1,Entire home/apt,100,0,0.16,100
29032,Alexandre,3,Entire home/apt,80,1,0.21,81
29033,Rob,1,Entire home/apt,200,3,0.5,203
29034,Mike,1,Entire home/apt,100,271,0.45,371
29037,Elsie,2,Private room,45,322,0.9,367
29039,Brad,2,Shared room,50,0,0.81,50
29040,Elsie,2,Private room,60,362,2.46,422
29041,Daphne,1,Private room,90,0,0.05,90
29042,Maxwell,2,Entire home/apt,110,0,0.17,110
29043,Kaj,1,Private room,65,144,0.71,209
29045,Elsie,2,Private room,75,360,2.65,435
29046,Elsie,2,Private room,64,352,2.67,416
29047,Blandine,2,Entire home/apt,120,346,4.43,466
29048,Garrett,1,Private room,95,0,0.7,95
29049,Elsie,2,Private room,67,359,1.55,426
29050,Joe,1,Private room,60,0,0.3,60
29051,Izi,1,Entire home/apt,150,147,0.25,297
29052,Lou,2,Entire home/apt,175,288,3.0,463
29053,Karan,1,Entire home/apt,220,0,0.05,220
29054,Mara,1,Entire home/apt,365,65,0.71,430
29056,Christian,3,Private room,59,348,1.53,407
29057,Dolores,2,Private room,121,91,0.44,212
29059,Antoine,2,Private room,32,0,0.06,32
29061,Miss. G.,3,Private room,50,301,2.04,351
29062,KerryAnna,3,Entire home/apt,95,190,2.53,285
29063,Ervita,2,Private room,75,265,3.26,340
29065,Mike,1,Entire home/apt,191,0,0.05,191
29066,James Nathan,2,Private room,125,0,0.49,125
29067,Nicolas,2,Private room,55,90,0.27,145
29068,Lance,2,Entire home/apt,110,50,2.37,160
29069,Henry,2,Entire home/apt,250,79,5.04,329
29071,Virginia,2,Private room,45,0,0.12,45
29073,Stephanie,2,Entire home/apt,125,264,1.3,389
29074,Sarah & Burak,1,Entire home/apt,185,120,4.88,305
29075,Alice,2,Entire home/apt,104,166,1.69,270
29076,Giuseppe,2,Private room,45,0,0.43,45
29077,Mairo,3,Entire home/apt,135,83,2.37,218
29078,Juliana,2,Private room,55,0,0.27,55
29079,Christian,3,Private room,79,151,3.3,230
29080,Valentin,3,Shared room,27,6,0.27,33
29081,Any,3,Private room,75,344,2.09,419
29082,Malik,2,Entire home/apt,135,36,1.42,171
29083,Juan,1,Entire home/apt,110,0,0.05,110
29084,Johnny,2,Entire home/apt,200,362,2.44,562
29086,Gabe,1,Private room,60,0,0.15,60
29087,Farid,1,Entire home/apt,175,0,0.16,175
29088,Blair,1,Entire home/apt,190,187,5.18,377
29090,Stanley,1,Entire home/apt,111,317,0.32,428
29091,Nick,1,Private room,130,0,0.13,130
29093,Akemi,1,Private room,44,0,0.05,44
29095,Frida,2,Entire home/apt,70,0,0.11,70
29096,Chemme,1,Private room,140,355,1.3,495
29097,Timo,2,Entire home/apt,80,4,4.71,84
29098,Kaitlin,2,Entire home/apt,179,35,0.71,214
29099,Julian,1,Private room,47,0,0.17,47
29100,Lee,1,Entire home/apt,160,0,0.06,160
29102,Glen,1,Entire home/apt,110,265,1.62,375
29103,Ted,2,Entire home/apt,250,69,5.5,319
29104,Joyce,1,Entire home/apt,400,69,1.88,469
29105,Rebecca,2,Private room,70,0,0.05,70
29108,Jen,2,Entire home/apt,350,0,0.11,350
29110,Juan,1,Entire home/apt,275,364,0.27,639
29111,Laura,1,Entire home/apt,90,0,0.98,90
29112,Hans,1,Entire home/apt,159,0,0.16,159
29113,Calisa,2,Entire home/apt,80,77,7.65,157
29114,Trisha,2,Private room,45,0,0.05,45
29115,Andrea,1,Private room,65,0,0.05,65
29116,N,2,Entire home/apt,118,249,1.32,367
29117,Emily,3,Entire home/apt,60,117,1.89,177
29118,Cynthia,3,Entire home/apt,57,57,5.04,114
29119,Vlada,2,Shared room,32,0,0.15,32
29120,Alexander,2,Shared room,29,334,0.14,363
29123,Dmitriy,2,Entire home/apt,126,0,0.49,126
29125,Jeffrey,1,Private room,120,277,3.73,397
29126,Shonelle,2,Entire home/apt,64,268,0.15,332
29127,Deundre,1,Private room,78,0,1.94,78
29128,Blueground,1,Entire home/apt,271,310,0.09,581
29129,Enrique,2,Private room,78,0,0.22,78
29131,Lewi,2,Private room,38,0,0.11,38
29132,Sheyla,2,Entire home/apt,140,0,0.54,140
29133,Cory,4,Private room,187,76,0.22,263
29134,Sneha,2,Entire home/apt,300,179,1.52,479
29135,Javier,1,Private room,100,13,1.2,113
29136,Jean,2,Entire home/apt,117,328,1.3,445
29138,Alberto,1,Entire home/apt,158,0,0.12,158
29140,Stacy,2,Private room,60,0,0.11,60
29141,Tanya,2,Entire home/apt,95,28,2.04,123
29142,Aracelis,2,Entire home/apt,160,272,1.84,432
29143,Lily-Thuy,2,Entire home/apt,109,156,1.85,265
29144,Alexis,1,Private room,160,49,5.73,209
29145,Nanda,1,Entire home/apt,330,5,0.48,335
29146,Wynne,3,Private room,50,0,0.11,50
29147,筱,3,Private room,50,211,0.53,261
29148,Jiyoung,2,Private room,23,0,0.11,23
29149,Sophie,2,Private room,68,0,2.59,68
29150,Concetta,3,Private room,36,250,0.27,286
29151,Michael,1,Entire home/apt,190,0,0.12,190
29152,Yoo MI,2,Private room,140,79,1.03,219
29153,Vanessa,1,Private room,185,8,0.27,193
29154,Elisabeth,1,Private room,50,31,0.66,81
29155,Sydney,2,Private room,45,76,0.7,121
29156,Francis,2,Private room,35,76,0.44,111
29157,Ahlem,1,Entire home/apt,110,67,3.93,177
29158,Jesus,4,Entire home/apt,140,310,5.7,450
29159,George,2,Entire home/apt,120,57,0.05,177
29160,Andrea & James,2,Entire home/apt,125,41,2.77,166
29164,Yves,3,Private room,68,51,2.84,119
29165,B,1,Entire home/apt,199,17,0.65,216
29166,Natalie,1,Entire home/apt,450,83,0.65,533
29167,Yves,3,Private room,76,76,3.15,152
29168,Brianna,1,Shared room,39,324,0.49,363
29169,Marlee,2,Private room,48,3,1.51,51
29171,Tatiana,2,Entire home/apt,175,0,0.85,175
29172,Athina,2,Entire home/apt,120,0,0.16,120
29173,Sean,1,Private room,100,0,1.8,100
29174,Amy,2,Private room,50,0,0.11,50
29175,Brandon,1,Private room,90,0,0.07,90
29177,John,3,Private room,40,313,0.38,353
29178,Mandela,4,Entire home/apt,60,365,5.61,425
29179,Gabriela,2,Private room,53,151,1.29,204
29180,Gabriela,2,Private room,120,150,1.05,270
29181,Johan,3,Entire home/apt,150,324,2.74,474
29182,Isabella,1,Entire home/apt,115,0,0.05,115
29183,Gabriela,2,Private room,59,132,1.23,191
29184,Judith,2,Entire home/apt,99,254,3.55,353
29185,Eric,1,Entire home/apt,89,0,0.06,89
29186,Candice,1,Private room,47,0,0.11,47
29187,JoAnn,2,Entire home/apt,149,3,1.42,152
29188,James,1,Private room,159,242,2.46,401
29189,Asya,1,Entire home/apt,90,25,2.05,115
29190,Matilda,1,Private room,80,0,0.38,80
29191,Wynne,3,Private room,50,1,0.85,51
29192,Patricia,1,Private room,60,0,0.54,60
29194,Miss. G.,3,Private room,37,310,0.83,347
29195,Mohamad,2,Private room,58,0,0.05,58
29196,Zack,2,Private room,70,0,0.51,70
29197,Gareth,2,Entire home/apt,280,0,0.38,280
29199,Alejandro,2,Entire home/apt,349,363,1.03,712
29200,Zeleke,1,Entire home/apt,120,55,4.96,175
29201,Jarryd,2,Private room,40,0,0.05,40
29203,Victoria,1,Entire home/apt,250,0,0.05,250
29204,Renata,2,Private room,80,0,0.27,80
29205,Eve,2,Private room,80,13,1.67,93
29206,Rajan,1,Entire home/apt,300,0,0.32,300
29207,Omur,3,Shared room,40,0,0.11,40
29208,Bianca,1,Private room,119,54,2.26,173
29209,Austin,1,Private room,110,0,0.27,110
29210,Chris,2,Entire home/apt,110,13,0.83,123
29211,Annamaria,1,Entire home/apt,499,1,1.27,500
29212,Dorothy,3,Private room,99,93,1.25,192
29213,Annamaria,1,Entire home/apt,499,298,0.78,797
29214,Marcia,5,Private room,40,36,0.92,76
29215,Wassym,2,Private room,50,0,0.11,50
29216,Suhel,3,Entire home/apt,130,279,5.01,409
29217,Simon,3,Entire home/apt,175,0,0.56,175
29218,Charles,3,Private room,60,0,0.22,60
29219,Miss. G.,3,Private room,60,173,1.41,233
29220,Vivian,1,Private room,92,25,5.67,117
29221,Bryan And Candace,2,Shared room,30,0,0.05,30
29222,Freehand,1,Private room,129,364,2.8,493
29223,Mamiko,2,Private room,34,5,2.36,39
29224,Shek,1,Private room,95,146,0.44,241
29225,Alex,2,Private room,125,4,0.16,129
29226,Garret,1,Private room,65,180,0.76,245
29228,Noni,1,Entire home/apt,225,14,1.72,239
29229,Scotty,1,Private room,68,54,0.39,122
29230,Sophia,2,Entire home/apt,65,0,0.05,65
29231,Diane And Craig,1,Entire home/apt,180,235,1.79,415
29232,Nayely,3,Private room,110,0,0.05,110
29233,Stacy,2,Private room,150,0,0.16,150
29235,Tara,2,Entire home/apt,108,98,0.31,206
29236,Mamadou,1,Private room,68,53,1.75,121
29240,Sasha,2,Entire home/apt,150,0,0.56,150
29241,Saim,1,Entire home/apt,165,0,0.11,165
29242,Robert,1,Private room,125,365,0.38,490
29243,Corporate Housing,1,Entire home/apt,150,251,0.87,401
29244,Melody,2,Entire home/apt,60,0,0.51,60
29246,Atthaphon,2,Private room,50,281,2.97,331
29247,Pete,1,Entire home/apt,199,10,1.14,209
29248,Janae,2,Private room,48,0,0.11,48
29250,Jasmine,1,Private room,109,0,0.06,109
29251,Ava,1,Private room,80,45,3.64,125
29252,Jasmine,1,Private room,109,0,0.06,109
29253,Janelle,2,Entire home/apt,139,57,1.08,196
29254,Mamiko,2,Private room,39,32,3.16,71
29255,Ivan,2,Private room,80,0,0.05,80
29256,Cindy,2,Entire home/apt,225,71,3.12,296
29257,Marlice,2,Private room,55,329,3.4,384
29258,Jay,5,Entire home/apt,99,364,0.36,463
29259,Eduardo,1,Entire home/apt,145,3,1.37,148
29260,Michael,2,Entire home/apt,75,267,4.91,342
29261,Hamza,2,Private room,85,0,1.86,85
29262,Jenni,2,Entire home/apt,150,85,3.42,235
29263,Alyse,1,Entire home/apt,150,0,1.79,150
29264,Simone,3,Private room,70,357,4.96,427
29265,Tommy,1,Private room,150,149,1.68,299
29266,Nate,2,Entire home/apt,140,0,0.17,140
29267,Derek,1,Entire home/apt,160,0,0.17,160
29268,Charles,1,Private room,78,219,0.45,297
29270,Michael,1,Entire home/apt,225,0,0.27,225
29272,Deo,1,Entire home/apt,220,280,0.17,500
29273,Kate,1,Private room,90,41,7.79,131
29274,Freddy,3,Private room,40,37,0.21,77
29276,Brent,2,Private room,40,0,0.6,40
29277,Karen,1,Entire home/apt,240,199,0.45,439
29278,Sajee,1,Entire home/apt,150,0,0.11,150
29279,Nima,2,Entire home/apt,170,190,1.42,360
29280,Chris,2,Private room,35,19,11.17,54
29281,Karen,1,Entire home/apt,250,264,0.37,514
29282,Brendan,2,Entire home/apt,399,272,1.13,671
29283,Michael,1,Entire home/apt,210,0,0.49,210
29284,Karen,1,Entire home/apt,220,298,0.16,518
29286,Karen,1,Entire home/apt,170,281,0.3,451
29287,Jaritza,2,Private room,90,280,0.08,370
29288,Zhanna,1,Entire home/apt,80,0,0.28,80
29289,Erica,1,Entire home/apt,96,0,0.73,96
29290,Myriam,3,Private room,59,80,6.94,139
29291,Sabrina,2,Private room,80,0,0.23,80
29293,Nitika,2,Entire home/apt,100,0,0.27,100
29294,Matthew,2,Private room,100,364,0.98,464
29296,Mayo,3,Entire home/apt,80,288,4.47,368
29297,Yaacov,1,Entire home/apt,235,327,0.4,562
29298,Cristiano,2,Private room,55,58,3.25,113
29299,Nl,1,Entire home/apt,140,242,3.03,382
29300,Megan,2,Entire home/apt,260,46,2.94,306
29301,Allison,1,Private room,200,0,0.05,200
29302,Lizette,2,Private room,80,0,1.14,80
29303,Asha,2,Private room,78,342,1.35,420
29304,Alberto,1,Entire home/apt,208,155,0.17,363
29306,Meryem,2,Private room,85,0,0.33,85
29307,Jessy,1,Entire home/apt,250,283,4.78,533
29308,Carmen,2,Entire home/apt,28,0,0.72,28
29309,Nicholas,1,Private room,101,2,0.22,103
29311,Fabiola,2,Entire home/apt,100,5,3.74,105
29312,J-,2,Private room,79,125,1.22,204
29313,Jeffrey,2,Entire home/apt,190,299,2.42,489
29314,Erick,3,Private room,30,0,0.38,30
29315,J-,2,Private room,69,139,1.21,208
29316,Aendel,3,Private room,44,32,4.27,76
29317,Becky,2,Private room,45,0,0.17,45
29318,Giovanni,2,Private room,70,0,0.23,70
29319,Eugene,1,Private room,85,0,2.77,85
29320,Eliahu,1,Entire home/apt,140,281,2.51,421
29321,Eliahu,1,Entire home/apt,140,354,0.53,494
29323,Philippe,2,Entire home/apt,400,327,0.55,727
29324,Sydney,2,Private room,50,153,0.44,203
29325,Aaron,2,Private room,35,35,1.5,70
29326,Eliahu,1,Entire home/apt,140,330,1.67,470
29327,Indhira & Alex,1,Private room,75,24,2.17,99
29328,Ella,4,Entire home/apt,140,73,3.58,213
29329,Noel,1,Entire home/apt,125,19,1.77,144
29330,Mark,1,Entire home/apt,125,53,5.95,178
29331,Carlina,1,Private room,60,132,2.24,192
29332,Lina,1,Entire home/apt,80,0,0.05,80
29335,Conor,1,Private room,60,0,0.05,60
29336,Jonathan,1,Entire home/apt,350,5,0.05,355
29338,Scarlett,2,Private room,42,0,0.54,42
29339,Sophia,2,Entire home/apt,60,299,0.28,359
29341,Dana,1,Entire home/apt,95,78,0.2,173
29343,Maria,2,Private room,40,317,0.44,357
29345,Karen,1,Private room,45,0,0.07,45
29346,Rocio,4,Private room,26,303,1.39,329
29347,Reuben,5,Entire home/apt,95,178,1.47,273
29350,Elena,2,Private room,75,280,1.08,355
29352,Bobi,1,Private room,50,365,0.81,415
29353,Kumar,1,Entire home/apt,105,238,6.08,343
29354,Stephen,1,Entire home/apt,149,0,0.06,149
29356,Alan,1,Entire home/apt,100,12,0.56,112
29357,Brady,2,Private room,89,11,5.1,100
29358,Conor,2,Entire home/apt,80,0,0.24,80
29360,Nate,2,Private room,50,306,0.78,356
29363,Meahgan,2,Entire home/apt,300,22,0.62,322
29364,K,3,Entire home/apt,85,339,5.14,424
29365,Rose,2,Private room,80,84,1.0,164
29367,Peter,1,Private room,65,31,0.88,96
29368,Karen,1,Entire home/apt,180,151,0.16,331
29369,Eva,2,Entire home/apt,111,43,0.18,154
29370,John,2,Private room,35,79,1.02,114
29371,Daisy,2,Private room,30,193,3.97,223
29372,Shana,2,Private room,90,365,0.72,455
29373,Brenda,2,Entire home/apt,89,10,2.74,99
29374,David,1,Entire home/apt,255,149,3.85,404
29375,Ilginutin,2,Private room,44,5,0.23,49
29376,Emma,1,Private room,30,9,0.33,39
29377,Christine,2,Private room,75,40,0.35,115
29378,Danielle,1,Entire home/apt,110,0,0.22,110
29382,Sam,2,Entire home/apt,300,0,0.38,300
29383,Sid,2,Private room,72,358,0.69,430
29385,Arianna & Z,2,Private room,75,128,4.65,203
29386,Colin,2,Private room,60,0,0.16,60
29387,Charmine,2,Entire home/apt,350,100,0.43,450
29388,Alexei,4,Entire home/apt,80,15,1.68,95
29389,Ann,2,Entire home/apt,550,90,5.24,640
29390,Yiou,1,Private room,39,0,0.06,39
29391,Diana,2,Private room,108,112,0.79,220
29392,Jannices,2,Private room,38,3,2.64,41
29393,Jennifer,2,Entire home/apt,85,0,3.54,85
29394,Cheryl,2,Entire home/apt,800,177,0.34,977
29395,Maria,4,Private room,40,220,0.83,260
29396,Emmet,2,Private room,60,0,0.36,60
29398,Cecilia,2,Private room,48,0,0.06,48
29399,Carmen,2,Entire home/apt,175,0,0.47,175
29400,Niamh,2,Entire home/apt,175,0,0.15,175
29401,Anallely,1,Private room,88,158,1.0,246
29402,Kali,2,Entire home/apt,60,0,0.28,60
29404,Robert,1,Private room,70,128,2.88,198
29406,Brian,4,Entire home/apt,145,332,0.77,477
29407,Yumi,3,Private room,38,0,1.73,38
29408,Jess,2,Private room,150,27,0.48,177
29410,Nilufer,3,Private room,35,304,2.2,339
29411,Lucerne,2,Entire home/apt,70,216,0.3,286
29412,Jackee,2,Entire home/apt,89,322,4.38,411
29415,Dawn Anna,2,Private room,55,0,0.08,55
29417,Mimi,2,Entire home/apt,180,277,2.98,457
29418,Hanna,1,Private room,94,6,3.68,100
29419,Tri,1,Private room,80,0,0.23,80
29420,Antonio,1,Entire home/apt,150,87,4.55,237
29421,Victor,1,Private room,70,0,0.18,70
29422,Benedetta,2,Entire home/apt,125,74,4.44,199
29423,Christine,3,Private room,69,128,0.69,197
29424,Albert,2,Entire home/apt,179,0,0.06,179
29425,Honey,1,Entire home/apt,170,364,0.08,534
29426,Danny,2,Entire home/apt,105,8,0.53,113
29427,Michelle,2,Shared room,23,58,3.27,81
29428,Claire,2,Private room,54,130,5.43,184
29429,Nat,2,Private room,69,185,1.07,254
29433,Annamaria,1,Entire home/apt,450,365,0.77,815
29434,Annamaria,1,Entire home/apt,490,365,0.81,855
29435,Xing,3,Private room,78,178,0.96,256
29436,Pat And Shelly,2,Entire home/apt,179,285,1.68,464
29437,Beth,2,Entire home/apt,245,53,3.69,298
29438,Sebastian,1,Entire home/apt,100,95,0.15,195
29439,John,1,Entire home/apt,160,159,0.31,319
29442,Amber,2,Private room,45,0,0.33,45
29443,Dounia,2,Private room,38,0,0.07,38
29444,Caroline,2,Entire home/apt,120,0,0.5,120
29445,Mia,1,Entire home/apt,280,257,3.88,537
29446,Don,2,Entire home/apt,120,0,0.24,120
29447,Stephanie,2,Entire home/apt,175,170,2.84,345
29448,Erin,2,Private room,100,17,2.04,117
29449,Ashley,2,Private room,60,0,0.06,60
29450,Jermaine,2,Private room,80,58,4.83,138
29451,Liliya,2,Entire home/apt,175,0,0.32,175
29452,Derek,1,Entire home/apt,130,0,0.19,130
29453,Valerie,2,Entire home/apt,185,124,0.82,309
29455,Lindsay,2,Entire home/apt,140,107,2.99,247
29456,Mikkel,1,Entire home/apt,140,11,1.91,151
29458,Barbara,3,Entire home/apt,95,53,3.57,148
29459,Yi,2,Entire home/apt,95,0,0.26,95
29460,Mark,2,Private room,49,299,0.41,348
29462,Sara,2,Private room,58,345,1.77,403
29463,Dico,1,Entire home/apt,175,42,1.3,217
29464,Michelle,1,Private room,25,0,0.11,25
29465,Miki,1,Private room,32,38,2.53,70
29467,Simone,3,Private room,45,0,0.23,45
29468,Lexx,1,Entire home/apt,100,86,3.62,186
29470,Jayne,1,Entire home/apt,230,0,0.76,230
29471,Willa,1,Private room,34,0,0.85,34
29473,Mark,2,Private room,35,350,0.29,385
29475,Trishia,2,Private room,60,0,0.23,60
29476,Eréz,2,Private room,55,64,0.21,119
29477,Garret,1,Private room,95,180,2.72,275
29478,Mariashi,1,Entire home/apt,416,244,2.17,660
29479,Leslie,2,Private room,45,0,0.06,45
29480,Roselie,1,Entire home/apt,99,0,0.33,99
29482,Paddy,1,Entire home/apt,75,0,0.06,75
29484,Vika & Josh,2,Private room,100,358,1.71,458
29485,Tia,2,Private room,40,37,0.23,77
29486,Katharine,2,Private room,60,0,0.11,60
29488,Jennifer,3,Private room,55,9,3.81,64
29489,Tia,2,Entire home/apt,120,296,1.88,416
29490,Jenna,2,Private room,39,324,1.29,363
29491,Ken,1,Private room,38,30,1.43,68
29492,Sonia,3,Private room,45,274,3.52,319
29493,Ayesha,3,Private room,60,301,4.43,361
29494,Annika,1,Entire home/apt,225,364,0.65,589
29495,Sonia,3,Private room,25,254,4.29,279
29496,Sonia,3,Private room,25,216,5.59,241
29497,Rishi,2,Private room,30,0,0.13,30
29498,Eric,2,Private room,50,0,0.12,50
29499,Adrian,2,Private room,25,0,0.06,25
29500,Daniel,1,Entire home/apt,200,228,2.63,428
29501,Tobey,1,Entire home/apt,100,177,0.06,277
29502,Mark,5,Entire home/apt,65,191,3.63,256
29503,Denise,3,Private room,30,0,0.06,30
29504,Laura,1,Entire home/apt,110,0,0.13,110
29505,Joel,3,Entire home/apt,45,304,3.65,349
29507,Shannon R,1,Entire home/apt,115,0,0.11,115
29509,Bugsy,2,Entire home/apt,89,0,0.23,89
29510,Victoria,2,Private room,50,189,0.28,239
29511,Dena,2,Private room,125,80,3.19,205
29512,Adrian,4,Private room,80,0,0.65,80
29514,Gary,1,Entire home/apt,100,3,3.2,103
29515,Yazmin,2,Entire home/apt,169,48,5.27,217
29517,Tiffany,2,Entire home/apt,300,0,0.06,300
29519,Honey,1,Entire home/apt,225,364,0.07,589
29520,Sofia,1,Shared room,30,0,0.94,30
29521,Jed,1,Entire home/apt,545,269,2.79,814
29522,Antonis,3,Entire home/apt,200,155,1.18,355
29523,Anastasia,2,Entire home/apt,189,0,2.88,189
29524,Timothy,2,Private room,71,140,1.29,211
29525,Julianna,1,Entire home/apt,200,0,0.87,200
29526,Aura,1,Private room,65,0,0.17,65
29527,Will,2,Private room,85,0,1.06,85
29528,Deo,1,Private room,125,0,0.85,125
29530,Jannices,2,Private room,38,0,2.0,38
29531,Jannices,2,Private room,38,1,1.83,39
29532,Logan,2,Private room,70,3,0.67,73
29534,Cj,2,Private room,69,28,1.2,97
29535,Walid,1,Entire home/apt,155,21,4.62,176
29536,Teena,1,Entire home/apt,165,188,0.24,353
29537,Michelle,1,Private room,80,0,0.06,80
29538,Ana,1,Private room,90,2,0.79,92
29539,Keisha,2,Private room,55,76,1.84,131
29540,Kimberley,3,Entire home/apt,150,351,3.21,501
29542,Tatiana,1,Entire home/apt,95,56,2.03,151
29543,Marko,2,Private room,22,5,0.3,27
29544,Percy,1,Private room,150,364,0.07,514
29546,Danielle,2,Entire home/apt,130,41,3.66,171
29547,Abel,1,Entire home/apt,173,0,4.43,173
29548,Anna,2,Entire home/apt,75,0,0.37,75
29550,Reginald,2,Entire home/apt,110,0,0.68,110
29551,Kennedy,2,Private room,50,0,0.06,50
29552,Stephanie,2,Private room,55,319,0.8,374
29553,East Village,1,Entire home/apt,135,202,2.71,337
29554,East Village,1,Private room,85,0,0.21,85
29555,Hortense,2,Private room,55,0,0.23,55
29556,Nicholas,2,Entire home/apt,189,0,0.52,189
29558,Jeannette,2,Entire home/apt,100,117,0.33,217
29559,Carmen,2,Private room,76,153,1.37,229
29560,Queen Sheba,2,Entire home/apt,97,174,2.92,271
29561,Narina,1,Entire home/apt,175,160,0.51,335
29562,Johny,2,Entire home/apt,150,319,1.58,469
29563,Elena,2,Private room,42,0,0.11,42
29565,Lee,3,Private room,40,0,0.09,40
29566,Anna,2,Private room,75,0,0.51,75
29567,Adelina,2,Entire home/apt,75,0,0.33,75
29568,Ramy,2,Entire home/apt,79,0,0.28,79
29569,Rebecca,2,Private room,45,8,3.15,53
29570,Darby,2,Private room,78,0,0.13,78
29571,Daniel,2,Entire home/apt,160,14,0.3,174
29573,Joey,3,Private room,60,47,2.28,107
29574,Piero,1,Private room,300,332,3.59,632
29575,Keisha,2,Private room,55,177,1.4,232
29579,Nuttamon,1,Private room,99,315,2.7,414
29580,Mohammed,2,Entire home/apt,90,293,1.7,383
29581,Kathleen,1,Private room,65,0,5.89,65
29583,M,1,Private room,80,0,0.19,80
29584,Erick,4,Entire home/apt,40,266,2.51,306
29585,Soon,3,Private room,54,335,0.39,389
29586,Chase,2,Private room,138,81,4.59,219
29587,Raven,2,Private room,66,49,0.13,115
29588,Melissa,1,Private room,35,0,0.17,35
29590,Casey,2,Shared room,55,0,0.06,55
29592,Piero,1,Private room,109,304,5.11,413
29593,Judith,2,Entire home/apt,110,96,3.03,206
29595,Paul,2,Entire home/apt,119,77,1.49,196
29596,Kristen,1,Entire home/apt,375,79,2.19,454
29597,Lucas,2,Private room,65,0,0.31,65
29598,Jeffrey,2,Private room,75,0,0.33,75
29599,Sophia,2,Entire home/apt,58,220,0.26,278
29600,Sam,2,Private room,85,13,0.82,98
29601,Qusuquzah,2,Private room,68,365,0.94,433
29602,Eriko,1,Entire home/apt,90,7,0.31,97
29603,Bertin,1,Private room,90,331,1.88,421
29604,Nabil,5,Entire home/apt,75,6,1.55,81
29605,Rose,2,Entire home/apt,130,132,2.23,262
29606,Justyna,2,Private room,50,0,0.06,50
29607,Christopher,1,Entire home/apt,150,0,0.79,150
29608,Daniel,2,Private room,100,172,1.35,272
29610,Anna,2,Entire home/apt,345,146,3.24,491
29611,Andrew,2,Private room,59,0,0.34,59
29612,Juline,1,Entire home/apt,150,33,0.36,183
29613,Marie Louise,3,Private room,80,188,1.28,268
29614,Mehmet,3,Private room,60,0,0.17,60
29615,Airik,1,Entire home/apt,100,22,0.22,122
29617,Autumn,1,Private room,120,58,0.66,178
29618,Sijia,3,Entire home/apt,120,0,0.73,120
29619,Nicauris,1,Private room,48,332,0.32,380
29621,Iris,3,Shared room,23,0,0.77,23
29622,Michael,2,Entire home/apt,175,98,0.31,273
29623,Cynthia And Froebel,2,Entire home/apt,95,108,0.23,203
29624,Alison,2,Private room,40,84,0.25,124
29625,Waj,1,Entire home/apt,339,365,1.25,704
29626,Caleb,2,Entire home/apt,100,0,1.17,100
29627,Laura,2,Entire home/apt,79,21,0.47,100
29628,Nalicia,3,Private room,50,26,16.81,76
29629,Jeffer,1,Private room,40,18,2.05,58
29630,Michelle,1,Shared room,85,90,0.11,175
29631,Sophia,2,Entire home/apt,129,255,3.97,384
29632,Derick,2,Entire home/apt,105,211,2.46,316
29633,Brad,1,Entire home/apt,275,0,0.66,275
29634,Simone,2,Private room,47,0,0.4,47
29635,Mari,1,Entire home/apt,265,70,2.45,335
29636,Motonobu,1,Entire home/apt,155,0,1.05,155
29638,Ethan,1,Entire home/apt,115,0,0.24,115
29639,Roberto,2,Private room,35,59,0.46,94
29640,Matt,2,Private room,69,319,0.35,388
29641,Joel,2,Entire home/apt,250,96,2.56,346
29642,Christopher,1,Entire home/apt,100,0,1.94,100
29643,Mayra,1,Entire home/apt,120,299,0.42,419
29644,Skander,1,Entire home/apt,450,0,0.14,450
29645,Emily,2,Private room,36,0,0.55,36
29646,Marie,1,Private room,52,21,2.73,73
29648,Danlin,3,Private room,130,365,0.27,495
29649,Stephanie,2,Private room,45,74,1.6,119
29650,Paul,1,Entire home/apt,150,328,0.09,478
29651,Evolve,3,Entire home/apt,228,0,0.26,228
29652,Dalton,2,Entire home/apt,80,139,3.31,219
29653,Thikshan,1,Entire home/apt,200,20,1.17,220
29654,Marcus,3,Private room,50,93,1.03,143
29655,Rosa,4,Entire home/apt,150,168,0.72,318
29656,Noelle,2,Private room,65,0,0.36,65
29658,April,1,Entire home/apt,180,0,0.15,180
29659,Cesar,2,Private room,47,0,0.53,47
29660,Lucky,3,Private room,40,0,0.41,40
29668,Jaran,2,Entire home/apt,125,250,3.47,375
29669,Wilson,3,Private room,140,57,0.81,197
29670,Maddi,1,Entire home/apt,220,13,1.79,233
29671,Rolland,1,Private room,50,0,1.01,50
29672,Herman,2,Private room,30,36,1.85,66
29675,Tsvika,1,Private room,79,107,5.69,186
29676,Maresa,3,Private room,90,1,2.26,91
29678,Tom,2,Private room,69,300,0.95,369
29679,Rusty,2,Private room,50,0,0.97,50
29680,Judie And Steven,1,Private room,49,257,0.79,306
29682,Jennifer,4,Private room,50,324,0.26,374
29684,Eliahu,1,Private room,69,180,0.29,249
29685,Eliahu,1,Private room,69,365,0.29,434
29686,Eliahu,1,Private room,65,364,0.18,429
29687,Svetlana,1,Entire home/apt,150,0,0.9,150
29688,Ian,1,Entire home/apt,200,311,0.28,511
29689,Edward,2,Entire home/apt,150,363,0.08,513
29690,Chelsea Holland,2,Entire home/apt,110,0,0.12,110
29691,Roger,2,Entire home/apt,110,347,1.71,457
29692,Paolo,1,Private room,69,334,0.37,403
29693,Dixon,2,Entire home/apt,230,0,0.97,230
29695,Miryan,1,Private room,60,19,5.94,79
29696,Zdenka,3,Entire home/apt,100,264,4.33,364
29697,Christopher,2,Entire home/apt,92,11,2.47,103
29698,Coco,3,Private room,98,215,1.48,313
29699,Eva,2,Entire home/apt,145,0,0.32,145
29701,Terry,2,Private room,80,0,0.53,80
29702,Eliahu,1,Private room,69,364,0.06,433
29703,Johanna,1,Private room,55,175,2.54,230
29705,Eliahu,1,Private room,65,364,0.07,429
29706,Caroline,2,Private room,40,8,6.77,48
29707,Lisa,2,Private room,100,0,0.59,100
29709,Lennie & Lincia,2,Private room,68,152,1.06,220
29710,Camille,1,Entire home/apt,250,0,0.53,250
29713,Holly,2,Entire home/apt,600,253,1.59,853
29714,Sam,3,Private room,60,105,7.07,165
29715,Ralph & Jenny,2,Entire home/apt,237,0,2.09,237
29716,Annett,1,Entire home/apt,100,0,2.19,100
29717,Yi Qun,1,Private room,120,360,0.81,480
29718,Mike,1,Private room,60,0,1.31,60
29719,Chinasokwu,2,Entire home/apt,105,307,4.08,412
29720,Mark,2,Entire home/apt,150,1,1.13,151
29721,Jami,2,Entire home/apt,125,0,0.36,125
29722,Megan,2,Private room,45,0,0.21,45
29723,Matt,2,Entire home/apt,90,0,2.18,90
29724,Jewel,3,Entire home/apt,175,33,2.84,208
29725,Thomas,2,Entire home/apt,125,0,0.13,125
29726,Jordan,1,Private room,46,0,0.57,46
29727,Chloe,1,Entire home/apt,150,0,0.23,150
29730,Jeff,4,Private room,70,0,5.23,70
29731,Nada,1,Private room,149,0,0.65,149
29732,Ksenia & Masha,2,Private room,50,178,1.15,228
29733,Fabiana,3,Private room,50,155,0.33,205
29735,Roman,1,Private room,69,77,1.27,146
29736,Lauren,3,Private room,44,0,0.34,44
29737,Salisha,2,Entire home/apt,80,156,1.38,236
29738,Madeline,5,Private room,25,0,2.06,25
29739,Diana,2,Entire home/apt,480,23,0.13,503
29740,Marco,2,Private room,46,285,0.4,331
29741,Ruth,1,Entire home/apt,150,6,0.17,156
29742,H&E,2,Private room,55,26,2.07,81
29743,Aaron,2,Private room,58,25,0.52,83
29744,Aaron,2,Private room,58,14,0.64,72
29746,Viramo,1,Private room,139,0,0.17,139
29747,Kayla,1,Private room,125,0,0.06,125
29748,Uri,2,Entire home/apt,69,225,3.95,294
29749,Nancy,1,Entire home/apt,110,171,1.11,281
29750,Efrat,2,Entire home/apt,275,0,0.22,275
29752,Erin,2,Private room,125,0,0.06,125
29753,Pascal-Louis,2,Entire home/apt,249,154,3.17,403
29754,Rafael,3,Shared room,32,16,1.64,48
29755,Veronika,2,Entire home/apt,140,1,3.17,141
29756,Elle,1,Entire home/apt,86,0,0.19,86
29757,Tia,2,Private room,50,18,0.07,68
29758,R.J.,1,Entire home/apt,165,0,1.57,165
29759,Yamile,1,Entire home/apt,150,0,1.15,150
29760,Keon,2,Private room,80,179,0.07,259
29761,Sarah,2,Private room,58,37,2.38,95
29762,Chris,2,Private room,38,141,0.93,179
29764,Rosemary,2,Entire home/apt,80,363,3.02,443
29765,Sonia,2,Entire home/apt,73,5,0.31,78
29766,Kim & John,1,Entire home/apt,169,186,3.81,355
29768,Juanjo,3,Private room,59,0,0.06,59
29769,Rgh,1,Entire home/apt,145,80,0.55,225
29770,Meryl,2,Entire home/apt,195,14,0.4,209
29771,Kristen,1,Entire home/apt,199,11,0.44,210
29772,Jonathan,1,Entire home/apt,100,161,0.09,261
29773,Luiz,2,Private room,60,0,3.07,60
29774,Karim,2,Private room,45,0,0.29,45
29775,Tomás,1,Private room,90,5,0.69,95
29776,Brie,3,Entire home/apt,78,50,1.53,128
29777,Marissa,1,Private room,59,0,0.17,59
29778,Morgan,3,Private room,37,0,1.01,37
29779,Anna,1,Private room,110,311,7.67,421
29781,Carnitas,1,Entire home/apt,188,146,2.35,334
29783,Jami,2,Private room,45,12,2.81,57
29784,Nix,2,Entire home/apt,169,189,1.3,358
29785,Katiuscia,1,Entire home/apt,275,239,3.9,514
29788,Mackenzie,1,Entire home/apt,190,0,0.29,190
29791,Gordon,1,Entire home/apt,189,108,0.21,297
29792,Brian,2,Private room,45,0,1.39,45
29793,Dan,2,Private room,60,362,1.17,422
29794,Steven,2,Entire home/apt,149,138,2.38,287
29796,Ricardo,3,Entire home/apt,199,161,2.95,360
29797,Claudia,3,Private room,72,35,0.4,107
29798,Sofia,1,Shared room,30,0,1.72,30
29799,Shauna,2,Private room,60,0,0.06,60
29800,Isabel,1,Private room,300,0,0.13,300
29801,Kelli,3,Entire home/apt,195,0,0.08,195
29803,Oscar,1,Entire home/apt,159,0,0.11,159
29808,Irina,1,Entire home/apt,120,289,0.25,409
29809,Dmitry,2,Private room,65,28,4.3,93
29810,Noemie,2,Entire home/apt,98,179,2.56,277
29811,Madeline,5,Private room,39,0,1.81,39
29812,Yelle,2,Private room,50,13,0.28,63
29813,UBliss,1,Entire home/apt,189,358,0.27,547
29814,Natalia,1,Shared room,75,8,2.92,83
29815,Mo,2,Entire home/apt,100,0,1.56,100
29816,Stephanie,2,Private room,36,297,0.06,333
29817,Juliet,2,Private room,25,207,0.58,232
29818,Josh,1,Private room,84,13,0.82,97
29819,Akon,1,Entire home/apt,295,125,6.68,420
29821,Kristiana,2,Private room,35,0,0.42,35
29822,Fernando And Ana,1,Entire home/apt,220,331,2.11,551
29823,Evelina,1,Private room,70,0,0.17,70
29824,Anna,2,Entire home/apt,150,10,2.86,160
29826,Charles,1,Private room,75,0,0.88,75
29827,Martin,2,Entire home/apt,110,0,1.9,110
29829,Emma,2,Private room,53,0,0.06,53
29830,Kevin,1,Private room,89,12,3.74,101
29832,Aaron,2,Private room,29,0,0.17,29
29833,Raphael & Sydonie,2,Entire home/apt,128,18,3.32,146
29834,Nicole,1,Entire home/apt,130,128,0.21,258
29835,Ivan,2,Private room,50,71,1.38,121
29836,Matilda,1,Private room,110,23,0.74,133
29837,Liliana,3,Private room,45,355,0.2,400
29838,Hugo,2,Private room,90,0,0.06,90
29843,Danika & Cary,2,Entire home/apt,150,231,3.55,381
29844,Daisy,2,Private room,35,187,4.67,222
29846,Arlene,2,Entire home/apt,69,193,5.0,262
29847,Rika,3,Private room,47,0,1.44,47
29848,Nick,1,Private room,50,0,0.19,50
29849,Tony,3,Entire home/apt,150,70,3.1,220
29850,China,1,Entire home/apt,175,0,0.46,175
29852,Kartikeya,5,Shared room,20,0,0.06,20
29853,Shirley,2,Entire home/apt,140,76,1.32,216
29857,Pebel,3,Entire home/apt,50,0,0.06,50
29858,Ken,2,Entire home/apt,57,69,5.4,126
29860,Rebecca,2,Entire home/apt,100,0,0.06,100
29861,Christine,1,Entire home/apt,190,0,0.29,190
29862,Alison,1,Entire home/apt,130,0,0.18,130
29863,Lisa,2,Private room,65,0,0.89,65
29864,David,3,Private room,25,350,3.61,375
29865,Abe,3,Entire home/apt,175,85,1.2,260
29866,Lauren,2,Entire home/apt,450,364,1.79,814
29867,Sean,3,Entire home/apt,200,152,3.6,352
29868,Pamela,3,Private room,55,179,0.71,234
29869,Nick,1,Entire home/apt,400,3,0.19,403
29870,Yaroslav,2,Entire home/apt,200,0,0.36,200
29871,Vasilios,3,Entire home/apt,140,145,4.14,285
29872,Brooke,1,Private room,160,102,2.29,262
29873,Michaela,3,Private room,100,172,0.91,272
29874,Muslum,1,Private room,90,338,0.71,428
29876,Robert,2,Private room,95,0,0.74,95
29877,Barthelemy,2,Entire home/apt,200,4,1.1,204
29878,Chandtisse,2,Private room,169,115,0.16,284
29879,Andre,3,Private room,65,240,1.68,305
29880,Jasmine,1,Entire home/apt,150,0,0.25,150
29881,Mariette,2,Private room,65,89,1.4,154
29883,Anna,1,Entire home/apt,250,0,0.57,250
29885,Laura,1,Entire home/apt,350,5,0.9,355
29887,Olga,2,Private room,27,0,0.06,27
29888,Demi,2,Entire home/apt,115,13,2.29,128
29889,Renata,2,Private room,74,46,2.27,120
29890,Rafaela,1,Private room,110,0,0.06,110
29891,Alfred,1,Entire home/apt,148,121,1.39,269
29892,Asya,1,Entire home/apt,150,0,0.35,150
29894,Daisy,2,Private room,35,186,3.83,221
29895,John,2,Entire home/apt,125,165,4.36,290
29896,Arthur,1,Private room,65,1,3.69,66
29897,Chinasokwu,2,Entire home/apt,150,307,0.82,457
29898,Anastacia,1,Entire home/apt,150,53,0.3,203
29899,Gila,2,Entire home/apt,60,0,0.71,60
29900,Katya,4,Entire home/apt,69,21,4.21,90
29901,Jacob,1,Entire home/apt,70,0,0.19,70
29902,Giulia,3,Entire home/apt,118,0,0.13,118
29903,Alli,1,Entire home/apt,115,132,3.98,247
29904,Megan,2,Private room,100,365,2.65,465
29905,Chris&Suly,3,Entire home/apt,125,107,3.76,232
29906,Oliver,1,Entire home/apt,399,161,2.55,560
29908,Turner,1,Entire home/apt,100,20,0.95,120
29909,Julia,2,Entire home/apt,100,0,0.12,100
29910,Agustina,1,Entire home/apt,495,52,0.84,547
29911,Catherine,1,Entire home/apt,120,128,1.25,248
29912,Arjun,2,Private room,140,0,0.11,140
29913,Mehdi,3,Private room,50,36,3.17,86
29914,Ziaul,4,Entire home/apt,119,351,1.68,470
29915,Emily & Joseph,2,Entire home/apt,200,279,2.3,479
29916,Lia,1,Entire home/apt,145,122,1.0,267
29917,M,3,Entire home/apt,50,0,5.63,50
29918,Ian,1,Entire home/apt,125,220,0.34,345
29919,Gal,1,Entire home/apt,117,0,0.06,117
29920,Yaacov,1,Entire home/apt,350,327,0.18,677
29921,Carolle,1,Private room,145,74,1.67,219
29923,Sehee,1,Entire home/apt,125,0,0.06,125
29924,Yaacov,1,Entire home/apt,300,248,0.16,548
29925,Keila,2,Entire home/apt,50,0,0.52,50
29926,Yaacov,1,Entire home/apt,135,338,0.07,473
29928,Kayla,4,Entire home/apt,60,23,2.44,83
29929,Yaacov,1,Entire home/apt,300,326,0.31,626
29931,Yaacov,1,Entire home/apt,300,342,0.49,642
29932,Sharon,2,Entire home/apt,110,62,3.39,172
29934,Joshua,2,Entire home/apt,104,84,1.67,188
29935,Jason,2,Private room,39,127,1.0,166
29936,Ilyas,3,Private room,45,27,3.26,72
29937,Wesly/Jessica,2,Entire home/apt,178,257,1.13,435
29938,Elior,2,Entire home/apt,220,0,0.24,220
29940,Anthony,2,Private room,55,179,0.23,234
29941,Susan,2,Entire home/apt,97,138,0.59,235
29942,Sonia,3,Private room,35,256,5.31,291
29943,Paola,3,Private room,80,219,0.11,299
29945,Martina,2,Private room,50,0,0.88,50
29946,Kynneth,3,Private room,68,298,1.33,366
29947,Pari,2,Entire home/apt,140,36,1.07,176
29948,Michele,1,Private room,150,0,0.41,150
29951,Max,2,Entire home/apt,75,0,0.13,75
29953,Micah,2,Entire home/apt,130,339,0.24,469
29954,Mayara & Gaspar,2,Entire home/apt,93,55,4.49,148
29955,Isabel,1,Entire home/apt,75,0,1.87,75
29956,Robert,2,Entire home/apt,130,114,8.21,244
29957,Randall,2,Entire home/apt,65,20,2.88,85
29958,Anna,1,Entire home/apt,99,0,0.89,99
29959,Francis & Daniele,2,Entire home/apt,119,240,3.58,359
29960,Gabryelle,1,Private room,55,0,1.15,55
29961,Elle,2,Private room,65,291,4.9,356
29963,Bless M,2,Entire home/apt,140,122,1.88,262
29964,Alyssa,1,Shared room,29,0,0.75,29
29965,Vivian,2,Private room,94,126,3.26,220
29966,Alyssa,1,Entire home/apt,72,0,0.64,72
29967,Cha,3,Private room,31,111,1.27,142
29968,Thomas,1,Entire home/apt,150,0,0.06,150
29969,Charles,2,Entire home/apt,250,235,2.94,485
29970,Dadrine,2,Private room,80,58,0.13,138
29971,Dadrine,2,Private room,80,89,0.14,169
29972,Akshay,1,Entire home/apt,150,2,1.19,152
29973,Leslie,3,Private room,75,48,0.06,123
29974,Emon,3,Private room,49,0,1.68,49
29975,Jeta,1,Private room,85,0,1.48,85
29976,Vic,3,Private room,83,48,0.55,131
29977,Lauren,1,Entire home/apt,135,60,0.19,195
29978,Emily,1,Entire home/apt,100,0,0.06,100
29979,Charles,1,Shared room,25,365,2.99,390
29980,Daia,1,Entire home/apt,329,59,0.91,388
29981,Shayna,1,Private room,48,0,0.77,48
29983,Wesly/Jessica,2,Private room,55,341,1.99,396
29984,Daia,1,Entire home/apt,365,50,0.86,415
29985,Andrea,1,Entire home/apt,150,6,0.58,156
29986,Sebastian,2,Private room,99,360,1.24,459
29987,Sebastian,2,Private room,109,360,1.37,469
29988,Ploy,2,Private room,40,61,0.38,101
29990,Algin,2,Private room,58,0,0.12,58
29991,Hisham,3,Private room,76,0,0.86,76
29992,Dan,3,Entire home/apt,289,271,0.91,560
29993,David,3,Entire home/apt,65,0,0.84,65
29994,Jason,1,Entire home/apt,850,344,1.57,1194
29995,Sophie,1,Entire home/apt,160,0,0.17,160
29996,Matthew,1,Entire home/apt,225,363,0.71,588
29997,Samantha,2,Entire home/apt,90,342,0.24,432
29998,Marti,2,Private room,70,16,1.71,86
29999,Brandon,2,Private room,45,0,0.64,45
30000,Declan,1,Entire home/apt,100,0,0.3,100
30001,Sush,1,Entire home/apt,90,0,0.31,90
30003,Winnie & Andy,4,Private room,41,0,0.06,41
30004,Lisa,2,Entire home/apt,149,0,0.16,149
30005,Winnie & Andy,4,Private room,45,0,0.06,45
30006,Arthur,1,Private room,40,0,0.18,40
30007,Ken,3,Entire home/apt,90,106,3.71,196
30008,Shera,4,Private room,29,192,4.93,221
30009,Asad,3,Entire home/apt,257,341,6.51,598
30010,Brittany,1,Entire home/apt,295,51,0.94,346
30012,Reina,2,Private room,70,264,3.29,334
30013,Del,1,Private room,65,2,0.6,67
30014,Reina,2,Private room,62,248,1.69,310
30015,Marko,3,Entire home/apt,60,0,0.19,60
30017,Max,1,Entire home/apt,225,279,0.78,504
30018,Jennyfer,3,Private room,49,87,0.36,136
30019,Redford,2,Entire home/apt,325,96,0.61,421
30020,Olga,1,Private room,100,270,1.66,370
30021,Sharik,1,Entire home/apt,67,1,0.06,68
30022,Ji,2,Private room,90,149,1.23,239
30023,Wilson,2,Private room,45,339,1.35,384
30024,Agustina,1,Entire home/apt,495,63,0.46,558
30025,Malin,1,Private room,112,1,0.9,113
30026,Alanna,1,Entire home/apt,160,0,1.96,160
30027,Maria,4,Private room,37,0,0.41,37
30028,Kevin,2,Entire home/apt,104,98,0.73,202
30029,Jessica,1,Private room,95,54,3.33,149
30030,Sanyika,4,Private room,80,36,1.18,116
30031,Cy,1,Entire home/apt,115,1,0.22,116
30032,Elvira,2,Entire home/apt,148,92,1.68,240
30033,Penina,2,Entire home/apt,75,0,0.37,75
30034,Jennifer,2,Entire home/apt,173,0,0.26,173
30035,Fatima,4,Private room,65,0,0.3,65
30036,Madeleine,3,Entire home/apt,75,1,0.78,76
30039,Andrée,1,Entire home/apt,300,0,0.77,300
30040,Nima + Kat,1,Entire home/apt,169,180,0.18,349
30041,Brizzo,2,Private room,60,88,0.58,148
30042,Awilda,2,Entire home/apt,84,0,2.36,84
30043,Charles,1,Entire home/apt,115,16,1.66,131
30044,Yola,3,Entire home/apt,106,113,3.73,219
30045,Michal,2,Entire home/apt,100,0,0.67,100
30046,Allison,3,Private room,100,0,0.41,100
30047,Daniella,2,Private room,50,52,3.44,102
30048,Sara And Greg,2,Entire home/apt,55,0,0.53,55
30049,Rose,3,Entire home/apt,120,52,3.49,172
30050,Tatyana,2,Entire home/apt,120,22,3.69,142
30051,Jonah,1,Entire home/apt,127,32,2.0,159
30052,Christina,1,Entire home/apt,160,266,2.14,426
30053,Jose,1,Entire home/apt,200,0,0.14,200
30054,Oren,2,Entire home/apt,117,0,0.82,117
30055,Yahaira,4,Entire home/apt,250,361,1.44,611
30056,Julian,2,Entire home/apt,76,41,0.06,117
30057,Geraldo,1,Private room,30,0,0.14,30
30058,Derek,2,Private room,40,0,0.58,40
30063,Jose,1,Entire home/apt,180,4,1.98,184
30065,Surani,1,Entire home/apt,117,0,0.08,117
30066,Rosella,1,Entire home/apt,130,35,0.38,165
30067,Jirapong,3,Private room,59,5,1.43,64
30068,Emily,2,Entire home/apt,94,0,0.3,94
30070,Cara,2,Private room,55,0,0.3,55
30071,Steve,3,Entire home/apt,69,0,0.06,69
30072,Camilo & Yesenia,3,Private room,80,30,4.57,110
30073,Elisheva,4,Shared room,20,0,0.53,20
30074,Megwyn,2,Private room,40,51,3.0,91
30075,S,1,Entire home/apt,127,0,0.08,127
30076,Anne-Lise,1,Private room,63,31,0.39,94
30077,Brittany,2,Private room,95,36,1.33,131
30078,Matt,1,Private room,75,88,0.06,163
30079,Betty,3,Private room,50,0,0.06,50
30080,Grace,3,Shared room,1250,173,0.06,1423
30082,Zsofia,3,Private room,40,169,0.13,209
30083,Fazli,1,Entire home/apt,145,0,0.13,145
30084,Richard,1,Entire home/apt,135,122,0.37,257
30085,Sen,3,Private room,44,116,4.62,160
30086,Stefanie,2,Private room,70,0,0.3,70
30088,Joey,2,Private room,42,4,5.54,46
30089,Sultan,1,Shared room,33,320,0.18,353
30090,Aaron,2,Private room,70,362,1.07,432
30095,Christian,1,Entire home/apt,100,0,0.31,100
30096,Iryna,1,Entire home/apt,145,0,0.3,145
30097,Rachel,2,Private room,75,115,1.07,190
30098,Amy,1,Entire home/apt,250,310,0.19,560
30099,Marlene,1,Entire home/apt,150,320,1.79,470
30100,Andre,1,Private room,65,30,1.5,95
30101,Jeffery,1,Entire home/apt,159,50,5.3,209
30102,Megan,2,Private room,65,8,0.52,73
30104,Alexandra,2,Entire home/apt,200,0,1.0,200
30105,Max,3,Private room,60,84,2.57,144
30106,Jirapong,3,Private room,46,96,0.16,142
30108,Anthony,2,Entire home/apt,69,0,0.41,69
30110,Byron,2,Entire home/apt,190,5,0.32,195
30114,Kyle,2,Entire home/apt,125,48,3.0,173
30115,Arek,5,Entire home/apt,71,306,1.8,377
30116,Olivia,2,Entire home/apt,150,331,4.86,481
30117,Gabriela,3,Entire home/apt,80,57,3.23,137
30118,Mirco,2,Entire home/apt,70,183,0.62,253
30119,Eni,1,Entire home/apt,80,46,0.93,126
30120,Sarah,2,Private room,43,0,2.31,43
30121,Ian,1,Entire home/apt,210,216,6.4,426
30122,Nick,2,Entire home/apt,133,0,0.15,133
30123,Idara,2,Private room,50,0,0.06,50
30124,Alek,3,Entire home/apt,100,132,0.17,232
30125,Kathleen,1,Private room,47,48,4.97,95
30126,Andrea,1,Private room,99,162,2.22,261
30127,Jeannie & Everett,2,Entire home/apt,150,244,2.69,394
30129,Lucas,1,Shared room,80,170,0.06,250
30131,Vas,4,Private room,47,176,1.96,223
30132,Nilbia,2,Private room,44,0,0.54,44
30133,Javerick,2,Private room,67,307,1.11,374
30134,Wilson,3,Private room,60,14,1.54,74
30135,Bianca,2,Private room,50,0,2.29,50
30136,Leon,5,Entire home/apt,245,216,2.28,461
30137,Jennifer,2,Private room,29,5,3.88,34
30138,Martin,2,Entire home/apt,180,0,0.09,180
30139,Jeff,1,Entire home/apt,189,73,2.37,262
30140,Lola,2,Private room,41,30,5.0,71
30141,Alegria,3,Private room,60,112,2.49,172
30142,Damien,2,Entire home/apt,120,19,2.79,139
30143,Laura,1,Entire home/apt,123,34,0.38,157
30144,Michael,1,Entire home/apt,339,0,2.63,339
30145,Julian,2,Entire home/apt,125,0,0.16,125
30146,Aj,3,Private room,30,65,0.84,95
30147,Edwin,4,Private room,54,69,0.99,123
30148,David,2,Entire home/apt,75,280,0.54,355
30149,Conor,1,Entire home/apt,92,4,0.53,96
30150,The,2,Entire home/apt,130,185,3.84,315
30151,Hooman,2,Private room,55,0,0.13,55
30152,Maxwell,2,Private room,35,0,0.24,35
30153,Sidney,2,Entire home/apt,75,0,0.12,75
30155,Anne,1,Entire home/apt,180,223,4.67,403
30156,Yitzchok,2,Entire home/apt,89,13,6.7,102
30157,Lugao,1,Private room,93,190,1.69,283
30159,Alan,3,Entire home/apt,85,232,0.31,317
30160,Claudio,1,Private room,80,180,3.74,260
30161,Heather Nadine,2,Entire home/apt,150,11,0.63,161
30162,Frederik,2,Private room,100,0,0.46,100
30164,E...,2,Entire home/apt,175,96,5.47,271
30165,Walter,2,Entire home/apt,113,0,0.25,113
30166,Topher,1,Private room,69,0,2.75,69
30167,Svetlana,2,Private room,50,316,2.19,366
30168,Houda,1,Entire home/apt,105,0,0.5,105
30169,Ilyas,3,Private room,55,29,4.27,84
30171,Li,3,Entire home/apt,109,54,4.02,163
30172,Giampiero,1,Entire home/apt,500,163,3.57,663
30174,Chelsea,2,Entire home/apt,125,0,0.19,125
30175,Alvina Da Silva,4,Private room,34,5,0.12,39
30176,Liberty,2,Entire home/apt,260,1,0.4,261
30177,Elizabeth,2,Private room,68,177,3.89,245
30179,Alexander M,2,Entire home/apt,200,179,1.17,379
30180,Jill,1,Entire home/apt,200,0,0.13,200
30181,Doug,2,Entire home/apt,125,190,1.29,315
30182,Tashi,3,Entire home/apt,199,0,2.48,199
30183,Mary,2,Private room,68,258,0.53,326
30184,Melissa,2,Entire home/apt,37,0,0.13,37
30185,Bingham,2,Entire home/apt,60,0,0.49,60
30186,Dan,1,Entire home/apt,300,182,1.77,482
30187,Natalie,2,Entire home/apt,87,54,4.25,141
30189,Andre,2,Entire home/apt,160,157,0.56,317
30190,Tanya,1,Entire home/apt,145,0,0.2,145
30191,Patricia,5,Private room,40,87,0.07,127
30192,Svetlana,2,Private room,50,311,1.69,361
30193,Matt,1,Shared room,60,363,2.01,423
30195,Kimberly,3,Private room,70,0,0.15,70
30196,Hollis,1,Entire home/apt,100,0,0.12,100
30197,Maxime,1,Entire home/apt,172,42,1.75,214
30198,Andrée,1,Private room,75,0,0.07,75
30199,Tyni,1,Entire home/apt,118,0,0.42,118
30200,C,1,Entire home/apt,240,83,4.09,323
30201,Mariela,4,Private room,73,39,1.83,112
30203,Oswaldo,5,Private room,60,0,5.49,60
30204,Charlie,3,Shared room,34,348,2.66,382
30205,Eliahu,3,Entire home/apt,60,299,0.66,359
30206,Luke,2,Entire home/apt,125,0,0.66,125
30208,Keah,1,Private room,55,0,1.57,55
30209,Nate,1,Private room,165,0,3.24,165
30210,Kosha,2,Private room,45,0,0.12,45
30211,Bridget,1,Private room,70,156,0.49,226
30212,Santosh,3,Entire home/apt,93,89,4.24,182
30213,Nataly,3,Private room,49,0,0.31,49
30214,Jasmine,3,Entire home/apt,65,0,0.06,65
30215,J & T,1,Private room,140,348,1.69,488
30217,Sophia,1,Private room,100,0,0.49,100
30218,Judith,1,Private room,125,297,0.43,422
30219,Rob,1,Entire home/apt,295,89,4.25,384
30220,Katya,3,Private room,120,0,0.21,120
30221,Lisa& Jonathan,2,Private room,75,336,7.87,411
30222,Megan,2,Shared room,75,270,1.69,345
30223,Erin V.,3,Shared room,30,140,3.02,170
30224,Haifa,1,Entire home/apt,127,3,0.43,130
30225,Anika,2,Private room,60,0,2.88,60
30226,Basia,5,Entire home/apt,165,0,3.25,165
30227,Isabelle,2,Private room,59,48,0.1,107
30229,Ed And Heather,2,Entire home/apt,105,74,3.98,179
30230,Lakisha,2,Private room,58,179,0.63,237
30231,Kinda,1,Entire home/apt,125,0,0.64,125
30232,Erin V.,3,Shared room,30,140,2.29,170
30233,Erin V.,3,Shared room,30,145,2.48,175
30234,Tatiane,1,Entire home/apt,146,353,0.21,499
30235,John,2,Private room,52,90,1.37,142
30236,Seb,1,Private room,35,267,0.11,302
30239,Karina,2,Private room,32,0,0.48,32
30240,Lauren & Chelsea,2,Private room,88,50,3.55,138
30242,Chanae,1,Entire home/apt,149,120,0.92,269
30243,K.C.,1,Entire home/apt,169,325,3.27,494
30244,Elizabeth,3,Private room,85,89,0.18,174
30245,Ethan,1,Entire home/apt,395,89,0.3,484
30246,Nini,1,Private room,60,0,0.12,60
30247,Isabel,2,Entire home/apt,100,3,0.43,103
30248,Yaakov,2,Private room,50,0,0.06,50
30249,Yoni,2,Private room,35,0,1.13,35
30250,Mark,2,Entire home/apt,99,26,1.31,125
30251,Ahmad,1,Shared room,75,24,2.39,99
30252,Chanhee,1,Private room,60,45,3.67,105
30253,Charlotte,3,Private room,46,51,1.92,97
30254,Malika,2,Entire home/apt,175,249,2.66,424
30255,Rezaur,3,Entire home/apt,120,356,2.18,476
30256,Jenny,1,Entire home/apt,179,333,2.32,512
30258,Jason,1,Entire home/apt,120,4,0.6,124
30261,Katie,2,Private room,69,0,0.51,69
30262,Arturo,1,Private room,98,0,1.25,98
30264,Tia,1,Entire home/apt,117,0,0.24,117
30265,Sunny,2,Entire home/apt,115,90,2.41,205
30266,Michael,2,Private room,45,0,0.06,45
30267,Andrew,1,Private room,149,0,0.3,149
30268,Rum,1,Entire home/apt,8500,251,0.18,8751
30271,Colleen,3,Entire home/apt,125,0,0.98,125
30272,Jose,1,Entire home/apt,125,188,1.63,313
30273,Sophie & Max,2,Private room,99,0,1.9,99
30274,Shopper,1,Private room,115,90,0.22,205
30276,Nigel,2,Private room,150,0,0.39,150
30277,Elena,1,Private room,67,0,0.43,67
30278,Sarah,2,Entire home/apt,225,56,2.31,281
30280,Danielle,1,Private room,62,0,0.43,62
30281,Jessica,2,Private room,35,0,0.37,35
30282,Greg,2,Entire home/apt,175,67,0.13,242
30284,Kelly,1,Private room,39,10,1.62,49
30285,Marianna,1,Private room,60,0,0.31,60
30286,Jon,1,Private room,110,37,4.39,147
30287,Melissa,2,Private room,47,0,0.06,47
30289,Liz,2,Private room,30,0,0.09,30
30290,Connie & Monty,2,Entire home/apt,139,344,1.49,483
30291,Analia,2,Private room,70,15,2.5,85
30292,Chloe,1,Entire home/apt,110,0,0.25,110
30293,Kar Man And Ariel,1,Private room,81,164,1.48,245
30294,Sarah,2,Private room,85,0,0.12,85
30295,Eduardo,1,Entire home/apt,68,13,3.92,81
30296,Hp,2,Entire home/apt,95,54,3.13,149
30297,Nada,2,Private room,80,0,0.17,80
30298,Nicole,1,Entire home/apt,409,106,3.15,515
30299,Lingqing,1,Private room,60,0,0.18,60
30302,Keyonna,1,Entire home/apt,66,0,0.48,66
30303,Batya,2,Entire home/apt,200,1,0.27,201
30305,Chloe,1,Private room,95,104,1.42,199
30306,Stephanie,2,Shared room,29,0,0.18,29
30309,Lia,1,Entire home/apt,240,156,0.14,396
30310,Matthew,2,Entire home/apt,162,0,0.24,162
30311,Jim&Lisa,3,Private room,46,180,1.65,226
30312,Sara I,5,Private room,31,357,0.19,388
30313,Bettina,3,Private room,100,32,1.86,132
30314,Pat And Shelly,2,Entire home/apt,159,285,0.78,444
30316,Elle,2,Entire home/apt,70,0,0.06,70
30317,Kacey,2,Private room,35,0,0.07,35
30318,Javier,2,Private room,59,27,0.62,86
30319,David,2,Entire home/apt,150,282,0.94,432
30320,Camilo & Yesenia,3,Private room,80,78,0.28,158
30321,Kerri,1,Entire home/apt,200,189,5.8,389
30322,Sadiq,1,Entire home/apt,225,17,1.36,242
30323,Lia,1,Entire home/apt,225,240,0.09,465
30324,Stacey,3,Entire home/apt,100,269,2.89,369
30325,Renato,2,Private room,96,25,2.31,121
30326,Joey,3,Private room,60,73,1.37,133
30327,Joey,3,Private room,60,64,0.88,124
30329,Joanna,1,Entire home/apt,145,155,1.13,300
30331,Tammy,3,Private room,75,0,0.29,75
30332,William,2,Private room,80,2,0.87,82
30333,Brad,2,Entire home/apt,155,14,1.04,169
30334,Bridge,1,Entire home/apt,100,229,0.34,329
30336,Lucie,2,Entire home/apt,120,35,5.59,155
30337,Tranquil,1,Entire home/apt,225,209,0.48,434
30338,Gen,1,Entire home/apt,175,0,0.26,175
30339,Angie,1,Private room,75,138,1.47,213
30340,Shopper,1,Private room,89,90,0.31,179
30343,Sherry,3,Private room,60,84,7.55,144
30344,Suzan,3,Private room,60,171,5.11,231
30347,Scott And Jill,2,Entire home/apt,250,213,4.89,463
30348,Antonio,1,Private room,80,365,0.06,445
30349,Jay,2,Private room,43,152,3.65,195
30350,Holman,1,Private room,99,0,0.19,99
30351,Jay,2,Private room,43,155,2.15,198
30352,Jay,2,Private room,43,170,2.04,213
30353,Karilyn,5,Entire home/apt,60,272,5.09,332
30354,Zachary,2,Private room,52,0,0.24,52
30355,Erin,2,Entire home/apt,110,0,2.31,110
30356,Erika,1,Private room,60,363,1.0,423
30357,Brian,2,Shared room,26,0,0.48,26
30358,Jim&Lisa,3,Private room,46,180,1.36,226
30359,David,2,Entire home/apt,200,50,3.33,250
30360,Clay,1,Entire home/apt,150,0,0.8,150
30361,Regi,1,Private room,80,20,2.24,100
30362,Massiel,4,Private room,65,135,0.13,200
30363,Madelaine,1,Entire home/apt,130,0,1.1,130
30364,Laura,1,Private room,90,339,0.63,429
30365,Gúney,1,Shared room,75,167,4.21,242
30366,Paris,2,Private room,40,89,0.18,129
30368,Nick,1,Entire home/apt,450,145,0.98,595
30369,Jeanne,2,Entire home/apt,150,32,4.27,182
30370,John,2,Entire home/apt,110,38,0.42,148
30371,Vanessa,2,Private room,101,90,0.34,191
30372,Dawa,3,Entire home/apt,135,89,4.27,224
30373,Meg,2,Private room,55,19,1.11,74
30374,Eduardo,3,Private room,51,125,3.93,176
30375,Eduardo,3,Private room,39,157,3.7,196
30376,Eduardo,3,Private room,37,150,4.06,187
30377,Eduardo,3,Private room,37,126,2.07,163
30378,Eduardo,3,Private room,37,126,1.96,163
30379,Louann,3,Private room,75,349,5.56,424
30381,Tanya,1,Entire home/apt,130,85,4.7,215
30382,Amanda Rose,1,Entire home/apt,479,3,3.24,482
30384,Delanique,3,Private room,89,5,2.57,94
30386,Natali,2,Entire home/apt,175,160,1.3,335
30387,Mary,1,Private room,36,0,0.07,36
30388,Jeerathinan,3,Private room,49,35,0.19,84
30390,Anthony,2,Entire home/apt,84,156,0.44,240
30391,Camilo,3,Private room,60,205,2.17,265
30392,Isabel,1,Entire home/apt,170,320,3.09,490
30393,Natalia Carolina,1,Entire home/apt,126,35,3.27,161
30394,Jason,2,Private room,100,20,0.13,120
30395,Jacob,1,Private room,55,341,0.13,396
30396,Tiffany,1,Entire home/apt,159,17,0.7,176
30397,Mason,2,Private room,90,20,1.0,110
30398,Patrick,2,Entire home/apt,90,0,2.75,90
30399,Sonia,3,Private room,30,254,3.54,284
30400,Agate,2,Entire home/apt,325,98,0.27,423
30403,Livia,2,Private room,70,223,0.32,293
30404,Quisqueya,4,Private room,80,17,2.07,97
30405,Regi,1,Entire home/apt,150,5,1.46,155
30406,Quisqueya,4,Private room,80,17,1.81,97
30407,Lindsay,1,Private room,83,44,4.57,127
30409,Caroline,3,Shared room,50,5,1.56,55
30411,Nathalia,3,Private room,40,0,0.9,40
30412,Marie,1,Entire home/apt,165,105,0.17,270
30413,Jennifer,2,Entire home/apt,130,1,1.3,131
30414,Zoe,2,Private room,65,0,0.42,65
30415,Jenny,2,Private room,50,0,0.25,50
30416,Rhonda,2,Entire home/apt,60,127,3.73,187
30417,Benjamin,2,Private room,42,0,0.07,42
30418,Sophia,1,Entire home/apt,158,106,2.88,264
30420,Audra,3,Entire home/apt,65,27,1.02,92
30421,Joseph,1,Entire home/apt,380,0,0.14,380
30422,Daapo,2,Entire home/apt,110,248,3.7,358
30423,Christopher,2,Entire home/apt,145,158,4.85,303
30424,Jermaine,2,Private room,77,89,0.38,166
30425,Jermaine,2,Private room,99,179,0.53,278
30426,Sol,1,Private room,89,213,0.68,302
30427,Paula,1,Private room,98,23,1.97,121
30428,Blueground,1,Entire home/apt,305,326,0.17,631
30429,Gúney,1,Shared room,75,172,3.25,247
30430,Gúney,1,Shared room,70,362,3.07,432
30431,Elizabeth,2,Private room,68,196,4.26,264
30432,Sophie,2,Entire home/apt,450,99,0.17,549
30433,Bonnie,2,Private room,40,0,0.22,40
30434,Jay,2,Entire home/apt,75,0,1.84,75
30436,Wyatt,1,Entire home/apt,200,124,1.46,324
30437,Malin,1,Entire home/apt,290,69,0.24,359
30438,Jennifer,4,Private room,50,326,1.16,376
30439,Wilfred,2,Entire home/apt,175,173,3.18,348
30440,Eileen,2,Entire home/apt,125,348,1.57,473
30441,Rory,1,Entire home/apt,96,2,2.03,98
30442,Julien,1,Entire home/apt,250,322,2.65,572
30443,David,1,Entire home/apt,135,171,0.28,306
30444,Antonella,2,Entire home/apt,140,0,0.19,140
30445,Henning,2,Private room,45,0,0.61,45
30446,Katie,2,Private room,75,7,0.13,82
30447,Elena,1,Entire home/apt,220,208,1.06,428
30448,Zihan,1,Entire home/apt,186,0,0.24,186
30449,Aigner,2,Private room,70,53,1.58,123
30450,Alistair,1,Entire home/apt,175,2,1.01,177
30451,Bess,2,Private room,55,0,0.31,55
30452,Nina,3,Entire home/apt,95,120,1.81,215
30453,Tyler,2,Private room,640,18,0.2,658
30454,Tony,3,Entire home/apt,278,68,2.12,346
30455,Marie,1,Entire home/apt,125,176,0.5,301
30456,LeMar,1,Entire home/apt,150,0,0.8,150
30457,Cha,3,Private room,65,41,2.21,106
30458,Ruben,2,Private room,43,47,0.76,90
30460,Lauren & Chelsea,2,Entire home/apt,285,3,0.39,288
30461,Janet,3,Private room,65,0,7.79,65
30462,Perla,1,Entire home/apt,85,188,0.12,273
30463,Dilan,1,Private room,120,31,0.19,151
30464,Kam,1,Entire home/apt,165,43,0.65,208
30465,Jen Supang,2,Private room,39,0,0.45,39
30467,Rob,2,Private room,40,0,0.74,40
30468,Mat,1,Entire home/apt,250,338,0.19,588
30469,Tone,2,Entire home/apt,140,77,3.68,217
30470,Aiko,2,Private room,60,0,0.73,60
30473,Rosan,3,Entire home/apt,135,0,3.52,135
30474,Marcelo,3,Entire home/apt,120,180,1.5,300
30476,Ali,3,Entire home/apt,200,338,3.38,538
30477,Joe,1,Private room,55,153,2.37,208
30478,Nick,2,Entire home/apt,86,311,9.53,397
30479,Fiorella,1,Entire home/apt,130,300,0.2,430
30480,Olivia,2,Entire home/apt,112,29,2.63,141
30481,Jestina,2,Private room,70,144,4.07,214
30482,Katy,1,Entire home/apt,275,0,0.37,275
30483,Ryan,2,Entire home/apt,150,11,0.52,161
30484,Megan,1,Entire home/apt,175,0,1.48,175
30485,Michelle,2,Entire home/apt,378,25,0.85,403
30487,Matt,2,Private room,65,0,4.4,65
30488,Milton,4,Entire home/apt,85,329,5.19,414
30490,Dee,1,Private room,46,0,0.82,46
30491,Alessandro,3,Entire home/apt,190,259,4.05,449
30492,Fiorella,1,Private room,70,358,0.26,428
30494,Kara,1,Entire home/apt,125,0,0.19,125
30495,Rich,2,Entire home/apt,175,0,0.15,175
30496,Orit,1,Private room,100,361,0.62,461
30497,Elizabeth,1,Entire home/apt,245,13,0.75,258
30498,Malissa,2,Entire home/apt,68,28,1.23,96
30499,Shireen,2,Entire home/apt,85,0,0.43,85
30500,Jon,2,Entire home/apt,95,6,0.52,101
30501,Stephanie,1,Private room,110,0,0.37,110
30502,Gabriela,2,Private room,74,162,1.31,236
30503,Jay R.,1,Private room,53,61,0.46,114
30504,Mike,1,Private room,45,90,0.07,135
30505,Chloe,2,Private room,125,1,0.06,126
30506,Sam,1,Private room,95,5,4.79,100
30507,Harold,2,Private room,45,16,1.04,61
30508,Libertad,2,Private room,250,0,0.21,250
30509,Dan,1,Entire home/apt,300,32,1.76,332
30510,Jacob,2,Entire home/apt,148,0,1.27,148
30511,Taylor,3,Private room,55,89,0.65,144
30512,Isaac,4,Private room,47,197,0.89,244
30514,Sunil,1,Entire home/apt,115,0,0.32,115
30515,Esther,2,Private room,55,0,0.06,55
30516,Nick,2,Entire home/apt,140,4,2.18,144
30517,Quisqueya,4,Entire home/apt,240,1,1.4,241
30519,Veronica,3,Private room,120,322,0.29,442
30520,Nathalie,2,Entire home/apt,200,266,0.41,466
30522,Matt,2,Private room,49,163,0.34,212
30525,Lisa,3,Private room,70,67,2.76,137
30526,Stephen Lionel,1,Entire home/apt,400,244,0.93,644
30527,Leona,1,Entire home/apt,199,112,4.23,311
30528,Alysha,1,Entire home/apt,194,177,1.23,371
30529,Pramila,1,Entire home/apt,500,179,0.12,679
30530,Cristian,1,Private room,105,300,2.38,405
30531,Paris,1,Private room,70,0,0.07,70
30533,Cherie,1,Entire home/apt,187,6,0.86,193
30534,Ellen,1,Entire home/apt,250,0,1.24,250
30535,Jenny,1,Private room,53,0,0.06,53
30537,Aurora,2,Entire home/apt,100,0,0.06,100
30538,Catherine,2,Private room,65,0,0.56,65
30539,Dan,1,Private room,110,117,2.02,227
30540,Marcie,2,Private room,36,0,0.68,36
30541,Sherry,3,Private room,40,69,4.81,109
30542,Tony,1,Entire home/apt,185,47,2.02,232
30543,Kate,2,Entire home/apt,175,27,0.45,202
30544,Jane,2,Private room,65,160,0.9,225
30545,David,2,Private room,42,10,0.64,52
30546,Gani,2,Shared room,25,81,0.81,106
30547,Luka,2,Private room,72,0,0.99,72
30548,Felipe,1,Private room,45,242,0.36,287
30549,Lo,2,Entire home/apt,77,32,0.94,109
30550,Robert,1,Private room,120,0,0.24,120
30551,Meg,2,Entire home/apt,70,0,0.39,70
30552,Sherry,3,Private room,35,75,4.82,110
30553,Terry,1,Entire home/apt,200,365,0.76,565
30554,Melissa,3,Private room,70,0,0.38,70
30556,Vijay,1,Private room,179,270,0.25,449
30557,Genna,1,Entire home/apt,110,0,0.14,110
30558,Cherie,1,Entire home/apt,374,3,0.84,377
30560,Bashiri,2,Entire home/apt,175,285,2.72,460
30561,Hugo,2,Private room,42,0,0.5,42
30562,Lawrence,1,Private room,350,87,0.13,437
30563,Noelle,3,Entire home/apt,200,42,2.84,242
30564,Rene,2,Private room,65,342,0.25,407
30566,Lorna,2,Entire home/apt,150,187,0.64,337
30567,Rainier,1,Private room,115,0,3.33,115
30568,Gúney,1,Shared room,75,362,3.64,437
30569,Elizabeth,2,Private room,62,50,4.19,112
30571,Ofir,1,Entire home/apt,150,332,0.07,482
30572,Virginia,2,Private room,75,0,0.08,75
30573,Lohlah,3,Private room,45,90,0.57,135
30574,Mytasha,1,Private room,90,5,2.02,95
30575,Camila,3,Entire home/apt,113,41,3.26,154
30577,Julie,2,Entire home/apt,186,22,1.36,208
30579,Shera,4,Private room,34,5,8.24,39
30580,Beethoven,3,Private room,72,364,0.38,436
30581,Jonathon,2,Private room,42,292,2.34,334
30582,Tom,2,Entire home/apt,250,0,0.31,250
30583,Alberto,1,Entire home/apt,120,267,0.53,387
30584,Alberto,1,Entire home/apt,120,246,0.4,366
30586,Alberto,1,Entire home/apt,137,182,1.03,319
30587,Alberto,1,Entire home/apt,163,221,1.42,384
30588,Alberto,1,Entire home/apt,153,226,0.49,379
30589,Alberto,1,Entire home/apt,120,257,0.47,377
30590,Alberto,1,Entire home/apt,137,218,0.96,355
30591,Alberto,1,Entire home/apt,120,200,0.51,320
30592,Alberto,1,Entire home/apt,163,225,0.63,388
30593,Alberto,1,Entire home/apt,153,216,0.27,369
30594,Alberto,1,Entire home/apt,137,162,0.34,299
30595,Alberto,1,Entire home/apt,120,232,0.51,352
30596,Alberto,1,Entire home/apt,208,215,0.3,423
30597,Alberto,1,Entire home/apt,153,234,0.7,387
30598,Alberto,1,Entire home/apt,163,239,0.57,402
30599,Emily,2,Entire home/apt,110,125,1.63,235
30600,Edwin,1,Private room,400,166,1.33,566
30602,Mj,4,Entire home/apt,360,71,0.51,431
30603,דניאל,1,Private room,120,0,0.16,120
30604,Tasos,2,Entire home/apt,95,0,0.06,95
30605,Dylan,2,Private room,50,57,5.1,107
30607,Sissy,4,Shared room,26,312,0.67,338
30608,Sophia,2,Entire home/apt,189,270,0.43,459
30611,East Village,1,Entire home/apt,400,161,0.51,561
30612,Maryam,1,Private room,90,0,0.93,90
30613,Tyler,1,Private room,400,2,0.14,402
30614,Alexis,1,Entire home/apt,245,272,1.74,517
30615,Nick,1,Private room,100,0,0.19,100
30616,Antoinette,2,Entire home/apt,125,215,3.44,340
30617,Patrizio,1,Entire home/apt,220,9,0.25,229
30619,Ermina,3,Private room,55,83,0.82,138
30620,Amir,2,Entire home/apt,250,140,2.39,390
30621,Emmanuel,1,Private room,110,176,4.34,286
30622,Abir,3,Private room,45,0,1.15,45
30624,Kaiti,1,Entire home/apt,175,37,2.89,212
30625,Tara & Carl,1,Private room,81,28,2.56,109
30626,Gúney,1,Shared room,75,174,3.64,249
30627,Sergii,2,Shared room,37,342,0.21,379
30628,Sergii,2,Shared room,32,341,0.28,373
30629,Gabriella,1,Entire home/apt,200,242,3.34,442
30630,Susana,2,Entire home/apt,120,177,0.16,297
30631,Nina,2,Entire home/apt,150,2,0.8,152
30632,Anne-Katrin,2,Private room,70,0,0.15,70
30634,Rina,1,Private room,108,0,0.44,108
30635,Mary,1,Entire home/apt,91,0,0.13,91
30638,Virginia,1,Private room,105,60,3.04,165
30639,Virginia,1,Private room,147,57,0.3,204
30640,Sonder,1,Entire home/apt,205,338,0.07,543
30641,Stephen,1,Entire home/apt,92,0,0.74,92
30642,Karen,2,Entire home/apt,139,70,1.61,209
30643,Elizabeth,3,Private room,100,0,0.09,100
30644,Jennifer,1,Private room,55,38,0.08,93
30645,Michelle,1,Entire home/apt,80,183,4.54,263
30646,Shani & Emily,2,Private room,75,0,0.39,75
30647,Ibrahim Maiga,4,Private room,40,291,5.01,331
30648,Alfredo,2,Entire home/apt,400,0,0.21,400
30649,Sonder,1,Entire home/apt,205,10,0.14,215
30650,Tanya,1,Private room,70,0,0.37,70
30651,Claudio,1,Private room,80,178,3.41,258
30652,Brooke,1,Entire home/apt,220,1,2.51,221
30654,Tess,1,Private room,119,86,1.31,205
30655,Chuck,2,Private room,44,0,0.06,44
30659,Alexandra,3,Private room,60,326,1.0,386
30660,Harry,1,Entire home/apt,178,83,2.75,261
30662,Sarah,1,Private room,175,63,0.77,238
30664,Khorkhe,2,Entire home/apt,130,41,1.06,171
30665,Charlene,2,Entire home/apt,135,29,2.21,164
30666,Kalani,3,Entire home/apt,100,267,3.68,367
30667,Kimberley,3,Entire home/apt,325,365,2.0,690
30668,Joycelyn,2,Entire home/apt,150,210,3.31,360
30669,Mel,2,Entire home/apt,100,328,1.25,428
30670,Eric,2,Private room,45,0,0.19,45
30671,Mafer,2,Private room,75,84,1.79,159
30672,Ty,1,Private room,30,0,0.94,30
30673,Florentino & Brian,2,Private room,130,290,2.05,420
30675,Chiara,2,Entire home/apt,105,38,2.44,143
30676,Jennifer,3,Entire home/apt,75,0,1.97,75
30677,Whitney,1,Entire home/apt,150,3,2.72,153
30678,Mie,1,Entire home/apt,89,7,0.14,96
30679,Genae,4,Private room,57,220,0.42,277
30681,Kevin,3,Private room,50,156,3.94,206
30682,Andy,1,Entire home/apt,325,179,2.77,504
30683,Alex,2,Entire home/apt,300,1,4.63,301
30685,Suzane,3,Entire home/apt,150,175,2.65,325
30686,Antonio,1,Entire home/apt,99,63,3.5,162
30688,Alex & Yoly,1,Entire home/apt,250,47,5.54,297
30690,Juliette,2,Entire home/apt,112,0,3.04,112
30691,Emanuel,1,Entire home/apt,175,175,1.13,350
30692,Burton,1,Private room,95,0,0.06,95
30693,Julia,2,Entire home/apt,100,65,1.55,165
30696,Cory,1,Entire home/apt,280,0,0.56,280
30697,Pascal-Louis,2,Entire home/apt,750,178,0.13,928
30698,Anna,2,Private room,55,0,0.06,55
30703,Benjamin,1,Private room,93,0,0.13,93
30704,Jude,2,Entire home/apt,125,64,2.93,189
30706,Kellie & Joachim,2,Entire home/apt,105,77,5.08,182
30708,Paul,4,Entire home/apt,69,343,0.75,412
30709,Vas,4,Private room,47,130,3.8,177
30710,Katie,1,Private room,50,358,0.13,408
30711,Saphira,1,Private room,120,0,0.62,120
30713,Kurt,2,Entire home/apt,84,0,0.06,84
30714,Jay,3,Entire home/apt,89,64,4.33,153
30715,Miranda,2,Private room,90,0,0.87,90
30719,Déborah,2,Entire home/apt,220,0,0.59,220
30720,Petar,1,Entire home/apt,172,195,0.5,367
30721,Emerson,2,Entire home/apt,550,38,0.28,588
30722,Megan,2,Entire home/apt,800,362,0.21,1162
30724,John,3,Entire home/apt,175,0,0.66,175
30725,Tony,3,Entire home/apt,149,63,1.81,212
30726,Tony,3,Entire home/apt,149,74,1.78,223
30727,Agathe,2,Entire home/apt,190,0,0.07,190
30728,Paul,1,Entire home/apt,600,0,0.07,600
30729,Dasha,2,Private room,96,0,0.77,96
30730,Angie,2,Private room,125,255,0.86,380
30731,Mitchell,1,Entire home/apt,166,0,0.13,166
30732,Alexi,2,Private room,45,0,0.33,45
30733,Jonathon André,2,Private room,75,17,4.2,92
30734,Ty,1,Private room,30,0,0.33,30
30735,Delcio,3,Private room,70,189,0.19,259
30736,Eliana,1,Entire home/apt,300,0,0.13,300
30737,Rebeca,2,Entire home/apt,200,25,1.78,225
30738,Jayu,1,Private room,160,3,8.27,163
30739,Asia,1,Entire home/apt,300,286,2.16,586
30740,Ken,1,Private room,90,21,4.46,111
30741,Joe,1,Entire home/apt,375,77,1.65,452
30742,Alyssa,2,Entire home/apt,100,0,0.45,100
30743,Leah,2,Private room,50,296,2.22,346
30744,Linnea,1,Private room,89,38,7.97,127
30745,Susannah,1,Private room,60,132,4.97,192
30746,Kerelle,2,Entire home/apt,100,34,1.16,134
30747,Sergii,2,Private room,65,341,0.19,406
30749,Garcia,2,Entire home/apt,125,290,4.45,415
30751,Sergii,2,Shared room,35,365,0.19,400
30752,Alan,3,Entire home/apt,85,256,0.2,341
30753,Sarah,2,Private room,86,156,2.34,242
30756,Allan C.,1,Private room,99,31,0.96,130
30757,Eva,1,Entire home/apt,50,0,0.75,50
30758,Chance,1,Entire home/apt,270,17,1.56,287
30759,Andrea,3,Entire home/apt,195,302,1.49,497
30760,Ez,1,Entire home/apt,110,193,3.4,303
30761,Allan C.,1,Private room,80,0,0.92,80
30762,Michael,1,Private room,85,0,0.14,85
30763,Nick,1,Entire home/apt,125,0,0.89,125
30765,David,2,Private room,75,89,1.27,164
30766,Jeffrey,2,Private room,55,188,0.53,243
30767,Felisha,2,Private room,35,28,2.83,63
30768,Sophia,2,Private room,48,0,0.14,48
30769,Nour,1,Private room,129,110,5.95,239
30770,Aravind,1,Private room,139,189,1.24,328
30771,Nour,1,Private room,129,114,6.11,243
30774,Jasmaine,2,Entire home/apt,85,32,2.28,117
30775,Ez,3,Entire home/apt,105,235,2.54,340
30776,Nadira,2,Entire home/apt,600,167,0.98,767
30777,Kris,2,Entire home/apt,110,90,1.05,200
30778,Quentin,2,Entire home/apt,280,11,0.39,291
30779,Johnny,2,Private room,75,167,1.62,242
30780,Chelsea,2,Private room,50,0,0.07,50
30781,Rick,2,Private room,40,0,0.46,40
30782,Holly,3,Private room,60,0,1.5,60
30783,David,1,Entire home/apt,375,0,0.46,375
30784,Omar,1,Private room,30,94,6.03,124
30785,Brette,2,Shared room,45,35,0.13,80
30786,Aj,2,Entire home/apt,100,79,5.8,179
30787,Kat,2,Private room,67,102,2.31,169
30788,Zander,1,Entire home/apt,200,176,1.87,376
30789,Gilles,1,Private room,65,8,0.75,73
30790,Sebastian,5,Entire home/apt,110,19,4.47,129
30791,Gustavo,2,Private room,49,5,3.13,54
30792,Annie,1,Private room,39,0,0.16,39
30793,Sam,1,Entire home/apt,199,293,2.44,492
30794,Antonia,3,Private room,65,354,1.49,419
30795,Devon,1,Private room,45,318,0.1,363
30796,Jesse,1,Entire home/apt,196,0,0.46,196
30797,Beth,2,Private room,65,9,4.59,74
30798,Wendy,2,Private room,47,272,2.05,319
30799,L.Marce,3,Entire home/apt,110,94,1.54,204
30800,Lisa,1,Entire home/apt,240,0,0.4,240
30801,Frederic,1,Private room,45,195,3.85,240
30802,Jamie,2,Entire home/apt,225,26,0.06,251
30803,Alex,2,Entire home/apt,200,3,1.01,203
30804,Luis,2,Private room,45,0,0.14,45
30805,Deborah,1,Entire home/apt,171,0,0.08,171
30807,J,1,Entire home/apt,170,0,1.12,170
30808,Megan,3,Entire home/apt,125,8,0.84,133
30809,Joey,2,Entire home/apt,45,0,0.19,45
30810,Ryan,1,Entire home/apt,150,66,0.51,216
30811,Kola,2,Private room,106,0,0.06,106
30813,Joey,3,Private room,50,45,2.39,95
30814,Joey,3,Private room,50,59,1.53,109
30815,MJ & Al,2,Private room,90,231,2.24,321
30816,Vika & Josh,2,Private room,60,324,2.8,384
30817,Marina,2,Entire home/apt,154,80,0.35,234
30818,David,1,Private room,80,0,1.44,80
30819,Zain,4,Private room,65,364,0.21,429
30821,Andrew,1,Private room,149,0,0.06,149
30822,Celia,2,Private room,66,0,0.08,66
30823,Judy,2,Entire home/apt,150,3,0.24,153
30824,Ilo And Richard,1,Entire home/apt,2990,237,4.36,3227
30825,S.,2,Entire home/apt,69,219,4.06,288
30826,Ndeye Aissatou,2,Shared room,30,67,6.31,97
30827,Sergii,2,Private room,65,341,0.13,406
30828,Ben,2,Private room,31,0,0.06,31
30829,Hugo,2,Entire home/apt,120,301,0.2,421
30830,Jose,1,Entire home/apt,140,0,1.51,140
30831,Katy,2,Private room,55,0,0.13,55
30832,Kevin,3,Private room,50,172,3.9,222
30833,Erin,2,Private room,60,0,0.45,60
30834,Sonder,1,Entire home/apt,179,333,0.36,512
30835,Nevine,3,Private room,45,101,0.56,146
30836,Sonder,1,Entire home/apt,187,332,0.71,519
30837,Sebastian,1,Private room,50,0,0.14,50
30839,Ann,2,Entire home/apt,249,32,3.94,281
30840,Sonder,1,Entire home/apt,182,259,0.21,441
30841,John,2,Private room,40,3,1.28,43
30842,Eliana,3,Private room,60,156,0.42,216
30843,Ana Y Hugo,3,Private room,50,282,2.22,332
30844,Eva,2,Entire home/apt,175,297,3.88,472
30845,Bernadette,2,Entire home/apt,195,258,3.87,453
30846,John,2,Private room,40,0,2.59,40
30847,Elizabeth,4,Private room,60,156,0.46,216
30848,Derek,2,Private room,75,67,0.36,142
30849,Nicole,2,Private room,40,0,0.07,40
30850,Michael,2,Entire home/apt,150,0,0.14,150
30852,Jessica,1,Private room,72,32,0.41,104
30853,Carlos,2,Entire home/apt,95,9,0.31,104
30854,Michele & Lucien,2,Entire home/apt,100,0,3.08,100
30855,Kristal,2,Private room,75,0,2.61,75
30856,Daniel,1,Entire home/apt,250,0,0.63,250
30857,J,1,Entire home/apt,1000,365,0.25,1365
30858,Erin,2,Private room,60,0,0.22,60
30859,Shelby,1,Entire home/apt,163,0,0.48,163
30861,Elise,2,Private room,48,0,0.07,48
30864,Michael,1,Entire home/apt,339,0,2.26,339
30865,Jon,2,Private room,40,0,0.63,40
30866,Gregorio,3,Private room,60,175,4.64,235
30867,Michael,1,Entire home/apt,339,0,2.27,339
30868,Gregorio,3,Private room,65,180,1.15,245
30869,Michael,1,Entire home/apt,269,0,0.35,269
30870,Michael,1,Entire home/apt,269,0,0.36,269
30871,Michael,1,Entire home/apt,269,0,0.38,269
30873,Ashumi,1,Entire home/apt,180,4,1.22,184
30874,Eric,1,Entire home/apt,200,0,3.31,200
30875,Bonnie,1,Shared room,63,56,1.2,119
30876,Crystal,1,Entire home/apt,65,9,0.13,74
30877,Luis,1,Entire home/apt,300,28,7.5,328
30878,Micah,2,Private room,100,45,3.45,145
30879,Ben,2,Entire home/apt,95,0,0.58,95
30880,Bettina,4,Entire home/apt,190,8,1.47,198
30881,Rachel,2,Entire home/apt,300,224,0.16,524
30882,Renata,3,Entire home/apt,231,0,0.27,231
30883,Allegra,2,Entire home/apt,125,269,5.41,394
30884,Marcus,2,Private room,45,337,2.95,382
30885,Allison,1,Private room,64,0,0.26,64
30886,Ben,2,Private room,150,0,0.06,150
30887,Ana,2,Private room,50,0,0.07,50
30888,William,1,Entire home/apt,115,0,0.2,115
30889,Josseline,2,Private room,29,0,0.08,29
30891,Ali,1,Private room,105,342,0.14,447
30892,Soon,3,Private room,40,342,0.11,382
30893,Soon,3,Private room,50,296,0.4,346
30894,Jillian,1,Entire home/apt,199,0,0.91,199
30895,Vicky,3,Private room,49,341,3.47,390
30896,Matthieu,2,Entire home/apt,105,0,0.82,105
30897,Rachel,2,Private room,50,365,0.32,415
30898,Ana,2,Private room,45,13,0.19,58
30899,Rebecca,2,Private room,95,54,3.42,149
30900,Edna,2,Private room,47,12,2.38,59
30901,Ashley,1,Entire home/apt,100,5,0.22,105
30902,Sergii,2,Private room,65,341,0.3,406
30903,Abbie,1,Private room,105,286,2.71,391
30904,Elizabeth,2,Private room,50,176,3.29,226
30905,Jenna,2,Entire home/apt,175,222,3.58,397
30908,Gregorio,3,Private room,75,160,7.98,235
30909,Jessica,2,Private room,45,0,0.46,45
30910,Laila,1,Entire home/apt,125,283,0.34,408
30912,Michelle,2,Private room,60,85,3.33,145
30913,Cindy,1,Entire home/apt,148,123,3.59,271
30914,Endazsia,2,Entire home/apt,50,0,1.75,50
30915,Kristen,2,Entire home/apt,150,0,0.2,150
30916,Patti,1,Entire home/apt,1000,37,3.5,1037
30917,Stephanie,2,Entire home/apt,135,10,3.78,145
30918,Aleksandra,2,Entire home/apt,140,165,1.23,305
30919,Gio,1,Private room,159,0,4.29,159
30920,Peiyi,1,Entire home/apt,50,4,8.06,54
30922,Lucy,1,Private room,49,1,0.15,50
30923,P,1,Entire home/apt,600,6,4.49,606
30924,Carlos,2,Private room,70,0,0.93,70
30926,Sage,2,Entire home/apt,200,32,2.0,232
30927,Marlyn,2,Private room,49,346,1.24,395
30929,Katharina,2,Private room,45,0,0.15,45
30930,Carol,2,Private room,35,79,1.68,114
30931,Killa,2,Entire home/apt,180,35,0.65,215
30932,Steven,1,Private room,100,6,3.53,106
30933,Ketia,2,Entire home/apt,155,302,6.97,457
30934,Samet,1,Private room,80,0,1.46,80
30935,Johnny,1,Private room,70,260,4.69,330
30936,Crispy,3,Private room,38,163,1.03,201
30937,Adeola,1,Private room,70,90,0.41,160
30938,Rafael,3,Private room,38,48,2.61,86
30939,Tanya & Mirjan,1,Private room,75,1,4.6,76
30940,Jessica,1,Entire home/apt,120,157,1.33,277
30941,Cyndi,1,Entire home/apt,200,16,0.07,216
30942,Nebojsa,2,Entire home/apt,160,46,0.35,206
30943,Latoya,3,Private room,28,43,2.25,71
30944,Emily,1,Entire home/apt,210,318,1.04,528
30946,Gustavo,2,Entire home/apt,120,0,0.13,120
30947,Michelle,2,Entire home/apt,77,0,0.2,77
30948,Tsilala,1,Private room,80,0,0.27,80
30950,Graham,2,Entire home/apt,124,0,0.13,124
30951,Andrew,2,Private room,30,0,0.07,30
30952,Avner,1,Private room,65,365,0.71,430
30953,Avner,1,Private room,65,365,0.28,430
30955,Chloé,1,Entire home/apt,90,24,0.13,114
30956,Alexandra,2,Entire home/apt,225,0,0.07,225
30957,Ben,3,Private room,48,0,0.13,48
30958,Lina,1,Private room,39,4,0.81,43
30959,Grace,2,Entire home/apt,88,18,0.56,106
30960,Melissa,2,Entire home/apt,159,191,0.16,350
30961,Laurin,2,Entire home/apt,99,0,0.72,99
30962,Esmee,3,Private room,40,0,1.68,40
30963,Jonathan,3,Private room,35,0,0.32,35
30965,Navi,1,Entire home/apt,620,309,2.52,929
30966,David,1,Shared room,75,0,0.52,75
30967,Lissette,5,Private room,37,341,3.4,378
30968,Michelle,1,Entire home/apt,200,8,2.51,208
30969,Elena,2,Private room,75,336,0.6,411
30970,Abe,5,Private room,50,88,2.64,138
30972,Valentine,1,Entire home/apt,95,5,0.37,100
30973,Anthony,2,Entire home/apt,80,0,0.86,80
30974,Laura,3,Private room,50,334,1.4,384
30975,Keisha,2,Private room,55,362,1.74,417
30976,Peter,1,Private room,48,0,0.19,48
30977,Cj,2,Entire home/apt,100,0,0.2,100
30978,Montage Yuriy,2,Entire home/apt,99,350,2.39,449
30979,Ky-Tsuyo,1,Private room,74,26,1.7,100
30980,Elena,2,Private room,65,43,4.13,108
30981,Ben,2,Entire home/apt,158,5,0.2,163
30982,Wj,5,Private room,40,71,1.0,111
30983,Melissa,1,Entire home/apt,119,0,0.2,119
30984,Jeremy,3,Entire home/apt,325,129,4.49,454
30985,Nick,1,Entire home/apt,215,51,3.34,266
30987,Nick & Gaby,2,Private room,65,62,3.71,127
30989,Katarina,3,Entire home/apt,230,51,2.97,281
30990,Katarina,3,Entire home/apt,188,140,2.26,328
30991,Tj,1,Entire home/apt,140,7,1.24,147
30992,Suzan,3,Private room,60,177,8.87,237
30993,Erica,2,Entire home/apt,95,327,4.52,422
30994,Anokhi,1,Private room,100,0,0.06,100
30995,Daniel,1,Entire home/apt,175,15,0.34,190
30996,Jessica,2,Private room,45,0,0.46,45
30997,Ryan,2,Private room,70,3,0.63,73
30998,Tom,1,Private room,60,94,2.34,154
30999,David,1,Private room,95,0,1.47,95
31000,Alex,2,Entire home/apt,70,0,0.19,70
31001,Christopher,1,Entire home/apt,119,41,0.58,160
31002,Gizem,2,Private room,120,8,0.66,128
31003,Najah,1,Entire home/apt,115,0,0.48,115
31004,Serenity,1,Entire home/apt,125,25,1.44,150
31005,Shirley,2,Private room,45,21,2.06,66
31006,Dan (Leo),1,Private room,89,32,0.58,121
31007,Sarah,2,Private room,75,0,3.04,75
31008,Edouard,1,Entire home/apt,240,17,0.63,257
31010,Nicole,2,Private room,40,216,0.45,256
31011,Christine,3,Entire home/apt,100,260,1.99,360
31012,Jason,2,Private room,60,21,1.2,81
31013,Yoav,2,Private room,45,3,0.58,48
31014,Ociel,4,Private room,50,75,2.14,125
31015,Lauren,2,Entire home/apt,175,357,1.67,532
31016,Vicky,3,Private room,60,0,2.68,60
31017,Riomar,3,Entire home/apt,99,0,0.27,99
31018,Mackenzie,2,Private room,70,0,2.15,70
31019,Teresa,1,Entire home/apt,260,86,2.56,346
31020,Tony,3,Entire home/apt,159,61,2.68,220
31021,Friday,5,Entire home/apt,60,361,3.48,421
31023,Melissa,1,Entire home/apt,78,13,0.31,91
31024,Eleni,2,Entire home/apt,180,1,0.22,181
31025,Amelia,1,Entire home/apt,80,0,0.07,80
31026,Carla Isabel,2,Entire home/apt,250,41,1.05,291
31027,Travis,2,Private room,50,0,2.04,50
31028,Scott,2,Entire home/apt,118,0,0.21,118
31029,Lisa,3,Shared room,42,66,3.48,108
31030,Nafsica,1,Private room,69,172,0.46,241
31032,Cindy,1,Private room,100,0,0.88,100
31033,Yaniv,1,Private room,110,0,4.51,110
31034,Séamus,2,Entire home/apt,155,53,1.28,208
31035,Ivana,3,Entire home/apt,150,89,2.04,239
31036,Mikaela,1,Entire home/apt,119,0,1.07,119
31037,Colin,1,Private room,89,105,2.73,194
31038,Daniel,1,Entire home/apt,399,78,1.38,477
31039,Bruce & Suzanne,1,Entire home/apt,275,0,0.52,275
31040,Joseph,2,Entire home/apt,150,0,0.06,150
31041,Jeremie,1,Entire home/apt,140,0,0.41,140
31042,Ernesto,1,Entire home/apt,199,0,0.54,199
31043,David,1,Private room,65,0,0.07,65
31044,Samir,1,Private room,100,77,4.39,177
31045,Louis,3,Entire home/apt,103,0,0.07,103
31046,William,1,Entire home/apt,649,199,2.59,848
31047,Danese,1,Private room,85,78,1.93,163
31048,Felix,4,Private room,79,59,3.0,138
31049,Samantha,2,Entire home/apt,96,257,4.37,353
31050,Michael,2,Private room,70,14,2.73,84
31051,Brady,2,Private room,57,0,0.6,57
31052,Valeria,1,Private room,274,238,0.24,512
31054,Annette,2,Private room,90,69,3.68,159
31055,Nyota,2,Entire home/apt,100,365,2.26,465
31056,Ashley,1,Entire home/apt,412,133,4.45,545
31057,Ashley,1,Entire home/apt,412,227,3.48,639
31058,Ashley,1,Entire home/apt,412,234,4.45,646
31061,Sabrina,2,Entire home/apt,120,334,0.41,454
31062,Hiroki,3,Private room,41,1,0.1,42
31063,Allan C.,1,Private room,70,32,1.22,102
31064,Aki,1,Private room,90,6,0.07,96
31065,Allan C.,1,Private room,99,45,1.88,144
31066,Salim,1,Private room,10,0,0.13,10
31068,Hulon,1,Private room,54,5,1.45,59
31069,Barry,4,Private room,35,0,0.4,35
31070,Nimo,2,Private room,39,0,0.41,39
31073,Ari,1,Entire home/apt,148,5,0.21,153
31074,Fran,3,Private room,60,164,0.92,224
31075,Catherine,2,Entire home/apt,130,0,0.15,130
31076,Daniel Rusteen,4,Entire home/apt,95,193,2.89,288
31077,Renat,1,Private room,65,9,4.14,74
31078,Kareem,2,Private room,20,18,0.26,38
31079,Krystle,3,Entire home/apt,190,327,1.49,517
31081,Woody,2,Private room,55,0,1.67,55
31082,Woody,2,Private room,49,0,2.67,49
31083,Milena,1,Private room,100,275,4.19,375
31084,Myriam,2,Private room,52,0,0.81,52
31085,Christophe,4,Private room,35,365,1.56,400
31086,Michelle & Evelyn,3,Private room,45,44,6.56,89
31087,Melissa,2,Private room,41,0,1.19,41
31088,Matthew,1,Entire home/apt,275,0,0.13,275
31089,Cindy,1,Entire home/apt,265,322,0.35,587
31090,Katya,1,Entire home/apt,250,57,1.0,307
31091,Nikki,1,Private room,130,0,0.48,130
31092,Daniyal,1,Private room,55,0,0.2,55
31093,Rich,1,Entire home/apt,365,0,0.07,365
31094,Luisa,2,Private room,70,321,0.42,391
31095,Maryam,1,Shared room,30,0,0.32,30
31096,Lea,1,Entire home/apt,225,323,1.87,548
31097,East Village,1,Entire home/apt,650,164,0.75,814
31098,Christine,2,Private room,95,0,0.7,95
31099,East Village,1,Entire home/apt,500,121,0.4,621
31101,East Village,1,Entire home/apt,750,151,1.27,901
31102,Rafael,2,Private room,46,0,0.26,46
31104,Johnny,1,Entire home/apt,140,0,2.27,140
31106,Ellie,1,Entire home/apt,140,0,0.2,140
31107,John,2,Entire home/apt,199,55,1.03,254
31109,Ling,3,Private room,69,90,5.95,159
31110,Chris,1,Entire home/apt,188,0,0.2,188
31111,Valerie,1,Entire home/apt,100,0,0.39,100
31112,Allison,2,Entire home/apt,235,3,0.32,238
31113,Gregory,1,Entire home/apt,165,81,2.81,246
31114,Alisha,3,Entire home/apt,55,0,0.26,55
31115,Luke&Quincey,1,Private room,65,156,0.07,221
31116,Janelle,2,Entire home/apt,70,2,0.09,72
31117,Joe,1,Private room,125,43,2.03,168
31118,Lara,2,Entire home/apt,90,0,1.31,90
31119,Sacha,2,Private room,56,0,0.67,56
31120,Conchita,1,Entire home/apt,394,13,0.12,407
31121,Margaret,2,Entire home/apt,172,0,0.27,172
31122,Eleanor,2,Entire home/apt,100,0,0.47,100
31124,Ashley,1,Entire home/apt,142,0,0.3,142
31125,Christina Jo,2,Entire home/apt,220,85,0.64,305
31126,Zani,1,Entire home/apt,264,94,1.19,358
31128,Steve,2,Entire home/apt,200,102,2.8,302
31129,John,2,Private room,45,0,0.08,45
31130,Patti,2,Private room,150,0,0.53,150
31131,Masa,1,Entire home/apt,160,203,3.35,363
31132,Fernando,3,Entire home/apt,135,141,3.08,276
31133,Kevin,3,Private room,55,345,3.75,400
31134,Kris,2,Private room,50,363,7.57,413
31136,Sarah,3,Private room,49,11,0.4,60
31137,Kelley,1,Entire home/apt,185,29,1.13,214
31138,Mario,1,Entire home/apt,180,10,2.14,190
31139,Tyrone,2,Private room,70,17,2.33,87
31140,Tim,2,Entire home/apt,450,22,0.35,472
31141,Farah,1,Entire home/apt,110,0,0.46,110
31143,Grainne,2,Private room,72,0,0.14,72
31144,Nate,2,Private room,80,54,0.29,134
31145,Elsie,2,Private room,44,322,2.06,366
31146,Marcus,2,Private room,45,308,2.61,353
31147,Kris,2,Private room,71,317,5.6,388
31148,Elsie,2,Private room,60,359,2.78,419
31149,Elsie,2,Private room,65,356,1.9,421
31150,Angie,1,Entire home/apt,300,178,0.2,478
31151,Leesha,2,Private room,99,295,4.59,394
31152,Kris,2,Private room,79,295,4.91,374
31153,Michael,1,Entire home/apt,339,0,1.93,339
31154,Emilio,3,Private room,58,0,0.2,58
31155,Alyssa,2,Private room,90,0,2.18,90
31157,Wyatt,1,Entire home/apt,158,2,1.34,160
31158,Maryse,1,Entire home/apt,145,278,0.23,423
31159,Mellissa,2,Private room,60,134,3.12,194
31160,Lynn Liz,1,Entire home/apt,99,98,3.54,197
31161,Krzysztof,2,Entire home/apt,80,161,0.42,241
31162,Jimmy,2,Private room,85,16,3.78,101
31163,David,1,Private room,115,128,2.55,243
31164,Anaiya,1,Private room,52,0,0.2,52
31165,Brian,3,Entire home/apt,280,108,3.44,388
31166,Christina,1,Entire home/apt,250,7,1.33,257
31167,Juan,1,Private room,55,157,0.55,212
31168,Samantha,1,Entire home/apt,100,8,0.44,108
31169,Lidor,2,Entire home/apt,195,0,0.49,195
31170,Calvin,1,Private room,80,88,1.25,168
31171,Lidziya,1,Private room,100,45,1.25,145
31172,Angela,2,Private room,55,0,0.35,55
31173,Julia,1,Entire home/apt,120,34,0.09,154
31174,Courtney,1,Entire home/apt,300,87,0.95,387
31175,Michael,1,Entire home/apt,339,0,2.07,339
31176,Maureen,2,Entire home/apt,140,65,1.0,205
31178,Kevin4,3,Shared room,21,260,1.64,281
31179,Samantha,2,Entire home/apt,125,78,3.8,203
31180,Reina,2,Private room,47,278,4.33,325
31181,Josh & Carin,1,Private room,180,0,1.96,180
31182,Diana,2,Private room,58,0,0.07,58
31184,Maya,1,Private room,150,8,4.11,158
31185,Miley,1,Private room,120,134,4.93,254
31186,Megwyn,2,Private room,47,12,3.67,59
31187,Emily,1,Entire home/apt,288,109,2.93,397
31188,Elsie,2,Private room,65,343,2.65,408
31189,Patti,2,Entire home/apt,300,129,1.22,429
31190,Rachel,1,Private room,104,0,0.07,104
31191,Ayelet,2,Entire home/apt,160,0,1.43,160
31194,Jenn,2,Private room,73,48,1.64,121
31195,Mat,1,Entire home/apt,195,311,0.21,506
31196,Santiago,1,Entire home/apt,200,0,0.16,200
31197,Carlos,2,Private room,100,365,0.5,465
31198,Jimmy,2,Private room,300,14,0.53,314
31199,Taras,2,Entire home/apt,150,0,1.27,150
31200,Jocelyn,1,Entire home/apt,190,3,0.54,193
31201,Charles,2,Private room,75,342,1.91,417
31202,Greg,1,Private room,81,0,0.39,81
31203,Raquel,4,Private room,25,0,0.14,25
31204,Rose,1,Entire home/apt,275,359,1.36,634
31205,Vera,3,Private room,60,365,0.07,425
31206,Analia,2,Entire home/apt,180,233,3.52,413
31207,Oriana,2,Private room,90,343,0.1,433
31209,Petra,2,Entire home/apt,95,19,0.45,114
31210,Ana,3,Entire home/apt,70,0,0.13,70
31211,Ali,2,Entire home/apt,125,8,0.07,133
31212,Anna,2,Entire home/apt,173,127,3.55,300
31214,Kyra,1,Entire home/apt,148,0,0.24,148
31215,Andrea,1,Private room,75,0,0.54,75
31216,Frances,1,Entire home/apt,199,99,4.02,298
31217,Darryl,1,Private room,54,157,1.73,211
31219,Burt,1,Entire home/apt,153,0,0.41,153
31220,Seba,2,Entire home/apt,99,0,0.07,99
31221,Juliana,1,Private room,65,311,0.26,376
31222,Howard,3,Private room,50,150,3.15,200
31224,Monica,1,Private room,100,0,0.42,100
31225,David,2,Private room,62,0,0.39,62
31226,Jess,1,Private room,77,0,0.07,77
31227,Austin,2,Private room,46,0,0.2,46
31228,Erik Joshua,1,Private room,95,0,3.3,95
31229,Victoria,1,Entire home/apt,159,42,0.31,201
31230,Zack,1,Entire home/apt,300,199,0.81,499
31231,Giulia,2,Entire home/apt,103,139,2.91,242
31232,Delia,1,Entire home/apt,200,3,1.57,203
31233,Nicole,1,Private room,102,0,0.13,102
31234,Jerry,2,Entire home/apt,350,77,0.38,427
31236,Darya,2,Private room,45,155,0.38,200
31237,Ibada,2,Entire home/apt,168,30,1.63,198
31238,Annero,2,Private room,40,263,2.64,303
31239,Carol&Emerson,1,Private room,55,135,4.89,190
31240,Doudou,1,Entire home/apt,150,25,0.76,175
31241,Lauren,2,Private room,79,1,1.15,80
31242,Bart,2,Private room,65,90,4.79,155
31243,Ilya,1,Private room,70,0,0.54,70
31244,Ian,2,Entire home/apt,199,93,0.3,292
31245,Michelle & Evelyn,3,Private room,45,33,7.03,78
31246,Albert,2,Private room,70,31,5.99,101
31247,Marian,2,Private room,60,0,0.07,60
31249,Albert,2,Private room,59,24,5.48,83
31250,Albert,2,Private room,49,0,6.73,49
31251,Michelle & Evelyn,3,Private room,65,41,6.45,106
31252,Veronica,1,Entire home/apt,165,59,4.06,224
31253,John,2,Private room,80,144,1.79,224
31256,Nate,1,Entire home/apt,100,3,4.86,103
31257,Natasha,3,Private room,95,361,0.15,456
31258,Giana,2,Private room,54,319,4.19,373
31259,Jowelle,1,Entire home/apt,299,169,2.79,468
31260,Camilo,2,Private room,45,0,0.41,45
31261,Preeya,1,Entire home/apt,250,0,0.21,250
31262,Barbara,3,Entire home/apt,120,117,0.41,237
31263,Amy,1,Entire home/apt,105,233,0.16,338
31264,Jowelle,1,Entire home/apt,299,0,1.76,299
31265,Martin,2,Entire home/apt,130,189,0.43,319
31266,Lanee,3,Entire home/apt,90,0,0.14,90
31267,Hazel,2,Private room,62,0,0.14,62
31268,Louis,2,Private room,70,0,0.07,70
31269,Jacob,1,Entire home/apt,225,1,0.73,226
31270,Melissa,1,Private room,95,0,1.08,95
31271,Lucky Day Realty Corp.,3,Entire home/apt,288,136,1.17,424
31272,Eduardo,1,Entire home/apt,149,6,1.3,155
31273,Kate,2,Private room,95,221,0.22,316
31274,Marie,2,Entire home/apt,150,26,1.84,176
31275,Vicki,1,Entire home/apt,200,0,0.68,200
31276,Aleksej,3,Entire home/apt,150,321,2.0,471
31277,Lee,1,Entire home/apt,175,190,1.92,365
31278,Paul,3,Entire home/apt,180,181,3.87,361
31279,Lawrence,4,Private room,70,178,0.4,248
31280,Linda,1,Private room,100,55,2.58,155
31281,Rafael,3,Private room,79,171,5.03,250
31282,Jose,1,Private room,350,148,4.0,498
31283,Brooklyn P,3,Private room,75,162,3.99,237
31284,David,1,Entire home/apt,235,5,0.47,240
31285,Rafael,3,Private room,39,62,0.77,101
31286,Tatiana,1,Entire home/apt,300,5,0.14,305
31287,Jeerathinan,3,Private room,50,71,1.39,121
31288,Hessam,1,Private room,130,0,0.13,130
31289,Abinav,1,Private room,130,0,0.21,130
31290,Michelle,1,Entire home/apt,250,44,1.91,294
31291,Ivy,2,Entire home/apt,120,0,0.08,120
31294,Michael,1,Entire home/apt,115,0,0.8,115
31295,Kelly,1,Entire home/apt,100,8,2.57,108
31296,Eloise,2,Entire home/apt,120,20,0.42,140
31297,Felix,4,Private room,65,64,3.69,129
31298,Felix,4,Private room,79,63,3.68,142
31299,Jackie,1,Private room,89,181,3.19,270
31300,Lucinda,1,Entire home/apt,300,19,0.44,319
31301,Brandon,1,Entire home/apt,220,2,0.93,222
31302,Stive Alexander,1,Entire home/apt,265,130,0.98,395
31303,Tom,3,Entire home/apt,300,162,3.29,462
31304,Antoine,2,Private room,150,0,0.07,150
31305,Melissa,1,Entire home/apt,150,0,1.26,150
31306,Karen,1,Entire home/apt,150,64,3.53,214
31307,Paige,3,Private room,46,0,0.59,46
31308,Jimmy,2,Private room,68,38,3.72,106
31309,Nina,1,Private room,55,210,0.48,265
31310,Nina,1,Private room,65,216,0.07,281
31311,Nina,1,Private room,70,317,0.24,387
31312,Nina,1,Private room,65,211,1.0,276
31313,Gahee,1,Entire home/apt,310,169,5.49,479
31314,Paul,4,Entire home/apt,88,322,0.61,410
31315,Ramy,1,Private room,50,0,3.01,50
31317,Dave,1,Private room,80,332,0.87,412
31318,Jermaine,1,Private room,80,0,0.14,80
31319,Princess-Wynona,2,Entire home/apt,130,34,2.47,164
31320,Miranda,2,Entire home/apt,130,0,0.14,130
31321,Amy,3,Entire home/apt,100,0,0.42,100
31322,Aureo,1,Entire home/apt,250,74,0.94,324
31323,Allison,3,Entire home/apt,200,308,2.43,508
31324,Eugenia,2,Private room,54,225,0.65,279
31325,Sam,2,Private room,65,157,0.1,222
31326,Ramiro & Jeff,1,Private room,120,89,1.11,209
31328,Helen,3,Private room,50,51,0.42,101
31329,Christine,1,Entire home/apt,299,6,1.96,305
31330,Nydia,3,Entire home/apt,138,347,1.88,485
31331,Siri,3,Private room,42,33,2.87,75
31332,Ray,1,Private room,175,365,0.41,540
31333,Yohana,2,Private room,85,69,2.44,154
31334,Adam,3,Private room,74,348,6.77,422
31335,Glory,2,Private room,65,156,0.77,221
31336,Olivia,2,Private room,47,0,0.36,47
31337,Meghan,2,Private room,85,7,2.47,92
31338,Dan,1,Entire home/apt,975,164,0.64,1139
31339,Rose,2,Entire home/apt,130,353,0.56,483
31340,Sasha,2,Private room,70,365,0.3,435
31342,Welecia,3,Entire home/apt,179,205,2.37,384
31344,Edward,2,Entire home/apt,150,0,1.15,150
31345,Edward,2,Entire home/apt,99,0,3.45,99
31346,Erin,1,Entire home/apt,125,0,0.42,125
31347,Nodar,1,Entire home/apt,170,0,0.21,170
31348,Justin,1,Private room,89,2,1.41,91
31349,Yating,2,Private room,50,0,0.07,50
31351,Guille,2,Private room,80,20,1.0,100
31352,Lana,1,Entire home/apt,168,95,1.18,263
31354,Lana,1,Entire home/apt,118,0,0.07,118
31355,Dionyssios,1,Entire home/apt,150,127,1.96,277
31356,Lee,1,Entire home/apt,120,27,0.22,147
31357,Ron,1,Entire home/apt,175,354,0.28,529
31358,Lauren & Chelsea,2,Entire home/apt,190,12,0.77,202
31359,Tiago,1,Entire home/apt,195,146,5.03,341
31360,Phil,2,Entire home/apt,112,219,4.62,331
31361,Jamie,1,Entire home/apt,450,302,3.21,752
31363,Rachel,2,Private room,45,0,0.35,45
31364,Karen,1,Entire home/apt,150,310,0.24,460
31365,Chris,2,Entire home/apt,99,140,4.8,239
31366,Courtney,2,Entire home/apt,100,2,0.2,102
31367,Bree,1,Private room,50,25,1.0,75
31368,Dante,1,Entire home/apt,220,60,5.3,280
31369,Liron,2,Entire home/apt,123,0,0.53,123
31370,Ellie,2,Entire home/apt,110,0,0.19,110
31371,Kaptan,1,Private room,120,28,1.22,148
31372,Paula,1,Entire home/apt,110,200,1.97,310
31373,Hong Ngoc,1,Private room,85,0,0.27,85
31374,Marcus,1,Entire home/apt,299,278,1.62,577
31375,Gabriel,2,Private room,55,73,1.81,128
31376,Elisabeth,2,Private room,47,0,0.61,47
31377,Ebony,2,Private room,55,87,0.09,142
31378,Ken And Andy,2,Private room,130,282,3.93,412
31379,Mark,2,Private room,40,84,0.29,124
31380,Artem,2,Entire home/apt,150,53,3.27,203
31381,Michael Daae,2,Private room,70,0,0.2,70
31382,Keren,1,Entire home/apt,180,3,1.08,183
31383,Demi,1,Private room,90,1,4.35,91
31384,Heather,1,Entire home/apt,120,47,0.09,167
31385,Kimberly,2,Entire home/apt,145,212,5.97,357
31387,Joseph,1,Entire home/apt,150,201,7.55,351
31388,Bianca,1,Private room,125,90,0.31,215
31389,Brandon,1,Private room,60,21,1.91,81
31390,Hannah,2,Entire home/apt,150,0,0.2,150
31391,Maya,1,Private room,190,28,2.68,218
31392,Manhattan,1,Entire home/apt,145,289,0.16,434
31393,Sandia,1,Private room,50,0,0.21,50
31394,Andrew,2,Private room,95,0,0.17,95
31395,Ken And Andy,2,Private room,91,337,4.54,428
31396,Emily,2,Entire home/apt,145,38,2.8,183
31397,Isabelle,1,Private room,100,31,1.36,131
31398,Amanda,2,Private room,35,0,0.28,35
31399,Maria,1,Private room,120,156,5.0,276
31400,Donna,2,Entire home/apt,69,229,2.46,298
31401,Dana,3,Private room,50,293,0.4,343
31402,Minh,1,Private room,290,70,6.96,360
31403,Glory,2,Private room,50,358,0.29,408
31404,Justin,1,Entire home/apt,545,177,1.0,722
31405,Olie,2,Entire home/apt,200,265,2.02,465
31407,Maureen,1,Private room,10,2,2.87,12
31408,Lisa,5,Private room,47,283,0.96,330
31409,Tom,1,Entire home/apt,175,0,3.72,175
31410,Zamira,3,Private room,75,11,4.93,86
31411,John,2,Private room,45,365,1.05,410
31412,Honey,1,Entire home/apt,275,364,0.07,639
31413,Lois,4,Private room,23,36,1.25,59
31414,Juan Carlos,1,Private room,95,219,0.76,314
31415,Steven,1,Entire home/apt,199,92,4.95,291
31416,Brittany,1,Entire home/apt,130,0,0.14,130
31417,Kelsey,2,Entire home/apt,161,0,0.69,161
31418,Natasha,2,Private room,65,340,3.57,405
31419,Yumiko,2,Private room,60,43,2.83,103
31420,Diane & Brice,1,Entire home/apt,165,192,2.3,357
31421,Viviana,3,Private room,69,348,2.16,417
31422,James,2,Private room,100,364,0.98,464
31423,Maria,2,Private room,89,103,2.0,192
31424,Minami,1,Private room,55,0,0.16,55
31427,Kaka,3,Private room,80,262,2.49,342
31428,Masud,2,Private room,37,356,0.43,393
31429,Gf,2,Private room,40,288,0.23,328
31430,Oscar,3,Private room,60,85,0.48,145
31431,Oscar,3,Entire home/apt,90,5,1.64,95
31432,Ken,1,Entire home/apt,245,357,0.12,602
31433,Jake,1,Entire home/apt,175,90,2.68,265
31434,Cristiano,2,Private room,50,55,1.94,105
31435,Edyta,2,Entire home/apt,210,354,0.13,564
31436,Home Studios,2,Entire home/apt,350,89,0.86,439
31437,Kelly,1,Private room,45,0,0.07,45
31438,Amit,1,Entire home/apt,300,85,0.98,385
31439,Luis,2,Entire home/apt,155,0,0.45,155
31440,Armine,2,Entire home/apt,125,0,0.21,125
31441,Ulker,2,Entire home/apt,225,157,1.8,382
31442,Mia,3,Private room,90,299,4.55,389
31443,Rebecca,3,Shared room,110,0,0.22,110
31444,Nichole,2,Private room,65,106,3.08,171
31445,Rhonda,2,Entire home/apt,125,294,3.36,419
31446,Dier,2,Private room,35,0,0.08,35
31447,Allie,1,Entire home/apt,150,340,1.91,490
31448,Paul,1,Entire home/apt,299,0,0.16,299
31450,Chandtisse,2,Private room,60,74,3.3,134
31451,Dana,2,Private room,59,17,2.48,76
31452,Shannon,2,Entire home/apt,250,58,2.88,308
31453,Joe,1,Entire home/apt,185,57,0.64,242
31454,Serdar,3,Private room,60,0,0.43,60
31455,Tina,1,Private room,139,338,1.01,477
31456,Ha,1,Private room,80,234,0.96,314
31457,Amarjit S,5,Private room,33,285,0.41,318
31458,Tomás,1,Private room,89,76,0.84,165
31459,Viviana,3,Private room,69,359,1.95,428
31460,June,1,Private room,68,265,2.1,333
31461,John,1,Entire home/apt,185,42,1.81,227
31462,Caroline,2,Entire home/apt,100,0,0.92,100
31463,Taz,1,Private room,116,280,6.42,396
31464,Brad,2,Entire home/apt,140,180,4.06,320
31465,Justin,1,Entire home/apt,225,253,0.11,478
31466,Chi,2,Entire home/apt,99,320,0.36,419
31468,Keenan & Emily,1,Private room,90,181,0.62,271
31469,V And J,2,Entire home/apt,160,8,0.24,168
31470,Brittany,1,Entire home/apt,148,2,0.34,150
31471,Nandi,2,Private room,60,0,1.88,60
31472,Lara,2,Entire home/apt,200,6,0.48,206
31473,Corporate Housing,1,Entire home/apt,125,304,0.34,429
31474,Corporate Housing,1,Entire home/apt,150,332,0.08,482
31475,Corporate Housing,1,Entire home/apt,125,346,0.32,471
31476,Corporate Housing,1,Entire home/apt,125,342,0.5,467
31478,Natasha,2,Private room,65,306,2.57,371
31479,Jared,1,Entire home/apt,85,15,0.56,100
31480,Viviana,3,Private room,89,355,2.0,444
31482,Chris,1,Entire home/apt,300,0,0.14,300
31483,Massiel,4,Private room,65,158,1.11,223
31485,Melissa,2,Entire home/apt,125,65,1.15,190
31486,Swann,3,Private room,75,84,5.44,159
31487,Gesner,2,Entire home/apt,145,219,4.95,364
31488,Nami,2,Private room,65,0,0.16,65
31489,Sonder,1,Entire home/apt,142,353,0.09,495
31490,Lindsey,2,Entire home/apt,200,7,0.37,207
31492,B,1,Entire home/apt,235,283,3.7,518
31494,Marshall,1,Private room,50,0,0.23,50
31495,Miller,2,Private room,36,0,0.08,36
31496,Ely,2,Entire home/apt,75,49,1.55,124
31497,George,1,Private room,60,260,0.68,320
31498,Shama,1,Entire home/apt,247,266,5.68,513
31499,Alfredo,2,Entire home/apt,295,161,3.83,456
31500,Diana,2,Private room,80,96,1.54,176
31501,Viviana,3,Private room,99,343,1.64,442
31502,Myrna,2,Private room,36,29,0.24,65
31504,Josh,1,Private room,73,37,0.07,110
31505,Corinne,1,Entire home/apt,117,0,0.5,117
31507,David & Javier,2,Entire home/apt,1000,88,0.66,1088
31510,Sonder,1,Entire home/apt,145,341,0.42,486
31512,Sonder,1,Entire home/apt,209,328,0.26,537
31513,Kevin,1,Entire home/apt,300,0,0.2,300
31514,Ben,1,Entire home/apt,101,363,1.74,464
31515,Avery,2,Private room,60,0,0.8,60
31517,Taz,1,Shared room,65,325,7.33,390
31519,Armstrong,1,Entire home/apt,250,89,0.62,339
31521,Samara,1,Entire home/apt,140,8,0.77,148
31522,Elena,2,Entire home/apt,110,248,0.58,358
31523,Paul,1,Entire home/apt,200,166,0.52,366
31524,Mike,1,Private room,100,68,4.98,168
31525,Sonder,1,Entire home/apt,175,290,0.45,465
31527,Jimmy,2,Private room,112,27,4.74,139
31528,Ian,2,Private room,70,135,3.33,205
31529,Tricia,2,Private room,102,0,0.07,102
31531,Shannon,1,Entire home/apt,75,9,0.66,84
31534,Allison,1,Private room,55,0,0.14,55
31535,Teddy,2,Private room,50,0,1.14,50
31536,Anita,2,Private room,62,261,6.97,323
31537,Allison,2,Entire home/apt,119,0,0.15,119
31538,Cristina,2,Private room,52,3,2.94,55
31539,Guilda,1,Private room,45,5,0.17,50
31540,Ben,1,Entire home/apt,160,70,0.36,230
31541,Molly,2,Entire home/apt,162,4,0.76,166
31542,Ross,1,Entire home/apt,205,5,1.04,210
31543,Matt,2,Entire home/apt,86,0,0.3,86
31546,Van,2,Entire home/apt,61,138,0.16,199
31547,Ameer,1,Private room,75,14,0.41,89
31548,Chang,3,Private room,79,32,2.4,111
31550,Max,1,Shared room,32,341,0.76,373
31551,Benjamin,1,Entire home/apt,119,201,0.43,320
31552,Kirac,2,Entire home/apt,150,8,0.41,158
31553,Ahmad,1,Entire home/apt,129,9,0.88,138
31554,Amarjit S,5,Private room,35,338,0.77,373
31555,Rebeca,1,Private room,51,17,1.12,68
31556,Shir,1,Private room,120,0,1.72,120
31557,Pamela,3,Private room,78,363,0.41,441
31558,Hunter,1,Entire home/apt,100,0,0.23,100
31559,Tiffany,2,Entire home/apt,114,0,0.15,114
31560,Kai,2,Private room,35,0,0.7,35
31561,Carolyn,1,Entire home/apt,150,0,1.19,150
31562,Angie,1,Private room,75,137,0.91,212
31563,Pia,2,Entire home/apt,128,0,0.42,128
31564,Angie,1,Private room,160,123,0.44,283
31566,C-Van,1,Entire home/apt,199,365,0.7,564
31567,Izaac,2,Private room,100,59,2.45,159
31568,Gareth,1,Entire home/apt,170,0,2.48,170
31569,Felicia,2,Entire home/apt,99,135,3.11,234
31571,Jennifer,1,Entire home/apt,175,0,1.28,175
31572,Rachael,1,Entire home/apt,400,47,1.14,447
31573,Samuel,4,Entire home/apt,125,253,4.34,378
31574,Emad,1,Private room,75,127,8.32,202
31576,Karli,2,Private room,46,0,0.72,46
31577,Andrew,1,Entire home/apt,240,220,0.3,460
31578,Shirley,2,Entire home/apt,240,243,3.44,483
31579,Michelle,3,Private room,50,358,4.69,408
31580,Kevin,1,Private room,115,0,0.14,115
31581,Cynthia,4,Private room,75,166,1.55,241
31582,Carrie,1,Entire home/apt,160,0,1.1,160
31583,Maxime C And Winie C,1,Private room,80,178,3.37,258
31584,Janey,1,Entire home/apt,150,216,2.36,366
31585,Thelma,5,Private room,79,355,0.3,434
31586,Usamah,2,Entire home/apt,250,177,0.22,427
31587,Lucy,3,Private room,60,21,0.85,81
31588,Amira,3,Private room,85,365,0.71,450
31589,Freddy,2,Entire home/apt,200,275,1.88,475
31590,Nicole,3,Private room,40,305,0.65,345
31591,Samia,2,Private room,89,128,0.29,217
31592,Christelle,1,Private room,95,0,0.41,95
31593,Anna,2,Entire home/apt,135,151,2.16,286
31594,Erika,1,Entire home/apt,260,299,3.0,559
31595,Maxime C And Winie C,1,Private room,80,177,2.75,257
31596,Betty,2,Entire home/apt,130,14,0.44,144
31598,Ha,1,Entire home/apt,400,191,0.2,591
31599,Night,3,Entire home/apt,200,363,2.73,563
31600,Tony,1,Entire home/apt,139,116,1.83,255
31601,Marcel,1,Private room,59,52,0.34,111
31602,Van,2,Private room,45,98,1.57,143
31603,Maria,5,Entire home/apt,75,129,0.22,204
31604,Kamaran,2,Entire home/apt,159,336,3.52,495
31605,Karan,1,Private room,120,0,0.14,120
31606,Mateo,2,Private room,99,224,3.63,323
31607,Thomas,1,Private room,112,6,5.63,118
31608,Omar,1,Entire home/apt,175,0,0.16,175
31609,Daria,2,Entire home/apt,85,27,0.6,112
31610,Serdar,3,Private room,55,123,0.96,178
31611,Karina,3,Private room,80,24,1.36,104
31612,Josh,1,Private room,90,0,0.21,90
31613,Gal,1,Entire home/apt,180,5,0.82,185
31616,Kj,1,Entire home/apt,415,71,3.33,486
31617,Riva,3,Entire home/apt,275,138,2.13,413
31618,Elissa,2,Private room,115,75,3.14,190
31619,Mostafa,5,Entire home/apt,199,171,2.51,370
31622,Joslyn And Pansy,2,Private room,120,365,0.29,485
31623,Kara,1,Private room,60,126,0.58,186
31624,David,2,Private room,58,36,0.87,94
31625,Erica,2,Private room,149,0,1.26,149
31627,Howard,3,Private room,45,159,3.29,204
31628,Simon,2,Private room,55,0,0.1,55
31629,Andres,1,Private room,110,53,2.42,163
31630,Radu,3,Private room,70,0,0.07,70
31631,Miss. G.,3,Private room,60,360,1.54,420
31632,Anthony,2,Entire home/apt,121,31,0.07,152
31633,Toun,2,Private room,62,172,1.58,234
31634,Anthony,1,Private room,75,345,0.29,420
31635,Juliana,1,Private room,50,281,0.21,331
31636,Alexandria,3,Private room,52,2,0.5,54
31638,Raisa,3,Entire home/apt,100,0,0.55,100
31639,Dustin,2,Entire home/apt,160,270,3.22,430
31640,Mark,2,Private room,200,88,0.09,288
31641,Donna,2,Private room,65,83,0.91,148
31642,Lynn,3,Entire home/apt,115,19,0.99,134
31643,Anthony,5,Private room,50,191,0.14,241
31644,Roni,1,Private room,95,241,4.59,336
31645,Karen,1,Entire home/apt,300,0,0.27,300
31646,David,1,Private room,69,0,4.83,69
31647,Muneeba,2,Entire home/apt,169,171,3.42,340
31648,Daniel,2,Entire home/apt,134,262,3.59,396
31650,Taylor,3,Shared room,35,90,0.78,125
31651,Bryan,1,Private room,120,249,1.27,369
31652,Jazmin,1,Entire home/apt,140,0,1.64,140
31653,Alexander M,1,Entire home/apt,200,188,0.51,388
31654,David,1,Private room,139,93,2.45,232
31655,Andrea,1,Private room,80,126,1.44,206
31656,Scar,1,Private room,79,0,0.22,79
31658,Luis,4,Shared room,40,141,1.82,181
31659,Karen,2,Entire home/apt,91,172,2.01,263
31660,Marie,1,Entire home/apt,295,88,0.64,383
31662,Fatimatou,1,Private room,76,0,1.45,76
31663,Vincent,2,Entire home/apt,400,347,0.35,747
31664,Benjamin,2,Private room,48,45,5.93,93
31665,Manny,4,Entire home/apt,125,281,1.4,406
31666,Alessandra,1,Entire home/apt,250,364,0.44,614
31667,Karen,1,Private room,65,0,0.64,65
31668,Flora,2,Private room,80,0,0.07,80
31669,Eric,1,Entire home/apt,650,126,2.83,776
31670,Mostafa,5,Entire home/apt,48,0,0.08,48
31671,Clark,1,Private room,99,0,1.18,99
31672,Any,3,Private room,55,332,1.75,387
31673,Tyni,1,Shared room,44,5,3.38,49
31674,Andrew,3,Entire home/apt,200,365,0.77,565
31675,Rochi,2,Entire home/apt,150,332,2.65,482
31676,Michael,4,Entire home/apt,100,107,2.66,207
31677,Ro,1,Entire home/apt,150,83,0.16,233
31678,Sabrina,1,Private room,150,0,0.21,150
31679,Sam,2,Entire home/apt,350,0,0.16,350
31680,Jeff,3,Entire home/apt,128,10,1.75,138
31681,Clark,1,Entire home/apt,200,95,5.49,295
31682,Matthew,2,Entire home/apt,190,2,2.18,192
31683,Jason,2,Private room,40,0,0.49,40
31684,Nathan,1,Entire home/apt,71,0,0.14,71
31685,Lolita,3,Private room,60,283,0.29,343
31686,Lolita,3,Private room,59,351,3.47,410
31687,Alejandro,2,Entire home/apt,599,0,2.42,599
31688,Maria,2,Entire home/apt,125,168,2.87,293
31689,Elissa,2,Entire home/apt,115,0,0.63,115
31690,Julie,2,Entire home/apt,65,0,1.03,65
31691,Merly,1,Shared room,50,89,0.56,139
31692,Celia,2,Entire home/apt,198,0,1.01,198
31693,Sam,2,Entire home/apt,78,74,3.77,152
31694,Vito & Miriam,1,Entire home/apt,160,325,4.05,485
31695,Michael,2,Shared room,125,0,0.28,125
31696,Jason,2,Private room,90,295,0.55,385
31697,Jason,2,Private room,43,146,1.11,189
31698,Mutaurwa,2,Entire home/apt,80,5,0.09,85
31699,Gabriel,2,Private room,60,0,0.29,60
31700,Benoit,1,Entire home/apt,190,0,0.15,190
31701,Briane,2,Shared room,60,0,0.1,60
31702,Ron,1,Private room,57,176,2.71,233
31703,Irina,1,Entire home/apt,120,342,0.26,462
31704,Svetlana,1,Entire home/apt,119,0,0.15,119
31705,Deborah,2,Entire home/apt,200,95,2.27,295
31707,Brayan,1,Entire home/apt,92,32,4.76,124
31708,Susana,2,Private room,45,354,0.15,399
31709,Leah,1,Entire home/apt,200,10,1.28,210
31710,Victoria,1,Private room,120,0,0.26,120
31711,Fabiola,2,Private room,42,0,0.28,42
31712,Mickael,1,Private room,89,0,3.11,89
31713,Ying,1,Private room,95,180,2.58,275
31714,Mike&Mavi,1,Private room,80,324,0.35,404
31715,Pooja,1,Entire home/apt,235,352,1.68,587
31716,Gal,2,Private room,40,0,0.21,40
31717,Joanna,4,Entire home/apt,150,0,0.28,150
31718,Stephanie,1,Entire home/apt,120,0,0.31,120
31719,Jasmine,1,Entire home/apt,400,164,4.59,564
31720,Ned,1,Private room,130,49,2.79,179
31721,Andre,2,Private room,75,157,0.07,232
31722,Alan,1,Entire home/apt,125,100,2.79,225
31723,Raimundo,1,Private room,120,0,0.15,120
31724,Danielle,2,Entire home/apt,120,0,0.07,120
31725,Masud,2,Private room,35,312,0.63,347
31726,Phoebe,2,Private room,45,0,0.07,45
31727,Tom,2,Entire home/apt,100,111,0.07,211
31728,Henry D,1,Private room,97,20,6.34,117
31729,Samantha,2,Entire home/apt,225,88,1.6,313
31730,Jen,2,Entire home/apt,89,0,0.09,89
31731,Eliana,3,Private room,80,220,1.46,300
31733,Patricia,2,Private room,40,0,0.07,40
31734,Conor,1,Private room,80,0,0.66,80
31735,Ben,1,Entire home/apt,175,0,2.14,175
31736,Sorel,2,Entire home/apt,250,22,1.04,272
31737,Joshua,2,Entire home/apt,135,70,4.09,205
31739,Ito,1,Private room,59,98,1.06,157
31740,Joshua,1,Entire home/apt,180,2,4.37,182
31741,Martha,1,Private room,125,5,0.07,130
31742,Alexandra,1,Entire home/apt,170,173,2.06,343
31743,Sonder,1,Entire home/apt,182,347,0.24,529
31744,Aaron,1,Private room,65,1,1.65,66
31745,Andy,2,Entire home/apt,450,3,0.36,453
31746,Howard,3,Private room,42,141,2.71,183
31747,Alessandra,2,Private room,79,28,3.53,107
31748,Maria,2,Entire home/apt,80,4,0.58,84
31749,Jacqueline,1,Entire home/apt,165,0,0.3,165
31750,Aleksandra,2,Private room,50,14,3.07,64
31751,Haley,2,Entire home/apt,75,0,0.15,75
31752,Erica,2,Entire home/apt,128,2,0.99,130
31753,Anwar,1,Entire home/apt,122,245,1.42,367
31754,Shoshana,3,Private room,46,0,0.15,46
31755,David,1,Private room,85,179,0.21,264
31756,Kalani,3,Entire home/apt,150,0,0.41,150
31757,Dana,1,Entire home/apt,199,0,0.09,199
31759,Dena,2,Entire home/apt,105,353,2.34,458
31760,Weimin,3,Private room,59,6,0.43,65
31761,Angela,1,Private room,67,0,0.07,67
31762,Andrew,2,Private room,61,1,2.08,62
31763,Anthony,2,Entire home/apt,170,10,5.54,180
31765,Alexander,3,Entire home/apt,86,0,0.14,86
31766,Deniz,3,Private room,85,88,0.79,173
31768,Sue,1,Entire home/apt,210,37,2.48,247
31769,Rilen,4,Private room,50,73,2.47,123
31770,Dave,1,Private room,80,88,1.74,168
31771,Shaina,3,Private room,50,0,5.15,50
31772,Hanna,2,Private room,50,0,0.07,50
31773,May,3,Private room,50,228,5.19,278
31774,Casey,2,Private room,151,0,0.97,151
31775,Frances,1,Private room,200,363,0.07,563
31776,Camille,1,Entire home/apt,150,0,0.29,150
31777,Janna,1,Entire home/apt,147,0,0.96,147
31779,James,2,Entire home/apt,200,21,0.07,221
31780,Cristiano,2,Private room,70,59,3.31,129
31781,Miguel,2,Entire home/apt,140,0,0.16,140
31783,Juliana,3,Private room,55,1,1.82,56
31784,Edwin,4,Private room,50,8,1.36,58
31785,Isabel,1,Entire home/apt,200,284,3.1,484
31786,Petr,1,Entire home/apt,190,20,1.24,210
31787,Jery & Dave,2,Entire home/apt,200,67,0.62,267
31788,Dmitry,2,Private room,49,0,2.03,49
31789,Diego,2,Entire home/apt,119,0,4.51,119
31790,Stefanos,3,Private room,40,0,0.35,40
31791,Stanley,1,Entire home/apt,210,365,0.08,575
31792,Hiram,2,Entire home/apt,105,43,0.62,148
31793,Maksim,1,Entire home/apt,86,154,0.19,240
31794,Erin,1,Entire home/apt,150,0,1.55,150
31795,Dean&Paula,3,Private room,60,355,3.49,415
31796,Shelley,2,Entire home/apt,225,150,0.47,375
31797,Baris,2,Private room,157,365,0.42,522
31798,Adi,2,Private room,70,363,0.14,433
31799,Cem,3,Entire home/apt,140,71,0.18,211
31800,Edwin,4,Entire home/apt,74,70,2.63,144
31801,Nino,2,Entire home/apt,150,179,0.56,329
31802,Maritza,1,Entire home/apt,75,171,5.73,246
31803,Nessim,2,Private room,40,0,0.14,40
31804,Lydia,1,Entire home/apt,180,18,1.29,198
31805,Emilie,2,Private room,37,0,0.92,37
31806,Raphael,1,Entire home/apt,344,25,0.75,369
31807,Martial Loft,2,Private room,40,0,0.14,40
31808,Yael,2,Entire home/apt,130,9,0.08,139
31809,Sean,2,Private room,99,0,0.54,99
31810,Helene,1,Entire home/apt,142,278,3.69,420
31812,Shahed,2,Private room,70,87,1.39,157
31813,Yero,4,Private room,45,85,2.7,130
31814,Bing,3,Private room,59,77,1.76,136
31815,Julie,1,Entire home/apt,160,6,1.47,166
31816,Adam,3,Private room,125,342,2.2,467
31817,Anna,2,Private room,59,25,7.08,84
31819,Alexis,1,Entire home/apt,200,6,1.57,206
31820,Kate,2,Entire home/apt,130,3,0.16,133
31821,Saleem,3,Entire home/apt,104,141,0.43,245
31822,Sonder,1,Entire home/apt,182,333,0.57,515
31823,Magui,3,Private room,30,6,1.67,36
31824,Charlie,1,Private room,65,163,2.0,228
31825,Moby,1,Entire home/apt,250,31,1.94,281
31826,Christine,3,Private room,60,180,0.23,240
31827,Christine,3,Private room,48,365,1.18,413
31828,Rocio & James,3,Entire home/apt,149,308,3.46,457
31829,Giana,2,Private room,59,365,4.06,424
31830,Tommy And Sarah,1,Entire home/apt,100,0,0.08,100
31831,Sophia,2,Entire home/apt,62,255,0.25,317
31832,Amir,2,Entire home/apt,135,57,1.95,192
31833,Sherry,3,Private room,95,87,5.43,182
31834,Suzan,3,Entire home/apt,450,83,0.22,533
31835,Fevzi,2,Private room,59,97,0.22,156
31836,Laura,1,Private room,59,0,0.28,59
31837,Edwin,4,Private room,40,37,2.54,77
31838,Kassidy,2,Entire home/apt,215,77,0.6,292
31839,Shany,3,Entire home/apt,120,5,0.37,125
31840,Zahir,3,Private room,49,278,8.95,327
31841,David,1,Private room,41,0,0.08,41
31842,Tomas,1,Private room,125,34,0.22,159
31843,Connor,1,Entire home/apt,250,297,1.03,547
31844,Jessica,2,Entire home/apt,75,9,0.54,84
31845,Maya,2,Private room,34,0,0.16,34
31847,Beauty,2,Private room,60,0,6.01,60
31850,Erik,1,Entire home/apt,150,179,0.43,329
31851,Jon,1,Entire home/apt,224,0,0.74,224
31852,Suzan,3,Private room,80,153,4.81,233
31853,Alyssa,2,Private room,100,365,0.69,465
31854,Jeremy,3,Entire home/apt,100,0,0.28,100
31855,Nikki,1,Entire home/apt,125,0,0.21,125
31856,Allan,2,Entire home/apt,120,0,1.42,120
31858,Wendy,2,Entire home/apt,600,162,2.37,762
31859,Suzan,3,Private room,70,85,5.73,155
31860,Jimmy,3,Private room,60,57,0.69,117
31861,Kangxin,1,Private room,50,0,0.28,50
31863,Laura,1,Entire home/apt,180,27,2.68,207
31864,Hannah,1,Entire home/apt,118,0,0.23,118
31865,Haydenn,1,Entire home/apt,70,0,0.15,70
31866,Wolf,1,Entire home/apt,1195,40,1.94,1235
31867,Reilly,1,Private room,175,109,3.22,284
31868,Cesar,2,Entire home/apt,165,258,0.66,423
31869,Adelle,1,Private room,150,0,0.07,150
31870,Harn,1,Entire home/apt,50,0,1.21,50
31871,Kyunam,1,Private room,50,53,0.58,103
31872,Amarjit S,5,Private room,33,316,1.2,349
31873,Jimmy,3,Private room,60,49,2.36,109
31874,Jimmy,3,Private room,50,2,1.64,52
31875,Itzi,1,Private room,110,160,2.65,270
31877,Navid,1,Entire home/apt,137,0,0.37,137
31878,Lilly,2,Private room,50,21,0.37,71
31879,Brittany,1,Entire home/apt,150,35,0.25,185
31880,Anna,2,Private room,45,199,1.34,244
31881,Marco,1,Private room,75,140,1.07,215
31883,Benjamin,1,Private room,91,197,0.19,288
31884,Kathryn,3,Entire home/apt,250,47,1.6,297
31885,Emma,2,Entire home/apt,80,2,1.21,82
31886,Natalie,1,Entire home/apt,136,39,0.42,175
31887,Leesha,2,Private room,99,327,3.52,426
31888,Ashley,4,Entire home/apt,103,248,2.84,351
31892,David,1,Entire home/apt,120,1,1.51,121
31894,Michelle,3,Private room,50,66,1.27,116
31895,Sharon,2,Private room,80,37,0.71,117
31896,Gentry,3,Private room,49,18,0.65,67
31897,Louis,1,Private room,50,0,0.07,50
31899,Christian,3,Entire home/apt,60,150,4.18,210
31900,Erin,1,Private room,45,0,0.99,45
31901,Raimundo,1,Private room,70,0,0.4,70
31902,Alexander,1,Entire home/apt,120,0,0.21,120
31905,Caroline,2,Private room,70,89,0.88,159
31907,Joey,3,Private room,55,107,1.44,162
31908,Allison,2,Private room,80,0,0.07,80
31911,Jessica,1,Entire home/apt,225,6,0.24,231
31912,Donna,3,Entire home/apt,200,44,0.55,244
31913,Fred,2,Entire home/apt,99,102,3.63,201
31914,Cassondra,3,Entire home/apt,110,0,0.23,110
31915,Alan,3,Entire home/apt,115,291,1.0,406
31916,Antoinette,2,Entire home/apt,225,120,0.66,345
31917,Samantha,2,Private room,95,260,1.48,355
31918,Zina,2,Entire home/apt,139,0,0.24,139
31919,Liset,2,Private room,65,282,1.57,347
31920,Rose,1,Entire home/apt,160,172,0.66,332
31923,Ana,1,Entire home/apt,175,3,0.15,178
31924,Michael,2,Entire home/apt,179,0,1.84,179
31925,Cecilia,2,Entire home/apt,130,129,3.34,259
31926,David,2,Entire home/apt,80,39,1.46,119
31927,Juan,2,Private room,44,0,0.28,44
31928,Kate,1,Entire home/apt,300,16,0.58,316
31929,Emily,1,Entire home/apt,215,38,1.33,253
31930,Nicole,2,Entire home/apt,100,0,1.91,100
31931,Alliot,2,Entire home/apt,295,343,0.56,638
31932,Kristanne,1,Entire home/apt,100,0,0.29,100
31933,Ken,1,Shared room,85,83,0.36,168
31934,Garry,2,Entire home/apt,150,23,0.25,173
31935,Keisha,2,Entire home/apt,225,77,1.66,302
31937,Genevieve,2,Private room,75,54,0.16,129
31938,Nkem,3,Private room,140,177,0.07,317
31939,Hili,2,Entire home/apt,110,0,0.23,110
31941,Baris,2,Entire home/apt,265,89,0.29,354
31942,Victor,2,Entire home/apt,150,20,0.08,170
31943,Sophie,2,Entire home/apt,91,12,0.3,103
31944,Andrea,1,Entire home/apt,795,16,2.56,811
31945,James,1,Entire home/apt,185,68,1.68,253
31946,Michael,1,Private room,125,0,0.07,125
31948,Leo,1,Entire home/apt,330,22,0.25,352
31950,Dalila,3,Private room,50,153,1.73,203
31951,Olivier,1,Private room,79,78,4.82,157
31952,Johnny & Hala,2,Entire home/apt,129,0,0.57,129
31953,Harry And Kelly,3,Private room,40,0,0.5,40
31954,Gina,1,Entire home/apt,1200,347,0.98,1547
31955,Peter,2,Entire home/apt,200,209,3.09,409
31956,Carolyn,2,Private room,41,0,0.64,41
31957,Rafael,2,Private room,140,157,2.64,297
31958,WeWork,1,Entire home/apt,295,117,3.95,412
31959,Weisbrod,2,Entire home/apt,125,90,0.44,215
31960,Ian,1,Entire home/apt,150,113,0.27,263
31961,Deborah,1,Entire home/apt,170,0,0.07,170
31963,John,3,Entire home/apt,350,332,1.83,682
31964,Kevin,1,Entire home/apt,175,1,0.59,176
31965,Miki,1,Entire home/apt,105,115,3.04,220
31966,Kevin,2,Private room,54,90,0.54,144
31967,Sergio,3,Private room,90,269,0.28,359
31968,Alexander,3,Entire home/apt,125,0,0.26,125
31970,Maxime C And Winie C,1,Entire home/apt,400,175,0.24,575
31971,Brendan,2,Entire home/apt,139,68,3.28,207
31972,Jessica,2,Entire home/apt,135,92,3.04,227
31974,Natalie,1,Entire home/apt,175,0,0.38,175
31975,Studio,2,Entire home/apt,140,178,0.08,318
31976,Earl,1,Entire home/apt,126,30,2.03,156
31977,Monica,2,Private room,75,68,0.96,143
31978,Kayleigh,2,Private room,62,0,0.36,62
31979,David,2,Private room,99,0,0.14,99
31980,Joseph,3,Private room,50,337,4.0,387
31981,Meghan,1,Entire home/apt,224,7,0.29,231
31982,Jenna,2,Private room,95,11,0.22,106
31983,Mark,2,Entire home/apt,108,99,0.36,207
31984,Robert,1,Private room,94,0,0.78,94
31985,Susan,1,Entire home/apt,160,117,3.44,277
31986,Karilyn,5,Entire home/apt,72,333,1.05,405
31987,Kate,1,Entire home/apt,199,329,1.58,528
31988,Esin,3,Private room,50,112,0.29,162
31989,Anthony,2,Private room,75,0,0.58,75
31990,Diana,3,Entire home/apt,169,297,0.62,466
31991,Jose,2,Private room,75,292,3.4,367
31992,Susan,1,Entire home/apt,85,119,3.51,204
31993,Jamesdean,3,Private room,75,0,0.16,75
31994,Yan,3,Private room,99,4,3.92,103
31995,Margarita,5,Private room,120,86,0.29,206
31996,Sia,1,Entire home/apt,200,0,0.45,200
31997,Faraz,3,Private room,80,0,0.65,80
31998,Veronique,2,Entire home/apt,150,100,2.93,250
31999,Briyah,3,Private room,55,179,3.11,234
32001,Alexandra,1,Entire home/apt,120,0,0.15,120
32002,Linda,1,Private room,90,0,0.37,90
32003,Alexander,1,Entire home/apt,1500,54,1.21,1554
32004,Shatese,3,Private room,40,90,5.07,130
32005,Lise,3,Private room,42,281,0.36,323
32006,Joy,3,Private room,55,122,0.76,177
32007,Thomas,1,Entire home/apt,180,11,0.92,191
32008,Guillermo,1,Entire home/apt,225,35,2.21,260
32009,Maurice,2,Entire home/apt,150,288,2.09,438
32010,Aboubakar,4,Private room,50,188,1.64,238
32011,Madison,1,Entire home/apt,170,61,0.32,231
32012,Benjamin,2,Entire home/apt,50,0,0.63,50
32013,Victor,1,Entire home/apt,350,224,4.28,574
32014,Nicholas,2,Entire home/apt,415,0,0.07,415
32015,Priscilla,2,Entire home/apt,112,0,3.93,112
32016,Helen Maria,1,Private room,170,0,0.5,170
32017,Maria,2,Private room,80,178,0.11,258
32018,Leslie,1,Entire home/apt,300,352,0.57,652
32019,Auri,2,Private room,60,91,3.61,151
32020,Win,3,Private room,54,48,9.74,102
32021,Suleyma,4,Private room,46,63,4.89,109
32022,Anne,4,Private room,80,0,0.44,80
32023,Maria,5,Entire home/apt,180,130,0.79,310
32024,Dasha,2,Entire home/apt,168,284,0.22,452
32027,Dylan,2,Private room,97,189,1.68,286
32028,Michelle,3,Private room,48,168,0.79,216
32029,Chloe,2,Entire home/apt,95,126,1.61,221
32030,Anna,1,Entire home/apt,170,24,0.78,194
32031,Stefani,1,Private room,125,29,6.64,154
32032,Devon,1,Private room,175,13,3.14,188
32033,A,1,Private room,80,0,0.23,80
32034,Kana,1,Entire home/apt,139,28,3.45,167
32035,Umber,1,Entire home/apt,162,0,0.28,162
32036,Gigi,2,Private room,75,249,2.26,324
32037,Doris,3,Entire home/apt,93,316,3.47,409
32038,Jay,1,Private room,99,0,1.29,99
32039,Meng,1,Entire home/apt,89,34,1.12,123
32040,Chloe,2,Private room,85,67,1.64,152
32041,Rasmus,1,Entire home/apt,2500,150,1.38,2650
32042,Rachel,1,Private room,105,64,0.39,169
32043,Anita,2,Entire home/apt,100,23,2.55,123
32044,Charles,1,Entire home/apt,198,12,0.28,210
32045,Micaela,2,Private room,48,0,0.45,48
32047,Tal,2,Entire home/apt,110,125,0.14,235
32048,Ola,1,Entire home/apt,206,12,0.22,218
32050,Alex & Dave,2,Private room,90,48,5.58,138
32051,Kendra,1,Entire home/apt,220,84,1.21,304
32052,Suri,2,Private room,150,365,0.27,515
32054,Drew,1,Private room,65,0,0.71,65
32055,John,1,Entire home/apt,170,0,0.52,170
32056,Monique & Bianca,4,Entire home/apt,399,356,1.79,755
32057,Tashi,1,Entire home/apt,175,0,0.15,175
32058,Kellie & Joachim,2,Entire home/apt,99,119,2.58,218
32059,Garth,2,Entire home/apt,185,125,0.87,310
32060,Mariano,1,Entire home/apt,150,304,2.63,454
32061,Ana,2,Entire home/apt,175,292,0.74,467
32062,Ness,2,Entire home/apt,189,99,1.82,288
32063,John,2,Private room,51,180,0.97,231
32064,Masako,1,Entire home/apt,398,12,0.25,410
32065,Sanah,1,Entire home/apt,175,0,0.51,175
32066,Carol,2,Entire home/apt,160,246,3.02,406
32067,Nicole,2,Entire home/apt,65,61,9.13,126
32068,Sorel,2,Private room,130,103,2.73,233
32069,Phil,2,Entire home/apt,96,237,2.88,333
32070,Odit (Andy),3,Entire home/apt,89,313,2.52,402
32071,Miho,2,Private room,70,163,3.01,233
32072,Jerome,2,Entire home/apt,99,0,0.23,99
32074,Mihyun,1,Private room,69,156,0.53,225
32075,Mary,1,Entire home/apt,500,363,0.09,863
32076,Juliana,1,Private room,50,311,0.17,361
32077,Wendy,2,Private room,120,75,1.42,195
32078,Michelle,2,Entire home/apt,197,228,0.78,425
32080,Stefan,3,Entire home/apt,105,95,3.47,200
32081,Tiffany,1,Entire home/apt,170,35,0.59,205
32082,Elizabeth,2,Private room,68,85,2.73,153
32084,Isabell,1,Entire home/apt,200,0,0.45,200
32086,Mona,1,Entire home/apt,165,203,0.29,368
32087,Kit,1,Entire home/apt,200,224,0.82,424
32088,@ Art House Monique,2,Entire home/apt,265,114,0.29,379
32089,Georgina,1,Private room,100,0,0.07,100
32090,YuJin,1,Entire home/apt,140,44,0.64,184
32091,Sunhwa,1,Entire home/apt,128,142,0.5,270
32092,Bruce,2,Entire home/apt,125,335,2.97,460
32093,Ez,1,Entire home/apt,150,207,4.41,357
32094,Etty,1,Private room,80,323,1.75,403
32095,Kenya,2,Private room,52,0,0.16,52
32096,Daveth,2,Entire home/apt,350,69,2.63,419
32097,Mike,2,Entire home/apt,129,0,0.36,129
32098,Amalia,1,Entire home/apt,125,0,0.24,125
32099,Evan,2,Private room,100,0,0.61,100
32100,Zoey,1,Entire home/apt,140,7,1.11,147
32101,Nick & Vance,2,Private room,45,92,4.38,137
32102,Reenie,2,Private room,70,20,0.8,90
32103,Atthaphon,2,Private room,75,0,0.15,75
32104,Arlene,2,Private room,110,254,1.13,364
32105,Elvis,4,Private room,90,35,0.11,125
32106,Brittany,1,Private room,100,0,2.51,100
32107,Kirill,1,Entire home/apt,176,67,4.17,243
32108,Maggy S,1,Shared room,90,60,2.75,150
32109,Claudia,1,Private room,89,0,0.38,89
32110,Irina,1,Entire home/apt,120,342,0.35,462
32111,Marwa,1,Private room,65,365,0.83,430
32112,L,1,Shared room,95,89,0.15,184
32113,Joey,1,Entire home/apt,180,340,0.86,520
32114,Ming,2,Private room,60,64,2.61,124
32116,Steven,1,Entire home/apt,191,28,3.17,219
32117,Alexandria,1,Entire home/apt,130,0,0.17,130
32118,Jonathan,2,Entire home/apt,650,0,0.44,650
32119,James,1,Private room,175,0,0.31,175
32120,Shirley,1,Private room,100,109,3.51,209
32121,Luis,2,Entire home/apt,113,1,0.46,114
32122,Juan,1,Private room,43,90,0.57,133
32124,Luciana,1,Private room,95,12,0.58,107
32125,Lindsey,1,Entire home/apt,200,159,2.79,359
32126,Raymond And Kymme,2,Entire home/apt,130,122,3.99,252
32128,Lyudmila,2,Private room,100,250,0.22,350
32130,Jessica,2,Private room,100,0,0.08,100
32131,Jackson,1,Entire home/apt,190,156,0.51,346
32132,Paula,1,Entire home/apt,150,298,3.69,448
32133,Kelly,3,Entire home/apt,65,26,2.13,91
32136,Janet,2,Entire home/apt,120,2,0.67,122
32137,Benjamin,2,Entire home/apt,186,342,0.16,528
32138,Monica,2,Entire home/apt,120,23,2.49,143
32139,Kheira,3,Private room,50,337,1.38,387
32140,Amarjit S,5,Private room,32,340,0.73,372
32141,Taylor,1,Entire home/apt,239,7,1.25,246
32142,Aaron,2,Private room,45,242,0.27,287
32143,Ina,1,Entire home/apt,159,31,0.89,190
32144,Emily,1,Entire home/apt,130,200,0.22,330
32145,Osvaldo,2,Entire home/apt,107,0,0.08,107
32146,Eric,2,Entire home/apt,75,0,0.22,75
32147,Brendan,1,Private room,120,0,0.15,120
32148,Dafna,2,Entire home/apt,80,0,0.73,80
32149,Camille,1,Entire home/apt,250,301,3.11,551
32150,Benjamin,2,Entire home/apt,217,189,0.09,406
32151,Danny,1,Entire home/apt,699,170,2.92,869
32153,Julia,2,Entire home/apt,150,0,0.49,150
32155,Ian,1,Entire home/apt,225,3,0.52,228
32156,Karen,1,Entire home/apt,225,283,1.8,508
32157,Cloe,1,Entire home/apt,140,51,3.58,191
32158,Gerusa,3,Private room,49,4,1.83,53
32159,John,3,Entire home/apt,450,315,2.35,765
32160,Feliz,1,Entire home/apt,200,337,1.94,537
32161,Irina,1,Entire home/apt,112,16,4.78,128
32162,Yaffa,3,Entire home/apt,89,84,2.64,173
32163,Alex,2,Private room,209,15,3.07,224
32164,Laure-Anne,2,Entire home/apt,300,365,1.01,665
32165,Lolita,3,Private room,49,322,2.96,371
32166,Lolita,3,Private room,50,363,2.02,413
32167,Jeff & Elita,1,Entire home/apt,294,179,2.48,473
32169,Alliot,2,Entire home/apt,150,364,0.15,514
32170,Harry,1,Entire home/apt,89,17,1.36,106
32171,Belinda,2,Entire home/apt,79,124,2.73,203
32172,Kathryn,2,Entire home/apt,50,0,0.61,50
32173,Michael,1,Private room,70,5,2.32,75
32174,Amit & Sofie,3,Entire home/apt,118,0,0.09,118
32175,Trina,1,Private room,75,0,0.15,75
32176,Kitti,2,Private room,41,0,0.08,41
32177,Leticia,3,Entire home/apt,190,36,1.76,226
32178,Maggie,1,Entire home/apt,90,0,0.35,90
32179,Roberta,2,Entire home/apt,195,15,0.34,210
32180,Nnenna,2,Entire home/apt,150,106,0.31,256
32181,Aviva,2,Private room,47,0,0.31,47
32182,Liz,3,Entire home/apt,86,174,8.27,260
32183,Charissa,1,Private room,160,9,0.87,169
32184,Scott,1,Entire home/apt,150,355,1.32,505
32185,Roberto,2,Private room,45,106,3.19,151
32187,Olivier,2,Private room,78,9,3.74,87
32188,George,2,Entire home/apt,169,0,0.93,169
32189,Pamela,3,Entire home/apt,169,128,1.4,297
32190,Yangbing,1,Private room,86,0,0.08,86
32192,Jimmy,2,Private room,99,54,2.96,153
32194,Jimmy,2,Private room,105,32,1.77,137
32195,Angie,2,Private room,85,337,0.53,422
32197,Mariaval,1,Private room,97,0,0.44,97
32199,Sonder,1,Entire home/apt,232,299,0.12,531
32200,Skarly & Ming,2,Private room,40,36,2.31,76
32201,Rhianna,2,Private room,100,8,0.88,108
32202,Adam,1,Entire home/apt,100,0,0.66,100
32203,Eva,1,Entire home/apt,400,0,0.57,400
32204,Karan,3,Private room,69,79,5.92,148
32205,Liza,1,Entire home/apt,180,228,6.12,408
32206,Karine,2,Entire home/apt,150,316,2.04,466
32207,Lina,2,Entire home/apt,88,126,0.38,214
32208,Sonder,1,Entire home/apt,169,337,0.27,506
32209,Margarita,5,Private room,40,89,0.73,129
32210,Ramon,1,Entire home/apt,390,79,5.31,469
32211,Lindsay,1,Entire home/apt,600,134,3.37,734
32212,Margarita,5,Private room,50,84,0.3,134
32213,Henry,2,Private room,55,0,1.69,55
32215,Julia,2,Private room,95,0,0.73,95
32216,Brandon,3,Entire home/apt,85,130,2.65,215
32217,My,1,Private room,65,35,0.58,100
32218,Joseph,2,Entire home/apt,100,358,0.29,458
32219,Hugo,2,Entire home/apt,295,68,1.42,363
32222,My,1,Private room,89,7,1.2,96
32223,Marlyn,2,Private room,49,342,0.62,391
32224,Dimitri,5,Private room,75,128,0.3,203
32225,Maegan,3,Shared room,45,0,0.37,45
32227,Maria,2,Entire home/apt,125,0,0.09,125
32228,Festus Atu,1,Private room,149,270,2.2,419
32229,Stanley,3,Private room,110,365,0.28,475
32232,James,1,Private room,90,0,0.16,90
32233,Peter,1,Entire home/apt,182,30,0.9,212
32234,Sophia,2,Entire home/apt,65,269,0.21,334
32235,Jocelyn,1,Entire home/apt,95,0,2.28,95
32236,Alex,2,Private room,46,0,0.08,46
32237,Justine,2,Private room,120,0,3.1,120
32238,Honglip,2,Private room,37,70,3.94,107
32239,Chloe,2,Private room,85,0,0.6,85
32240,Isabela,2,Private room,85,233,6.06,318
32242,Kate,1,Private room,110,6,0.15,116
32243,Gala,2,Entire home/apt,140,216,1.52,356
32244,Garvey,1,Entire home/apt,150,0,0.08,150
32245,Nate,2,Private room,85,336,2.46,421
32246,Damian,1,Entire home/apt,130,0,0.87,130
32248,Sabrina,2,Entire home/apt,130,7,0.31,137
32249,Sarah,2,Entire home/apt,125,0,1.14,125
32250,Edwin,4,Private room,74,58,1.77,132
32251,Cyn,1,Private room,99,42,3.96,141
32252,Anita,2,Private room,62,263,8.25,325
32253,Stephanie,1,Entire home/apt,200,53,1.47,253
32254,Robert,1,Entire home/apt,180,34,0.39,214
32255,Xinhua,1,Private room,46,0,0.51,46
32256,Cortney,2,Private room,70,0,0.08,70
32259,John,3,Entire home/apt,200,0,0.33,200
32260,Victoria,1,Private room,100,0,0.3,100
32261,Hendrick,2,Entire home/apt,100,107,3.81,207
32263,Maggie,2,Private room,40,0,0.22,40
32264,Andrea,1,Entire home/apt,120,105,1.03,225
32265,Petya,3,Private room,38,310,0.08,348
32266,Yvonne,2,Private room,55,326,0.41,381
32267,Yvonne,2,Private room,60,177,1.52,237
32268,Vera,1,Entire home/apt,199,347,0.74,546
32269,Faith,1,Private room,50,0,2.26,50
32270,Inigo,2,Private room,32,1,0.17,33
32271,Laura J.,3,Entire home/apt,175,28,0.68,203
32272,Di,1,Private room,74,0,0.15,74
32273,Eric,1,Entire home/apt,175,22,0.91,197
32275,Madz,2,Entire home/apt,150,8,0.8,158
32276,Teon,2,Entire home/apt,200,2,0.69,202
32277,Saron,2,Private room,95,0,0.29,95
32278,Keren J,4,Entire home/apt,86,111,3.18,197
32279,"Brian,Gigi & Clementine",2,Entire home/apt,260,3,0.18,263
32280,Andres,2,Private room,65,49,1.36,114
32281,Kimberley,1,Entire home/apt,165,38,5.51,203
32282,Francis,2,Entire home/apt,150,0,0.4,150
32283,Cara,1,Entire home/apt,140,334,0.15,474
32284,Emily,1,Entire home/apt,62,5,0.29,67
32285,Billy,1,Shared room,100,354,1.53,454
32288,Tyni,1,Shared room,44,6,1.83,50
32289,Dmitriy,1,Private room,75,0,0.34,75
32290,Maite,1,Entire home/apt,299,0,0.2,299
32292,Ricky,3,Private room,70,319,2.4,389
32293,Festus Atu,1,Private room,149,270,2.31,419
32294,Anne,2,Entire home/apt,145,25,0.08,170
32295,Kyunam,1,Private room,50,90,1.0,140
32296,Kyunam,1,Private room,50,83,0.62,133
32297,Jehnna,2,Private room,80,67,0.93,147
32299,Alley,2,Private room,60,66,0.32,126
32300,Curtis,2,Entire home/apt,92,179,1.23,271
32301,Heena,3,Private room,80,89,0.31,169
32302,Teresa,2,Entire home/apt,155,67,2.18,222
32303,Daniel,2,Private room,65,8,1.03,73
32304,John,1,Private room,156,318,0.4,474
32305,Lindsey,2,Private room,100,0,0.59,100
32306,Tiffany,1,Entire home/apt,197,0,0.48,197
32307,Martita,2,Private room,80,160,2.09,240
32308,Meredith,2,Entire home/apt,250,0,1.83,250
32309,Adelina,2,Private room,45,35,0.35,80
32310,Colin,2,Private room,50,0,0.37,50
32311,Robert,1,Entire home/apt,250,223,0.85,473
32312,Conor,1,Entire home/apt,199,92,3.74,291
32313,Frankie,2,Entire home/apt,150,0,0.38,150
32314,Hilary,2,Private room,80,0,0.08,80
32315,Lamesha,4,Private room,33,365,0.09,398
32316,Juan,1,Private room,85,90,1.91,175
32317,Melissa,2,Private room,65,308,0.96,373
32318,Chester,1,Private room,100,91,1.79,191
32319,Marija,2,Entire home/apt,60,0,0.18,60
32320,Adriana,2,Entire home/apt,150,0,0.3,150
32321,Margarita,1,Private room,80,18,0.16,98
32322,Michael,1,Entire home/apt,339,0,1.37,339
32323,Jeffree,1,Entire home/apt,175,0,0.52,175
32324,Michael,1,Entire home/apt,339,0,1.13,339
32325,Elizabeth,1,Private room,100,86,0.14,186
32326,Pedro,1,Private room,100,0,0.08,100
32327,Zane,2,Entire home/apt,200,119,1.14,319
32328,Mamadou,1,Private room,75,84,1.4,159
32329,Kaitlyn,1,Entire home/apt,140,0,0.51,140
32330,Bora,2,Entire home/apt,245,58,0.16,303
32331,Christopher,4,Entire home/apt,195,313,0.19,508
32332,Skarly & Ming,2,Private room,45,54,1.97,99
32333,Saida,2,Entire home/apt,93,330,1.03,423
32334,Eddie,1,Private room,35,22,4.76,57
32335,Angela,3,Private room,40,336,2.42,376
32337,Jade,2,Private room,65,124,5.01,189
32338,Sevasti,3,Entire home/apt,156,67,5.16,223
32339,Melissa,2,Private room,60,340,1.76,400
32340,Melissa,2,Private room,60,310,2.22,370
32341,Mark,1,Entire home/apt,399,158,4.26,557
32343,Katie,2,Entire home/apt,95,0,0.24,95
32344,Caroline,2,Entire home/apt,108,158,2.77,266
32345,David,1,Entire home/apt,269,277,0.66,546
32346,Laura,2,Entire home/apt,240,0,0.31,240
32347,Lewis,1,Entire home/apt,200,50,2.72,250
32348,Rnl,4,Entire home/apt,80,142,5.34,222
32349,Mirjam,2,Private room,61,1,1.84,62
32350,Shari,2,Entire home/apt,200,16,0.16,216
32351,Darryl,1,Private room,50,157,1.74,207
32352,Stephanie,3,Entire home/apt,100,160,0.88,260
32353,Kara,3,Private room,65,131,1.63,196
32354,Olvin,2,Private room,60,0,0.08,60
32355,James,1,Entire home/apt,410,10,3.2,420
32356,Cesar,1,Private room,55,35,0.8,90
32357,Sandy,1,Entire home/apt,245,163,0.68,408
32358,Farhan,3,Entire home/apt,132,316,8.38,448
32359,Shanthi,4,Private room,45,193,0.09,238
32360,Kiki,1,Entire home/apt,155,301,1.22,456
32361,Gotham,1,Entire home/apt,225,357,4.83,582
32362,Ilana,2,Entire home/apt,150,0,0.16,150
32363,Shadi,2,Private room,150,0,1.52,150
32364,Steph,1,Entire home/apt,450,36,1.04,486
32365,Billy,1,Private room,100,323,1.92,423
32366,Billy,1,Private room,110,348,3.25,458
32367,Ingrid,2,Entire home/apt,160,37,3.9,197
32368,Mark,1,Shared room,220,89,0.07,309
32369,Colin,3,Entire home/apt,150,0,0.16,150
32370,Chris,1,Entire home/apt,350,88,0.83,438
32371,Christen,2,Entire home/apt,53,29,0.3,82
32372,Fabiana,1,Entire home/apt,1000,84,0.79,1084
32373,Kat,1,Entire home/apt,145,1,1.02,146
32374,Dennis,1,Private room,68,0,2.56,68
32375,Janet,3,Private room,60,155,5.12,215
32376,Dima,1,Private room,85,19,9.43,104
32377,Antonio,2,Private room,60,155,0.51,215
32378,Janet,3,Private room,65,333,2.57,398
32379,Alex,1,Entire home/apt,130,10,0.88,140
32380,Mike,2,Private room,61,0,0.15,61
32382,Dinorah,2,Private room,41,0,4.14,41
32383,Joe,1,Entire home/apt,425,106,3.85,531
32384,Voxie,2,Entire home/apt,135,358,1.21,493
32385,Seth,2,Entire home/apt,85,318,1.18,403
32389,Ryne,2,Entire home/apt,117,108,3.51,225
32390,Damien,2,Entire home/apt,95,5,1.12,100
32391,Mark,2,Private room,75,89,0.97,164
32392,Ting Yi,2,Entire home/apt,140,229,1.05,369
32394,Jackie,1,Private room,85,0,0.86,85
32395,Aldric,2,Entire home/apt,200,179,0.29,379
32396,Clint,4,Entire home/apt,149,328,4.33,477
32397,Shannon,2,Private room,85,32,0.27,117
32398,Will,2,Shared room,30,0,1.6,30
32400,Dani,1,Entire home/apt,200,230,5.23,430
32401,Kisha,3,Private room,60,365,0.45,425
32402,Josh,1,Private room,150,3,2.91,153
32403,Dean,1,Private room,109,0,0.53,109
32405,M.J.B.,1,Entire home/apt,650,23,0.09,673
32406,Annajan,2,Entire home/apt,140,5,0.34,145
32407,Stacey,2,Entire home/apt,200,246,3.3,446
32408,Nick,1,Entire home/apt,120,1,0.49,121
32409,Peter,2,Entire home/apt,175,6,0.68,181
32410,Gabriel,2,Entire home/apt,170,288,0.62,458
32412,Martita,2,Private room,90,256,1.61,346
32413,Nikolas,3,Private room,110,90,0.48,200
32414,Meng,1,Entire home/apt,89,3,4.64,92
32415,Stephanie,3,Entire home/apt,96,0,0.78,96
32416,Patrick,1,Private room,70,147,1.99,217
32417,Hardeep,3,Private room,80,147,6.35,227
32418,Annero,2,Private room,65,361,1.79,426
32419,Nancy,2,Private room,150,293,2.71,443
32420,Geraldine,1,Private room,100,12,3.87,112
32421,Geraldine,1,Private room,99,0,7.2,99
32422,Walter,1,Private room,150,57,1.25,207
32423,Shriver,2,Private room,69,49,2.85,118
32424,Annie And Joan,2,Entire home/apt,375,158,0.96,533
32425,Arjang,2,Private room,55,313,1.84,368
32426,Jenny,1,Entire home/apt,175,3,1.45,178
32427,Eyal & Jessie,3,Private room,90,284,4.31,374
32428,Celeste,2,Private room,60,75,1.71,135
32429,Stefanie,1,Private room,100,341,0.15,441
32430,Cora & Kai,1,Private room,47,174,0.99,221
32431,Matthew,1,Entire home/apt,160,156,0.71,316
32432,Eddie,3,Entire home/apt,80,307,3.16,387
32433,Ai,1,Private room,125,0,1.9,125
32434,Elena,1,Private room,81,38,1.34,119
32436,Victor,2,Entire home/apt,183,15,4.36,198
32437,Pnb,4,Entire home/apt,60,257,0.76,317
32438,Chris,1,Entire home/apt,120,172,0.09,292
32439,The 6o2,2,Entire home/apt,1000,365,0.12,1365
32440,Shelley,2,Private room,156,4,2.33,160
32441,Michele,2,Entire home/apt,300,185,0.33,485
32443,Marsha,2,Private room,70,331,0.08,401
32444,Helena,1,Private room,80,76,2.31,156
32445,Carolina,2,Entire home/apt,120,0,0.19,120
32448,Michon,2,Private room,110,49,0.39,159
32449,Elle,1,Private room,55,0,0.25,55
32450,Dave,2,Private room,100,89,0.1,189
32451,John,1,Private room,55,324,0.91,379
32452,Kemar,2,Private room,75,54,3.05,129
32453,Emily,2,Entire home/apt,160,261,0.08,421
32454,Richard,1,Entire home/apt,170,0,0.16,170
32456,Elena,1,Entire home/apt,120,154,4.25,274
32457,Viktoria,2,Private room,230,24,1.72,254
32458,Maranatha,2,Entire home/apt,125,98,4.38,223
32459,Lily,2,Private room,100,3,0.45,103
32460,S. N,1,Entire home/apt,300,108,0.17,408
32461,Brandon,1,Entire home/apt,125,67,0.18,192
32463,Christine,2,Private room,100,76,1.9,176
32464,Sonder,1,Entire home/apt,250,220,0.09,470
32465,Cristiane,3,Private room,50,11,3.68,61
32466,Rachel,3,Private room,70,180,1.96,250
32467,Jonathan,3,Private room,43,282,2.5,325
32468,Suanny,2,Private room,95,180,1.07,275
32471,Gabriela,2,Entire home/apt,95,0,1.04,95
32473,Kea,1,Entire home/apt,190,17,2.74,207
32475,Sonder,1,Entire home/apt,207,365,0.08,572
32476,Hyeseung,2,Entire home/apt,100,11,0.08,111
32477,Sonder,1,Entire home/apt,180,342,0.09,522
32478,Mayumi,1,Private room,99,8,1.06,107
32479,Zoya,2,Entire home/apt,125,0,0.18,125
32480,Mala,3,Private room,50,84,2.96,134
32481,Carita,2,Entire home/apt,190,17,0.32,207
32482,Cesar,1,Private room,55,125,0.16,180
32483,Jenny,2,Entire home/apt,150,0,1.17,150
32484,Isaac,2,Entire home/apt,75,2,5.23,77
32485,Andrew,1,Entire home/apt,500,126,3.17,626
32486,R.Henry,1,Shared room,69,205,3.86,274
32487,R.Henry,1,Shared room,99,181,3.12,280
32488,R.Henry,1,Shared room,65,199,3.27,264
32489,R.Henry,1,Shared room,65,196,4.68,261
32490,Anthony,2,Private room,36,309,0.38,345
32491,Dylan,2,Entire home/apt,125,0,0.09,125
32492,Enoch,2,Private room,50,7,4.52,57
32493,Tanya,2,Entire home/apt,250,5,0.24,255
32494,Jessica,3,Private room,54,0,0.17,54
32495,Zoltan,3,Private room,55,61,0.45,116
32496,Leo,2,Entire home/apt,95,12,0.63,107
32497,Francis,1,Entire home/apt,115,38,3.41,153
32498,Pnb,4,Private room,35,75,2.82,110
32499,Tamara & Fran,4,Entire home/apt,105,328,2.13,433
32500,Margaret,3,Private room,200,332,1.28,532
32501,Nicholas,1,Private room,123,53,4.09,176
32503,Ruben,1,Entire home/apt,300,0,1.07,300
32504,Carlos,1,Private room,120,48,4.23,168
32505,Julissa,4,Private room,70,348,0.17,418
32506,Roberto,1,Private room,140,69,3.71,209
32507,Amanda,1,Private room,114,0,0.08,114
32508,Afshan,2,Private room,80,0,0.22,80
32509,Alex,2,Entire home/apt,85,0,0.17,85
32510,Johnnet,4,Private room,125,189,0.88,314
32511,Robert,1,Entire home/apt,157,0,0.3,157
32512,Corporate Housing,1,Entire home/apt,125,346,0.44,471
32513,May,1,Private room,90,16,1.0,106
32515,Otoja,1,Entire home/apt,195,200,1.05,395
32516,Wendy,2,Private room,230,90,1.66,320
32517,Jenna,1,Private room,40,0,0.47,40
32518,Niki,2,Private room,65,0,0.53,65
32519,Evelyn,1,Entire home/apt,325,56,0.42,381
32520,Selina,2,Entire home/apt,460,63,2.49,523
32521,Lindsey,2,Shared room,30,0,0.61,30
32522,Nadir,1,Entire home/apt,132,236,0.12,368
32524,C. Jack,1,Entire home/apt,180,90,3.69,270
32525,Gregory,1,Entire home/apt,149,265,4.74,414
32526,Tricia,2,Entire home/apt,90,21,4.19,111
32527,Aron,1,Entire home/apt,149,224,4.77,373
32530,Alarape,5,Entire home/apt,115,263,2.67,378
32531,Maia,3,Entire home/apt,50,0,0.16,50
32532,Laura,1,Private room,55,0,0.16,55
32533,Rodolfo,2,Entire home/apt,100,124,7.77,224
32534,Josh & Madeleine,2,Private room,90,0,2.98,90
32535,J,1,Entire home/apt,160,33,5.11,193
32536,Deni,3,Entire home/apt,100,326,0.34,426
32537,Diana,3,Private room,60,0,0.23,60
32538,Aprilene,2,Private room,75,90,0.63,165
32540,Mallary,2,Private room,120,0,0.09,120
32541,Numi,2,Private room,149,357,0.08,506
32542,William,1,Private room,85,0,0.23,85
32543,Omar,1,Private room,182,131,2.95,313
32545,Suzanne,2,Entire home/apt,160,17,0.49,177
32546,Sandia,1,Private room,50,0,0.16,50
32547,Jessica,1,Entire home/apt,175,0,0.38,175
32549,Jackie,1,Entire home/apt,179,54,2.06,233
32550,Na,1,Entire home/apt,350,0,0.87,350
32551,Mikaela,2,Private room,45,0,0.15,45
32552,Katie,2,Private room,100,33,1.36,133
32553,Artem,1,Private room,136,130,0.78,266
32554,Christopher R,4,Entire home/apt,125,72,6.02,197
32555,Uri,2,Entire home/apt,60,224,0.85,284
32556,Mads,1,Entire home/apt,200,66,0.15,266
32557,Simon,2,Entire home/apt,80,0,0.68,80
32559,Jared,1,Shared room,235,21,0.7,256
32560,Irene,1,Private room,249,41,2.2,290
32561,Eric,1,Private room,125,2,0.47,127
32562,Fola,2,Private room,65,0,0.1,65
32564,Natalie,2,Private room,45,0,1.22,45
32565,Jackee,3,Entire home/apt,325,299,1.59,624
32566,Kemar,2,Entire home/apt,150,6,0.74,156
32567,Anne,1,Private room,150,120,7.69,270
32569,Lia,1,Entire home/apt,165,337,1.0,502
32570,Ali,3,Entire home/apt,189,324,3.52,513
32571,Dennis,1,Private room,1100,0,0.09,1100
32572,Michel,2,Private room,50,0,1.41,50
32573,Gal,2,Entire home/apt,200,0,0.08,200
32574,WeWork,1,Entire home/apt,225,323,7.59,548
32577,Blake,2,Entire home/apt,350,171,1.0,521
32578,Talia,1,Entire home/apt,499,55,0.82,554
32579,Kevin,1,Entire home/apt,115,81,1.26,196
32580,Stefan,3,Private room,100,90,0.68,190
32581,Kohl,1,Private room,95,0,0.68,95
32582,Mike,1,Private room,43,116,0.82,159
32583,Elena,1,Entire home/apt,120,53,5.37,173
32585,Bethany,2,Entire home/apt,215,218,3.95,433
32586,Clare,2,Entire home/apt,200,1,0.33,201
32587,Olivia,1,Entire home/apt,299,84,2.74,383
32588,Robert,1,Private room,115,11,5.8,126
32590,Ali & Guillaume,2,Entire home/apt,129,0,0.61,129
32591,Rachel,2,Private room,84,51,7.13,135
32592,Artem,2,Entire home/apt,170,57,3.7,227
32593,Claudia,1,Entire home/apt,149,0,2.01,149
32594,Ish,2,Private room,47,89,2.82,136
32595,Marie,2,Entire home/apt,125,194,4.92,319
32596,Sonder,1,Entire home/apt,177,58,0.3,235
32597,Kazuyuki,2,Entire home/apt,500,160,1.26,660
32598,Sarah,2,Private room,60,0,0.23,60
32599,Lenny,1,Entire home/apt,100,0,0.07,100
32600,Marc & Youna,1,Entire home/apt,180,4,0.71,184
32601,Rina,1,Private room,65,21,2.97,86
32602,John,1,Entire home/apt,200,23,3.77,223
32603,Maya,3,Private room,50,295,4.37,345
32604,Freddie,2,Private room,150,39,0.49,189
32605,Ted,2,Entire home/apt,159,110,4.07,269
32606,Joachim,2,Entire home/apt,130,0,0.15,130
32607,Jessica Rose,1,Private room,100,263,0.1,363
32608,Vivi,3,Private room,65,341,0.53,406
32609,David,1,Private room,100,0,0.08,100
32610,Nati,1,Entire home/apt,185,133,1.87,318
32613,Omari,1,Entire home/apt,398,139,3.06,537
32614,John,1,Private room,62,324,0.52,386
32615,Chris,2,Entire home/apt,180,61,1.27,241
32617,Adam,2,Entire home/apt,75,0,0.84,75
32618,Telia,4,Entire home/apt,150,175,3.15,325
32619,Letitia,4,Shared room,33,6,0.71,39
32620,Samuel,2,Entire home/apt,200,0,0.92,200
32621,Maritza,2,Entire home/apt,99,40,0.25,139
32622,Kaptan,1,Private room,100,335,0.99,435
32623,Marlyn,2,Private room,49,354,0.78,403
32624,Yvonne,2,Private room,50,365,0.46,415
32625,Hiba,1,Private room,83,77,0.46,160
32626,Briana,3,Private room,40,0,0.99,40
32627,Hyacinth,2,Private room,45,320,2.61,365
32628,Denada,5,Entire home/apt,161,87,1.82,248
32629,Jasmine,1,Private room,125,0,1.63,125
32630,Adelina,3,Entire home/apt,90,127,3.22,217
32631,Sagawa,1,Private room,85,133,1.38,218
32632,R.Henry,1,Shared room,69,192,6.09,261
32633,Maria,3,Private room,85,0,0.16,85
32634,R.Henry,1,Shared room,65,204,4.19,269
32635,Maria,1,Private room,99,346,3.05,445
32636,Adesh & Viviana,3,Entire home/apt,110,140,0.88,250
32637,John,1,Private room,70,310,0.73,380
32638,John,1,Private room,100,271,0.64,371
32639,Mo,3,Entire home/apt,25,292,3.37,317
32641,Mitsu,1,Entire home/apt,110,15,2.64,125
32642,Pablo & Anastasiya,3,Private room,60,204,2.67,264
32643,Carla,2,Private room,55,0,0.35,55
32644,Sophie,1,Private room,98,238,3.95,336
32645,Sanjay,2,Entire home/apt,295,1,0.87,296
32646,CJ & Raissa,3,Entire home/apt,80,189,3.27,269
32647,Natalie,1,Shared room,70,66,0.55,136
32648,Freda,3,Entire home/apt,400,334,0.36,734
32649,Anastasia,2,Private room,66,0,0.46,66
32650,Sophie,1,Private room,98,219,4.23,317
32651,Aryuna,1,Entire home/apt,186,79,0.54,265
32652,Jinfei,3,Private room,60,108,3.68,168
32653,Sophie,1,Private room,97,246,4.52,343
32654,Jinfei,3,Private room,60,171,0.74,231
32655,Sophie,1,Private room,98,242,4.25,340
32656,Emerald,2,Entire home/apt,200,101,0.35,301
32657,John,1,Private room,62,337,0.75,399
32658,John,1,Private room,62,328,0.66,390
32659,Lily,1,Entire home/apt,138,1,4.44,139
32660,Alec,1,Private room,65,68,3.0,133
32661,Rachel,2,Private room,90,88,0.16,178
32662,John & Christine,3,Entire home/apt,99,133,1.66,232
32663,Julia,1,Entire home/apt,350,291,5.27,641
32664,Nardia,2,Entire home/apt,140,0,2.12,140
32665,Charlene,2,Entire home/apt,85,34,2.74,119
32666,Melissa,1,Entire home/apt,200,2,2.85,202
32667,D,1,Private room,90,208,0.63,298
32668,Alexandria,2,Private room,60,0,0.39,60
32669,Emelie,1,Entire home/apt,225,0,0.24,225
32670,Stephany,2,Private room,48,0,9.97,48
32671,Gail,3,Entire home/apt,149,350,0.61,499
32672,Eve,1,Entire home/apt,200,0,0.24,200
32674,Jinfei,3,Private room,50,92,2.41,142
32675,Adedeji,3,Private room,65,211,6.05,276
32676,Maggie,1,Private room,80,0,0.85,80
32677,Claudina,2,Private room,87,330,0.32,417
32678,Claudina,2,Private room,87,337,0.45,424
32679,Ted,2,Entire home/apt,149,150,3.01,299
32680,Molly,2,Entire home/apt,169,60,0.95,229
32682,Rebecca,2,Entire home/apt,305,101,5.19,406
32683,Samantha,2,Entire home/apt,525,21,0.49,546
32684,Jimmy,2,Private room,102,59,3.12,161
32685,Amy-JPSU,1,Entire home/apt,220,23,1.45,243
32686,Lilian,1,Entire home/apt,179,102,0.64,281
32687,Cal,2,Entire home/apt,190,0,0.08,190
32688,Ms. Edith,2,Private room,50,89,0.08,139
32689,Mohammed,2,Entire home/apt,140,220,4.96,360
32690,Kendall,1,Entire home/apt,220,0,0.23,220
32691,Christine,1,Private room,124,3,0.94,127
32692,Avital,2,Entire home/apt,114,0,0.2,114
32693,Ido,1,Entire home/apt,199,0,0.1,199
32694,Jean,2,Entire home/apt,135,44,1.12,179
32695,Kaila,1,Private room,55,125,1.35,180
32697,Alberto,1,Entire home/apt,131,224,0.84,355
32698,Gus,2,Entire home/apt,100,39,4.74,139
32699,Livia,1,Private room,95,0,0.31,95
32702,Cristina,1,Private room,80,317,0.93,397
32703,Alper,2,Private room,89,176,0.16,265
32704,Ania,5,Entire home/apt,97,131,1.54,228
32706,Crystal,1,Private room,45,119,1.36,164
32707,Nikki,2,Private room,45,2,2.02,47
32708,Brendan,2,Shared room,45,0,0.31,45
32709,Abeyu,2,Private room,75,7,0.75,82
32710,Catherine,2,Private room,100,0,2.75,100
32711,Roseanne,1,Entire home/apt,189,21,1.4,210
32712,Alexandra,1,Private room,70,0,0.32,70
32713,Allison,1,Private room,120,40,4.26,160
32715,Amy,2,Entire home/apt,375,8,0.08,383
32716,Alex,2,Private room,25,144,2.76,169
32717,Reggie,2,Entire home/apt,165,133,3.16,298
32718,Kazuya,1,Private room,56,244,0.37,300
32719,Kazuya,1,Private room,52,184,0.18,236
32720,Christian,1,Entire home/apt,275,0,0.09,275
32721,Blair,1,Entire home/apt,250,48,0.57,298
32722,Martin,3,Private room,89,282,0.93,371
32723,Martin,3,Private room,89,297,1.38,386
32724,Patnaree,2,Private room,49,221,3.37,270
32725,Lucia,2,Private room,60,0,0.54,60
32726,Livia,1,Entire home/apt,159,0,0.51,159
32727,Rob,1,Private room,120,0,0.08,120
32728,Rachel,2,Private room,88,51,5.37,139
32729,Micheal,1,Entire home/apt,186,219,3.8,405
32730,Jill,1,Entire home/apt,99,0,0.63,99
32731,Eddie,1,Private room,90,39,3.88,129
32732,Shahed,2,Private room,70,86,0.26,156
32733,Martita,2,Private room,40,325,9.47,365
32734,Zinnia,1,Entire home/apt,649,75,0.4,724
32735,Yelle,2,Private room,50,114,2.78,164
32736,Fallon,2,Private room,45,0,0.47,45
32737,Chiara,2,Private room,95,3,1.16,98
32738,Leo,1,Private room,149,264,1.08,413
32739,Lilia And Mateo,2,Entire home/apt,50,0,1.06,50
32740,Zipi,2,Entire home/apt,280,0,0.79,280
32741,Andrea,2,Private room,75,198,1.47,273
32742,S,3,Private room,65,44,0.78,109
32743,Stephanie,2,Entire home/apt,100,69,0.63,169
32744,Zahra,1,Private room,80,0,0.08,80
32745,Raphael,1,Private room,80,136,1.66,216
32746,Melissa,2,Private room,60,0,1.63,60
32747,Mackenzie,2,Entire home/apt,100,0,0.43,100
32749,Breanna,2,Entire home/apt,250,0,1.58,250
32750,Paris,2,Private room,75,0,4.12,75
32751,Ricardo,2,Entire home/apt,60,0,0.73,60
32752,J,2,Private room,49,0,5.83,49
32753,Mckinley,2,Entire home/apt,125,332,4.22,457
32754,Herick,2,Private room,50,27,0.27,77
32755,Tunde,1,Private room,50,0,0.08,50
32756,Kirstie,2,Entire home/apt,100,1,0.39,101
32757,Devon,1,Private room,43,310,0.58,353
32758,Mariah,2,Entire home/apt,200,345,0.87,545
32759,John,1,Private room,55,354,1.09,409
32760,John,1,Private room,54,359,0.58,413
32761,Chelsea,1,Private room,80,83,2.58,163
32762,Adonis,1,Private room,140,1,0.73,141
32763,Suzanne,1,Entire home/apt,250,48,3.53,298
32764,TaRi,3,Entire home/apt,250,1,0.44,251
32765,Alisa,1,Entire home/apt,499,0,2.5,499
32766,Kelly,2,Entire home/apt,140,26,3.19,166
32767,Brooke,2,Entire home/apt,175,0,0.45,175
32768,Forest,1,Private room,111,62,0.76,173
32769,Ricardo & Ashlie,1,Entire home/apt,160,46,0.48,206
32770,John,1,Private room,150,354,0.77,504
32771,Lillian,1,Shared room,60,331,1.06,391
32772,Yury,2,Private room,70,53,1.79,123
32773,Viviane,2,Private room,70,352,6.94,422
32774,Bryan,2,Private room,425,156,0.66,581
32775,Laura,1,Entire home/apt,230,0,0.47,230
32776,Jewell,2,Private room,50,330,0.62,380
32777,Katrina,1,Entire home/apt,200,10,3.0,210
32778,Yul,1,Entire home/apt,125,2,3.79,127
32779,John,1,Private room,60,326,0.49,386
32780,Oscar,2,Private room,40,8,4.14,48
32781,Bettina,4,Entire home/apt,107,8,3.63,115
32782,John,1,Private room,62,358,0.87,420
32783,Colin And Bryn,1,Entire home/apt,195,6,0.57,201
32784,Bettina,4,Entire home/apt,150,24,2.23,174
32785,Ms. Edith,2,Private room,50,179,0.29,229
32786,Norjia,1,Private room,85,80,0.79,165
32787,Mohammed,2,Entire home/apt,110,288,3.4,398
32788,Blueground,1,Entire home/apt,211,201,0.23,412
32789,John,1,Private room,100,238,0.29,338
32790,Claudia,1,Entire home/apt,125,0,0.17,125
32791,Andre,2,Private room,45,81,4.24,126
32792,Jhon,3,Private room,38,0,3.32,38
32794,Mike,1,Private room,83,0,0.28,83
32795,Jenny,1,Private room,100,0,0.08,100
32797,Digna,4,Private room,35,168,3.84,203
32799,Juan,3,Private room,26,118,0.16,144
32800,John,1,Private room,62,331,1.8,393
32801,Katie,2,Entire home/apt,170,308,0.93,478
32802,John,1,Private room,62,355,0.77,417
32803,Minying,3,Entire home/apt,60,155,2.64,215
32804,Miryung,3,Private room,51,3,1.78,54
32805,Maira,2,Private room,70,64,1.96,134
32806,Ramble,1,Entire home/apt,105,45,2.91,150
32807,Minying,3,Private room,60,335,1.13,395
32808,Amiee,1,Private room,100,92,3.86,192
32809,Amiee,1,Private room,122,91,5.5,213
32810,Rachel,2,Entire home/apt,10,4,1.06,14
32811,Aaron,1,Entire home/apt,299,91,5.82,390
32812,Johann,3,Private room,85,114,1.75,199
32813,Amiee,1,Private room,90,77,6.24,167
32814,Maggie,2,Entire home/apt,124,6,0.5,130
32815,Carlos,3,Private room,42,299,2.09,341
32816,Aurelio,2,Entire home/apt,180,0,0.29,180
32817,Johann,3,Private room,80,125,3.56,205
32818,Liz,1,Entire home/apt,175,0,0.23,175
32819,Johann,3,Private room,85,297,2.8,382
32820,Asaf,1,Private room,45,0,0.17,45
32821,Johan,1,Entire home/apt,160,0,1.94,160
32822,Aneta,2,Entire home/apt,59,0,0.4,59
32824,Demir,1,Shared room,69,208,1.84,277
32825,Demir,1,Shared room,69,212,1.3,281
32826,Christopher,1,Entire home/apt,180,89,1.52,269
32827,Erika,2,Entire home/apt,100,0,0.91,100
32828,Annette,2,Entire home/apt,125,24,0.32,149
32829,Sarah,2,Private room,50,0,1.76,50
32830,Lucky,2,Private room,75,90,1.03,165
32831,Gal,1,Private room,55,131,0.25,186
32832,Lori,1,Private room,65,2,0.16,67
32837,Kazuya,1,Private room,34,207,0.26,241
32838,Roxana,1,Entire home/apt,195,9,3.33,204
32839,Xiomara,1,Private room,70,101,2.67,171
32840,Ramon,3,Entire home/apt,105,222,0.7,327
32842,Deborah,1,Private room,60,288,3.86,348
32843,Yulia,1,Entire home/apt,120,0,0.64,120
32844,Taylor,1,Entire home/apt,250,0,0.24,250
32847,Johann,3,Entire home/apt,340,82,0.78,422
32848,Claudia,1,Entire home/apt,550,0,0.25,550
32849,Elena,1,Private room,88,90,1.38,178
32850,Mars,3,Private room,70,15,3.18,85
32851,Erin,1,Private room,65,5,4.17,70
32852,Margaret,1,Entire home/apt,125,9,0.34,134
32853,George,4,Entire home/apt,100,89,1.84,189
32854,Signe,1,Entire home/apt,110,0,0.37,110
32855,Nazma,3,Entire home/apt,125,166,1.78,291
32856,Oscar,2,Private room,40,9,3.96,49
32859,俞,1,Private room,72,0,0.38,72
32860,Jeremiah,2,Entire home/apt,195,0,0.4,195
32861,Torell,2,Shared room,45,306,1.18,351
32862,Stefan,2,Private room,45,0,0.12,45
32863,Robert,2,Entire home/apt,90,126,2.49,216
32864,Patricia,2,Private room,60,0,1.01,60
32865,Lilee,1,Private room,134,12,1.26,146
32866,Anne,1,Entire home/apt,250,11,0.21,261
32867,Amah Justin,3,Entire home/apt,75,62,2.06,137
32868,Keon,2,Private room,80,86,3.7,166
32869,Grace,2,Entire home/apt,300,292,2.56,592
32870,Emily,1,Private room,75,0,1.88,75
32871,Evelyn,1,Private room,150,0,0.31,150
32872,Kazuya,1,Private room,52,237,0.09,289
32874,Reisha,2,Entire home/apt,250,156,0.7,406
32875,Christopher,1,Private room,110,0,0.45,110
32876,Gabriel,2,Entire home/apt,250,0,0.08,250
32877,Nicole,3,Entire home/apt,325,3,0.51,328
32878,Charles,4,Private room,21,0,0.7,21
32879,Aliesha,1,Entire home/apt,150,3,1.13,153
32880,April,2,Entire home/apt,75,7,0.74,82
32881,Li,1,Private room,100,0,0.31,100
32882,Isaac And Eunice,3,Private room,37,331,2.63,368
32883,Daniel,3,Private room,50,0,0.08,50
32884,Anna,1,Entire home/apt,275,10,1.56,285
32885,Jessica,2,Entire home/apt,110,46,4.16,156
32886,Lily,4,Entire home/apt,115,114,3.12,229
32887,Kelley,2,Entire home/apt,160,95,0.09,255
32889,Sonder,1,Entire home/apt,184,347,0.26,531
32890,Sonder,1,Entire home/apt,189,338,0.09,527
32892,Jasmine,1,Private room,129,151,2.98,280
32893,Jasmine,1,Private room,119,156,2.75,275
32894,Jasmine,1,Private room,119,120,3.32,239
32895,Can,2,Private room,65,356,0.85,421
32896,Qingxue,1,Shared room,40,30,1.0,70
32897,Federico,2,Private room,45,44,2.07,89
32898,Jeremy,1,Entire home/apt,375,8,0.31,383
32900,Maria,1,Private room,65,98,2.29,163
32901,Mary,1,Private room,70,0,5.19,70
32902,Shen,1,Private room,190,14,1.53,204
32903,Zak,2,Private room,85,0,1.24,85
32904,Catherine,1,Entire home/apt,800,197,0.19,997
32905,Damira,2,Private room,80,0,0.71,80
32906,Juliana,1,Private room,65,311,0.14,376
32907,Martin,3,Private room,129,275,1.02,404
32909,Josh,1,Entire home/apt,180,0,0.31,180
32910,Prav,1,Private room,35,68,7.77,103
32911,Yvonne,2,Private room,60,312,0.82,372
32912,Yvonne,2,Private room,60,350,0.26,410
32913,Prav,1,Private room,39,17,6.46,56
32914,Jourdain,2,Private room,70,311,0.2,381
32917,Qi,1,Private room,80,0,0.85,80
32919,Panid,2,Entire home/apt,155,7,0.08,162
32921,Dale,1,Entire home/apt,135,0,0.5,135
32922,Beatriz,1,Private room,115,189,1.5,304
32923,Jeff,3,Private room,59,0,0.79,59
32924,Nick,1,Entire home/apt,169,59,0.39,228
32926,Ruth & C,1,Entire home/apt,195,0,3.71,195
32927,Raphael,1,Private room,85,145,2.48,230
32928,"R, J",2,Entire home/apt,109,20,5.77,129
32929,Raphael,1,Private room,109,0,2.82,109
32931,Karen,2,Private room,85,0,0.97,85
32932,Leomaris,1,Private room,45,88,0.85,133
32933,Nick,1,Private room,60,0,0.62,60
32934,Dafna Irit,1,Entire home/apt,115,21,0.09,136
32935,Adriano,1,Entire home/apt,100,48,1.39,148
32936,Jaquayala,2,Private room,50,0,0.14,50
32937,Inna,1,Entire home/apt,125,339,0.59,464
32938,Rose,1,Entire home/apt,850,45,0.88,895
32939,Genevieve,1,Private room,70,0,0.08,70
32940,Katy,1,Private room,100,0,0.17,100
32941,Maddie,1,Private room,55,0,0.08,55
32942,Marina,3,Entire home/apt,95,136,3.94,231
32943,Adrien,2,Entire home/apt,347,70,2.19,417
32944,Oscar,2,Private room,50,6,3.61,56
32945,Yado & Vane,2,Entire home/apt,190,251,2.07,441
32946,John,1,Entire home/apt,169,0,0.78,169
32948,A. Kaylee,1,Entire home/apt,299,314,0.97,613
32949,Megan,1,Entire home/apt,175,36,2.01,211
32950,Simon,1,Entire home/apt,220,0,0.24,220
32951,Lauren,1,Entire home/apt,120,0,2.22,120
32953,Michal,2,Entire home/apt,190,0,7.38,190
32954,Viviane,2,Private room,90,316,7.71,406
32955,Miguel,4,Entire home/apt,85,0,1.05,85
32956,Katherine,1,Entire home/apt,90,91,0.41,181
32960,Franklin,2,Private room,399,249,0.1,648
32962,Silva,1,Private room,98,54,5.65,152
32963,Ting Yi,2,Entire home/apt,140,240,2.76,380
32964,Brígida,1,Private room,50,134,3.42,184
32965,Jasmine,1,Entire home/apt,393,300,0.91,693
32966,Heather,2,Private room,62,64,5.38,126
32967,Jenn,2,Private room,112,0,0.39,112
32968,Zhenni,1,Entire home/apt,90,18,0.44,108
32970,Helen,2,Entire home/apt,350,129,1.06,479
32971,Heather,2,Private room,62,73,5.52,135
32972,Camille,4,Private room,45,365,0.31,410
32974,Deepika,1,Private room,125,80,1.26,205
32975,Rosalba,1,Private room,75,0,0.96,75
32976,Alex,1,Entire home/apt,333,110,0.1,443
32977,Christophe,4,Private room,65,0,0.19,65
32978,Adonis,1,Private room,250,365,0.08,615
32979,Eric,2,Entire home/apt,100,85,0.12,185
32980,Tammen,2,Entire home/apt,103,0,0.4,103
32981,Christopher,1,Entire home/apt,95,251,2.06,346
32982,Alexandra,1,Private room,75,0,0.55,75
32983,Carlota,1,Entire home/apt,220,43,0.98,263
32984,Wayne,2,Entire home/apt,100,133,4.47,233
32986,Steven,1,Entire home/apt,125,0,0.63,125
32988,Heather,2,Private room,39,0,0.09,39
32990,Laure-Ellyn,2,Private room,90,344,1.39,434
32991,Patricia,2,Private room,55,345,2.75,400
32992,Adam,1,Private room,99,192,4.08,291
32993,Tanya,2,Entire home/apt,200,2,1.42,202
32994,Laura,2,Private room,120,87,0.28,207
32995,Fabie,2,Private room,149,83,0.65,232
32996,Casey,1,Entire home/apt,200,0,1.0,200
32997,Katherine,2,Entire home/apt,190,9,0.93,199
32999,Jeremy,1,Entire home/apt,230,59,0.95,289
33000,Ava,2,Private room,50,72,0.41,122
33001,Sharlee,1,Private room,97,23,1.08,120
33002,Bill,2,Private room,76,44,4.57,120
33003,Viviane,2,Private room,60,342,4.65,402
33004,Jordyn,1,Entire home/apt,350,163,1.5,513
33006,Mark,2,Private room,60,0,2.79,60
33007,Jasmine,1,Private room,209,247,3.09,456
33008,Harold,1,Entire home/apt,125,291,1.84,416
33009,Norman,2,Entire home/apt,150,243,7.94,393
33010,Billy,1,Private room,125,293,5.34,418
33011,Carinne,1,Private room,90,0,0.62,90
33012,M,1,Private room,50,21,4.35,71
33014,Adonis,1,Private room,60,23,0.86,83
33015,Giorgi,1,Entire home/apt,300,0,0.2,300
33016,Norman,2,Entire home/apt,150,241,8.93,391
33018,Gerard,2,Entire home/apt,200,217,2.3,417
33019,Jam,2,Private room,60,344,0.45,404
33020,Linda Jo,2,Entire home/apt,183,115,1.89,298
33021,Karla,2,Private room,70,0,0.94,70
33022,Karla,2,Private room,60,2,1.31,62
33024,Daniel,1,Private room,100,9,0.48,109
33025,Ashley,2,Private room,70,20,3.41,90
33027,Rocio,1,Private room,59,0,0.43,59
33028,Béla,3,Private room,83,364,0.32,447
33029,Brysen,2,Private room,67,251,5.67,318
33031,Sarah,2,Entire home/apt,150,0,0.39,150
33032,David,2,Private room,41,155,0.11,196
33033,Violetta,1,Entire home/apt,550,61,3.18,611
33034,Rowan,2,Entire home/apt,99,0,0.26,99
33035,Alvaro,2,Private room,70,33,1.78,103
33036,P,1,Entire home/apt,350,207,0.43,557
33037,Emily,2,Entire home/apt,350,117,0.09,467
33038,Anna,3,Private room,37,157,0.64,194
33039,Fabio,3,Entire home/apt,140,122,2.23,262
33040,Brandon,1,Entire home/apt,349,188,0.26,537
33041,Roni,1,Private room,105,14,0.09,119
33042,Joe,3,Entire home/apt,75,363,0.11,438
33043,Levi,2,Private room,55,74,1.97,129
33045,Sarah,2,Entire home/apt,165,191,4.04,356
33046,Corey,2,Entire home/apt,250,0,0.49,250
33047,Levi,2,Private room,55,64,1.96,119
33048,Levi,2,Private room,59,32,1.86,91
33049,Jasmine,1,Private room,129,245,2.28,374
33050,Keithan,2,Private room,55,0,3.57,55
33051,Lenny,1,Private room,109,0,1.14,109
33052,Jade,2,Private room,75,95,0.52,170
33053,Kazuya,1,Private room,52,214,0.19,266
33054,Jenita,2,Entire home/apt,115,6,0.56,121
33057,Charlie,3,Private room,40,330,1.24,370
33058,Pierpaolo,4,Entire home/apt,100,11,0.08,111
33059,Luis,3,Private room,45,54,3.59,99
33060,Nicole,2,Entire home/apt,150,255,0.09,405
33061,Jeff,3,Private room,66,0,1.34,66
33062,Franklin,1,Entire home/apt,200,5,1.42,205
33063,Mohammed,2,Private room,35,264,0.55,299
33064,Kytzia,1,Private room,90,0,0.08,90
33065,Malika,2,Private room,75,170,1.93,245
33066,Jake,1,Private room,90,99,3.26,189
33067,Allan,2,Entire home/apt,139,12,0.7,151
33068,Molly,1,Private room,82,2,2.75,84
33069,Maki,1,Entire home/apt,85,16,0.21,101
33070,Estefania,2,Private room,106,58,1.73,164
33071,Emon,2,Entire home/apt,100,44,0.3,144
33072,Denada,5,Entire home/apt,106,87,0.86,193
33073,Daitao,2,Entire home/apt,130,0,0.18,130
33074,Emily,3,Entire home/apt,60,55,2.49,115
33075,Debbie & Hilel,2,Entire home/apt,200,321,2.8,521
33076,Michael,2,Entire home/apt,200,69,2.39,269
33077,Maria,2,Private room,100,145,1.0,245
33078,Bliss Beata,2,Entire home/apt,745,28,0.16,773
33079,Tupac,1,Private room,95,98,3.45,193
33080,Cristian,1,Entire home/apt,85,16,1.32,101
33081,Maria,2,Private room,230,114,0.24,344
33082,Janne,2,Entire home/apt,89,193,7.26,282
33083,Siddhartha,2,Entire home/apt,150,16,0.17,166
33085,Marina,2,Entire home/apt,85,110,4.62,195
33086,Lara,2,Private room,100,309,1.62,409
33087,Mimi,2,Entire home/apt,225,0,0.09,225
33088,Hannes & Will,2,Private room,75,17,1.12,92
33089,Brian,3,Entire home/apt,175,238,3.77,413
33091,John,1,Private room,65,356,0.53,421
33092,Lynn,1,Entire home/apt,100,26,0.09,126
33093,Patience,3,Entire home/apt,120,189,1.81,309
33094,Suzan,3,Private room,60,81,1.73,141
33095,Alisha,3,Entire home/apt,249,360,1.28,609
33096,Teddy,4,Entire home/apt,110,171,2.18,281
33097,Dakota,2,Entire home/apt,95,0,0.39,95
33098,Randaull,2,Entire home/apt,170,137,2.13,307
33099,Mariela,3,Entire home/apt,100,203,1.34,303
33100,Ewa,2,Private room,65,0,0.39,65
33102,Bryan,1,Private room,155,0,0.24,155
33103,Alex,1,Private room,90,6,2.26,96
33104,Paschal,2,Private room,50,0,0.08,50
33105,Malu,2,Entire home/apt,150,0,0.08,150
33107,Andrés,1,Entire home/apt,250,4,0.37,254
33108,Dipti,1,Entire home/apt,189,7,0.65,196
33109,Veronika,2,Entire home/apt,119,81,3.85,200
33110,Nyota,2,Entire home/apt,112,364,0.29,476
33111,Edgard,3,Private room,70,224,1.82,294
33112,Julia,2,Private room,41,0,1.17,41
33113,Pedro Y Martha,3,Private room,45,365,1.18,410
33114,Joshua,1,Entire home/apt,280,119,3.18,399
33116,Corporate Housing,1,Entire home/apt,175,241,0.38,416
33117,Corporate Housing,1,Entire home/apt,199,0,0.1,199
33118,John,1,Private room,64,365,0.55,429
33119,Asad,3,Entire home/apt,99,333,7.32,432
33120,Emily,2,Entire home/apt,168,0,0.39,168
33121,Anastasia,1,Entire home/apt,150,19,2.11,169
33122,Hupeto,2,Entire home/apt,163,309,1.59,472
33124,Deanna,3,Entire home/apt,156,0,0.16,156
33125,German And Wendy,4,Entire home/apt,85,247,5.37,332
33126,Damien,4,Private room,40,360,2.47,400
33127,Marisha,2,Private room,60,364,0.45,424
33128,Rees,4,Private room,60,365,0.85,425
33129,槟利,1,Private room,70,0,0.17,70
33130,Kat,2,Private room,130,48,0.57,178
33131,Andreas & Bella,1,Private room,80,26,3.56,106
33132,Chelcie,1,Entire home/apt,145,2,1.55,147
33133,Tevfik,3,Private room,73,0,0.09,73
33134,Lo,2,Private room,38,342,0.19,380
33136,Weimin,3,Private room,59,0,0.33,59
33138,Anthony,2,Private room,36,302,0.09,338
33142,Ronen,1,Private room,102,65,0.34,167
33143,Erica,3,Entire home/apt,230,310,0.33,540
33145,Georges,1,Entire home/apt,200,2,0.16,202
33146,Vivian,3,Private room,42,0,0.25,42
33147,Charlotte,2,Private room,70,0,0.16,70
33148,Angie,1,Entire home/apt,170,64,0.2,234
33149,John,5,Entire home/apt,99,172,4.25,271
33150,Alyssa,1,Entire home/apt,750,365,0.71,1115
33151,Anna,1,Entire home/apt,289,0,0.52,289
33152,Kristina,1,Entire home/apt,200,16,1.0,216
33153,Vasilisa,2,Entire home/apt,208,9,0.51,217
33154,Sarah,2,Entire home/apt,175,0,1.72,175
33155,Mik,2,Entire home/apt,225,50,0.38,275
33156,Yankel,2,Entire home/apt,300,347,2.13,647
33157,Akriti,2,Entire home/apt,130,174,2.02,304
33158,Ge,1,Entire home/apt,170,0,2.2,170
33160,Thomas,2,Private room,40,52,5.27,92
33161,Erika,1,Entire home/apt,131,0,2.82,131
33162,Kit,2,Private room,75,0,0.5,75
33163,Stephanie,1,Entire home/apt,425,1,0.2,426
33164,Elissa,2,Private room,100,161,0.29,261
33165,Chelsea,1,Entire home/apt,250,96,5.82,346
33166,Martita,2,Private room,40,174,11.68,214
33168,Andreas & Bella,1,Private room,85,2,4.34,87
33169,Olga,1,Entire home/apt,156,1,0.74,157
33170,Stephen Lionel,1,Private room,112,340,2.59,452
33171,Tina,1,Entire home/apt,139,0,0.09,139
33172,Joshua,1,Entire home/apt,169,150,3.56,319
33173,Mallary,2,Private room,75,0,0.32,75
33174,Dee,3,Private room,70,0,0.08,70
33175,Sheri,2,Entire home/apt,300,280,0.39,580
33176,Peter,2,Private room,75,189,0.08,264
33177,Tom,2,Entire home/apt,595,13,0.43,608
33178,Janice,1,Private room,90,0,0.48,90
33179,Ferheen,3,Entire home/apt,99,0,0.08,99
33180,Petula,2,Entire home/apt,120,52,1.23,172
33181,Corrie,2,Entire home/apt,185,0,1.12,185
33183,Charles,4,Private room,30,0,0.71,30
33184,Janice,1,Private room,74,0,0.16,74
33186,Caitie,1,Entire home/apt,131,0,0.23,131
33187,Patrick,2,Private room,40,0,0.27,40
33188,Elise,1,Entire home/apt,125,48,3.32,173
33189,Gabrielle,1,Private room,60,0,0.46,60
33190,Francesco,2,Entire home/apt,95,0,0.48,95
33191,Beto,1,Private room,155,103,0.8,258
33192,Leli,2,Private room,120,40,1.77,160
33193,Anthony,2,Entire home/apt,200,177,0.63,377
33195,Freddie,2,Private room,95,6,1.11,101
33196,Marina,2,Private room,38,175,1.38,213
33197,Sonder,1,Entire home/apt,187,335,0.79,522
33199,Mickey,3,Entire home/apt,50,349,4.59,399
33200,Eddie&Vlad,1,Entire home/apt,249,352,3.04,601
33201,Suah,3,Private room,60,34,1.52,94
33202,Alisha,3,Entire home/apt,215,360,0.16,575
33203,John,3,Entire home/apt,89,1,0.45,90
33204,Birim,1,Private room,90,7,4.07,97
33205,Thomas,2,Entire home/apt,165,21,1.17,186
33206,Monique And Colin,2,Entire home/apt,108,315,2.26,423
33207,Alejandro,2,Private room,55,0,0.92,55
33208,Mike,1,Entire home/apt,499,10,3.31,509
33210,Sergii,2,Shared room,35,364,0.09,399
33211,Chris,3,Private room,75,281,0.47,356
33212,Judah,1,Entire home/apt,99,7,0.86,106
33213,Steve,3,Entire home/apt,155,239,3.6,394
33214,Feng,3,Private room,50,0,1.34,50
33215,Marsha,2,Private room,75,146,0.2,221
33216,Alexis,5,Private room,50,363,1.81,413
33217,Monica,2,Entire home/apt,220,270,2.19,490
33218,Titi,2,Private room,90,36,3.06,126
33219,Natalya,2,Entire home/apt,75,3,0.91,78
33220,Julie,2,Private room,60,56,0.59,116
33221,Yann,1,Entire home/apt,295,0,0.27,295
33222,Kathleen,1,Private room,60,0,0.45,60
33223,Julie,3,Entire home/apt,100,0,0.57,100
33224,Anna,1,Shared room,75,329,1.15,404
33225,Maria,3,Entire home/apt,10,332,1.76,342
33226,Nuttamon,1,Private room,58,315,2.01,373
33227,Myrto,3,Entire home/apt,60,4,0.3,64
33229,Ali,1,Entire home/apt,369,365,0.22,734
33230,John,1,Private room,150,354,0.95,504
33231,Diana,2,Private room,63,225,2.26,288
33232,Lyric At 70 Pine,1,Entire home/apt,219,321,2.83,540
33233,Cesar,2,Entire home/apt,90,0,0.25,90
33234,Erika & Brett,2,Entire home/apt,171,81,1.51,252
33237,Lyric At 70 Pine,1,Entire home/apt,309,143,1.18,452
33238,Shayna,2,Private room,60,0,0.11,60
33240,Lyric At 70 Pine,1,Entire home/apt,650,315,0.76,965
33241,Jacob,1,Shared room,80,225,4.76,305
33242,Ana,3,Private room,50,328,1.09,378
33243,Fanny,3,Private room,30,363,0.11,393
33244,Elodie,2,Entire home/apt,90,30,0.5,120
33245,Andrea,1,Shared room,65,5,1.34,70
33247,Cindy,3,Entire home/apt,110,6,0.16,116
33248,Megan,2,Private room,95,38,0.17,133
33249,Ana,3,Private room,32,365,1.28,397
33250,William,4,Entire home/apt,142,312,2.5,454
33251,Lisa,1,Entire home/apt,150,0,2.25,150
33252,Alex,2,Private room,35,0,0.16,35
33253,Oni,3,Private room,55,263,1.85,318
33255,Lauren,2,Entire home/apt,140,0,0.25,140
33256,Alberto,1,Entire home/apt,175,230,0.51,405
33258,John,2,Private room,39,14,1.63,53
33259,Gennaro,2,Private room,80,285,4.49,365
33260,Abigail,1,Entire home/apt,65,0,0.98,65
33261,Taryn,5,Entire home/apt,75,59,1.69,134
33262,Olya,2,Private room,94,0,1.48,94
33263,Yosh,1,Private room,91,0,2.84,91
33264,Elsie,2,Private room,60,356,0.74,416
33265,Kate,2,Entire home/apt,260,0,0.08,260
33266,Marj,3,Shared room,73,90,0.21,163
33267,Susye,2,Entire home/apt,225,168,0.11,393
33268,Kazuya,3,Private room,34,251,0.18,285
33269,Nina,2,Private room,67,19,0.28,86
33270,Corey,1,Entire home/apt,170,0,0.17,170
33271,Putri,2,Entire home/apt,190,0,0.09,190
33274,Genny,5,Private room,50,365,1.53,415
33275,Petya,5,Entire home/apt,100,72,5.64,172
33276,Joy,3,Shared room,65,161,0.71,226
33277,Ash,1,Entire home/apt,220,0,0.26,220
33278,Anqi,1,Entire home/apt,250,0,0.09,250
33279,Alfredo,2,Entire home/apt,120,0,1.11,120
33280,Param,1,Private room,120,0,0.32,120
33281,Elizabeth,1,Private room,50,0,0.08,50
33282,Allison,1,Private room,120,9,1.29,129
33283,Debbie,2,Private room,66,87,1.03,153
33284,Vlad,1,Private room,80,0,4.76,80
33285,Alexis,5,Private room,80,29,0.34,109
33286,Vlad,1,Private room,80,110,3.89,190
33287,Kyle,2,Private room,45,0,0.08,45
33288,Vik,3,Entire home/apt,129,90,1.73,219
33290,Nick,1,Entire home/apt,200,0,0.94,200
33291,Sadie,2,Private room,55,225,2.82,280
33292,Lucy,2,Private room,40,256,0.26,296
33293,Genny,5,Private room,55,363,3.21,418
33294,Eva,1,Private room,150,0,0.24,150
33295,Lisa,2,Private room,75,242,1.44,317
33296,Sarah,2,Entire home/apt,75,87,3.73,162
33297,Muhammad,2,Private room,67,365,0.83,432
33298,Nicole,2,Entire home/apt,250,114,2.56,364
33299,Akem & Terry,2,Entire home/apt,125,282,1.88,407
33300,Jess,1,Private room,59,216,0.44,275
33301,Lucia,2,Entire home/apt,165,0,0.24,165
33302,Alexandra,2,Entire home/apt,195,0,0.95,195
33303,Joule,1,Private room,50,243,1.54,293
33304,Zoraida,4,Entire home/apt,79,10,3.33,89
33305,Lucia,2,Private room,98,0,0.17,98
33307,Sergii,2,Shared room,37,312,0.26,349
33308,Juan,1,Entire home/apt,295,2,2.17,297
33309,Gabriella,2,Private room,75,36,0.22,111
33310,Sara,1,Entire home/apt,265,5,0.49,270
33312,Laurence,2,Entire home/apt,449,329,2.82,778
33313,David,1,Entire home/apt,400,0,0.43,400
33314,Anne,2,Entire home/apt,195,30,5.32,225
33315,Christiana,2,Private room,59,107,3.59,166
33316,Konrad,3,Entire home/apt,100,0,0.34,100
33317,Shalisa,2,Entire home/apt,100,176,2.5,276
33318,Veronica,1,Private room,80,0,1.23,80
33319,Rex,1,Shared room,96,179,0.11,275
33320,Maria,3,Private room,45,266,2.8,311
33321,Noemi,4,Entire home/apt,125,155,1.89,280
33322,Emil,1,Private room,85,72,0.33,157
33323,Mich,1,Entire home/apt,250,180,2.26,430
33324,Elvis,5,Private room,40,337,1.0,377
33326,Rita,2,Private room,55,156,0.35,211
33327,Errol,2,Private room,150,174,1.4,324
33328,Anh & David,2,Entire home/apt,229,215,4.41,444
33329,Angelica,1,Private room,67,193,5.82,260
33330,Angelica,1,Private room,69,170,5.39,239
33331,Ada,2,Private room,51,352,1.14,403
33332,Patty,2,Entire home/apt,275,12,0.46,287
33334,Jack,1,Entire home/apt,200,0,0.76,200
33335,Tom,1,Private room,75,0,0.66,75
33336,Christopher,2,Entire home/apt,80,0,1.77,80
33337,Alex,1,Entire home/apt,350,124,2.87,474
33338,Bernarda,2,Entire home/apt,85,122,2.95,207
33339,Amber,2,Private room,46,0,0.25,46
33340,Mich,1,Entire home/apt,135,328,1.92,463
33341,Rachael,2,Entire home/apt,200,0,0.19,200
33342,Kim,2,Entire home/apt,125,24,0.18,149
33344,Likowsky,1,Private room,58,0,0.4,58
33345,Janie,2,Entire home/apt,150,0,0.09,150
33346,Owen,2,Entire home/apt,120,0,0.75,120
33347,Alberto,3,Private room,90,365,2.58,455
33348,Taylor,3,Private room,74,0,0.93,74
33349,Marine,2,Private room,99,153,1.61,252
33350,Rauf,2,Private room,53,294,3.69,347
33351,John,1,Private room,120,332,0.5,452
33352,Roger,2,Entire home/apt,250,49,0.53,299
33353,Lucy,3,Shared room,30,5,4.74,35
33354,Joey,2,Entire home/apt,209,0,0.24,209
33355,Lola,2,Entire home/apt,140,36,0.67,176
33356,John,1,Private room,99,362,0.73,461
33359,Tarry,1,Private room,80,0,4.63,80
33360,Stanley,1,Entire home/apt,200,352,0.64,552
33362,Sabine,3,Private room,50,13,4.69,63
33363,Taina,1,Private room,85,78,3.28,163
33364,Ernesto,2,Private room,50,0,1.63,50
33365,Daphna,2,Entire home/apt,84,0,1.33,84
33366,Brock,3,Private room,79,365,0.65,444
33367,Phil,1,Entire home/apt,79,3,2.67,82
33368,Jackson,2,Entire home/apt,130,0,1.32,130
33369,Ariane,1,Entire home/apt,350,292,0.09,642
33370,Sean,2,Entire home/apt,125,93,1.8,218
33371,Deborah,3,Entire home/apt,80,300,8.69,380
33372,Lamar,1,Entire home/apt,100,0,1.45,100
33373,Jake,2,Private room,70,9,0.88,79
33375,Julian,1,Private room,125,341,4.34,466
33376,Jonny,2,Shared room,100,82,2.81,182
33377,Courtney,1,Entire home/apt,450,360,0.86,810
33378,Zhaoyun,1,Entire home/apt,150,0,0.17,150
33379,Jason,2,Private room,89,73,5.28,162
33382,Dana,2,Entire home/apt,265,365,1.95,630
33383,Liza,1,Entire home/apt,225,0,0.29,225
33384,Karen,1,Private room,55,21,0.36,76
33385,John,1,Private room,120,288,0.26,408
33386,Michael,2,Entire home/apt,210,190,3.11,400
33387,Mary,1,Entire home/apt,599,0,0.24,599
33388,Jennifer,2,Private room,65,0,0.59,65
33389,Tk,2,Private room,115,0,0.49,115
33390,Michael,2,Private room,50,0,0.41,50
33391,Kathryn,1,Private room,70,4,2.53,74
33392,Jen,1,Entire home/apt,80,1,0.38,81
33393,Nuno,2,Private room,110,101,3.25,211
33394,Brett-Michael,2,Private room,115,0,0.17,115
33396,Melissa,2,Shared room,38,360,1.0,398
33397,Niccolo,2,Private room,150,0,0.08,150
33398,Maria Ivy,3,Entire home/apt,125,0,0.7,125
33399,Emma,1,Private room,125,0,0.52,125
33400,Jenya,1,Entire home/apt,180,1,0.93,181
33401,Jana,2,Private room,99,0,0.35,99
33402,Lillie & Donald,2,Entire home/apt,125,1,1.26,126
33403,Jelani,2,Private room,59,150,0.87,209
33404,Janine,1,Shared room,110,4,3.46,114
33405,Mark,2,Entire home/apt,300,174,0.81,474
33406,Samantha,2,Private room,50,0,0.33,50
33407,Lucia,1,Private room,99,11,0.43,110
33409,Jeff,3,Entire home/apt,150,10,1.5,160
33410,Myrna,2,Private room,36,81,0.71,117
33411,Byron,1,Private room,149,185,1.42,334
33412,Ada,2,Private room,51,310,0.84,361
33413,Floriana,2,Private room,70,0,0.89,70
33414,Ada,2,Private room,49,343,0.53,392
33415,Gina,2,Private room,85,0,0.66,85
33416,John,1,Private room,55,345,0.92,400
33417,John,1,Private room,65,326,1.15,391
33418,Alexandria,2,Private room,99,0,0.32,99
33419,Melissa,2,Shared room,38,365,1.39,403
33420,Gardell,2,Entire home/apt,44,89,0.77,133
33421,Paul,2,Entire home/apt,345,321,2.17,666
33422,Melissa,2,Shared room,38,365,1.14,403
33423,Laural,1,Entire home/apt,150,0,0.08,150
33424,Melissa,2,Shared room,38,365,1.77,403
33425,Ai,1,Entire home/apt,119,5,1.13,124
33426,Izi,3,Entire home/apt,71,77,2.73,148
33427,J,1,Entire home/apt,200,365,0.14,565
33428,Karen,2,Private room,35,319,0.57,354
33430,Quincy,1,Entire home/apt,1500,362,0.43,1862
33431,Giovanna,1,Private room,150,51,7.01,201
33432,Jelani,2,Private room,59,156,0.87,215
33433,Catherine,3,Private room,34,0,0.17,34
33434,Rikki,2,Entire home/apt,225,0,0.33,225
33435,Leli,2,Private room,80,41,1.76,121
33437,Leli,2,Private room,50,1,0.68,51
33438,Amardeep,5,Private room,30,359,2.14,389
33439,Simranjeet,5,Private room,30,334,1.3,364
33441,Simranjeet,5,Private room,30,337,0.99,367
33442,Abby,2,Shared room,40,301,1.07,341
33443,Robert,2,Entire home/apt,160,0,0.44,160
33444,Dana,2,Entire home/apt,100,3,0.42,103
33445,Joey,1,Entire home/apt,285,76,0.51,361
33446,Elene,2,Private room,53,143,2.46,196
33447,John,1,Private room,55,357,0.73,412
33448,Kevin4,3,Shared room,15,271,1.71,286
33449,Leivan,1,Private room,90,49,4.61,139
33450,Nish,2,Entire home/apt,90,0,0.74,90
33451,Brigit,2,Entire home/apt,90,120,2.8,210
33452,Melinda,1,Private room,125,141,1.82,266
33454,Summer,3,Entire home/apt,180,0,0.61,180
33455,Nat,1,Entire home/apt,120,0,0.22,120
33457,Rev. Simone,3,Private room,75,180,0.58,255
33459,Mehedhi,3,Entire home/apt,145,133,4.5,278
33463,Sonder,1,Entire home/apt,187,323,0.24,510
33464,Sonder,1,Entire home/apt,185,220,0.11,405
33467,Amanda,3,Entire home/apt,72,0,1.12,72
33468,Kazuya,3,Private room,39,186,0.3,225
33469,Cathy,3,Private room,55,177,2.21,232
33470,Ana,3,Private room,59,132,2.54,191
33471,Kazuya,3,Private room,33,269,0.18,302
33472,Dian,1,Private room,55,0,0.08,55
33474,Elizabeth,1,Private room,125,0,0.65,125
33475,Naheel,2,Entire home/apt,200,0,0.94,200
33476,Jonathan,1,Entire home/apt,400,0,0.18,400
33477,César Julio,1,Private room,80,187,0.09,267
33478,Jonathan,1,Entire home/apt,220,16,0.08,236
33479,Nïco,2,Entire home/apt,130,0,2.87,130
33480,Yooin,1,Entire home/apt,90,0,2.07,90
33481,Hiram,2,Shared room,47,365,1.03,412
33482,Vincent,2,Private room,118,288,2.46,406
33483,Stacey,2,Entire home/apt,145,0,0.66,145
33484,Mayur,1,Private room,85,33,1.98,118
33485,Marisha,2,Private room,75,364,0.36,439
33486,Oscar,4,Private room,80,0,4.79,80
33487,Priyanka,2,Private room,40,0,0.19,40
33488,Angela,2,Entire home/apt,110,44,4.36,154
33490,Al,3,Private room,60,0,0.5,60
33491,Tami,2,Private room,50,84,3.68,134
33492,Lee,2,Private room,58,17,0.09,75
33493,Brittany,2,Entire home/apt,150,168,1.58,318
33494,Angel,1,Private room,49,0,0.97,49
33495,Umut&Deniz,1,Private room,69,270,0.6,339
33496,Ben,1,Private room,99,147,2.51,246
33497,Gary,2,Entire home/apt,200,267,2.28,467
33499,Barak,1,Entire home/apt,200,0,0.25,200
33500,Regina,2,Entire home/apt,125,0,0.16,125
33501,Lionel,2,Private room,70,1,2.74,71
33502,Rebecca,2,Private room,45,0,2.05,45
33503,Mercedes,2,Private room,70,0,0.17,70
33504,Hamad,3,Entire home/apt,75,63,10.86,138
33506,Christina,1,Entire home/apt,150,4,0.48,154
33507,Victoria,2,Private room,55,340,3.35,395
33508,Santiago,1,Private room,90,0,0.57,90
33509,Daniel,1,Private room,139,81,2.88,220
33510,Despina,1,Entire home/apt,120,0,0.58,120
33511,Jacqueline,3,Entire home/apt,65,293,4.06,358
33512,Eeman,2,Entire home/apt,83,97,2.91,180
33513,Jeremy,3,Entire home/apt,149,140,3.34,289
33514,Brian,2,Private room,175,90,1.1,265
33515,Carol Gloria,4,Private room,70,360,0.47,430
33516,Paul,3,Private room,49,356,0.87,405
33517,Talia,2,Entire home/apt,150,55,0.17,205
33518,Andrea,1,Entire home/apt,180,233,1.99,413
33519,Carol Gloria,4,Private room,80,365,1.48,445
33520,Lotte,1,Entire home/apt,220,25,0.28,245
33521,Alex,2,Private room,30,13,0.35,43
33522,Andrea,1,Entire home/apt,150,261,1.9,411
33523,Michelle,1,Entire home/apt,225,1,1.3,226
33524,William,1,Entire home/apt,210,0,0.63,210
33525,Sydney,1,Private room,299,365,0.35,664
33526,Alwyn,2,Entire home/apt,110,46,1.6,156
33527,Maria,2,Private room,120,291,0.45,411
33528,David,2,Private room,80,0,0.09,80
33529,Lou,2,Entire home/apt,330,147,2.83,477
33530,Walter,2,Entire home/apt,150,11,0.36,161
33531,Brian,1,Private room,150,0,0.17,150
33532,Laura-Lee,1,Entire home/apt,99,1,2.9,100
33533,Justin,1,Private room,99,0,0.16,99
33535,Holly,2,Entire home/apt,90,76,0.08,166
33537,Bei,3,Private room,65,38,2.36,103
33538,Bei,3,Private room,65,0,1.76,65
33539,Anna,1,Entire home/apt,300,11,0.1,311
33540,Waen,2,Private room,70,0,4.15,70
33543,Eileen,1,Entire home/apt,125,342,0.09,467
33544,Kai,1,Entire home/apt,150,0,0.52,150
33545,Jeff,3,Private room,50,0,0.34,50
33546,Gursharan,1,Entire home/apt,120,0,0.08,120
33547,Cecilia,1,Entire home/apt,125,0,0.09,125
33549,Marvin,1,Entire home/apt,250,228,1.94,478
33550,William,4,Private room,142,48,2.47,190
33552,Taylor,2,Shared room,60,342,0.17,402
33553,William,4,Private room,142,57,3.5,199
33554,Bob,1,Entire home/apt,179,12,2.92,191
33555,Andre,3,Entire home/apt,140,70,2.96,210
33556,Debbie,1,Entire home/apt,465,142,2.66,607
33557,Julia,2,Entire home/apt,80,0,2.02,80
33558,Charles,2,Entire home/apt,65,0,0.54,65
33559,Millie,1,Private room,300,0,0.25,300
33561,Jared,2,Entire home/apt,180,0,1.13,180
33562,Anuar,2,Private room,56,57,2.33,113
33563,Edwin,4,Entire home/apt,99,337,6.07,436
33564,Leanne,2,Private room,70,220,0.09,290
33565,Christina,3,Entire home/apt,285,172,2.54,457
33566,Jeffrey & Casandra,3,Private room,82,172,8.0,254
33567,William,4,Private room,142,48,2.56,190
33568,Dena,2,Entire home/apt,100,57,0.69,157
33569,William,4,Private room,142,57,2.56,199
33570,Peggy,2,Entire home/apt,125,0,0.54,125
33571,Will,1,Entire home/apt,900,0,0.18,900
33572,Nonie,3,Private room,40,24,1.6,64
33573,George,1,Entire home/apt,120,0,1.32,120
33574,Leigh,1,Entire home/apt,199,0,0.8,199
33575,Luqman,2,Private room,60,129,0.59,189
33576,Rose,1,Entire home/apt,200,129,3.62,329
33577,Luis,2,Private room,55,0,2.34,55
33578,Rachael,2,Entire home/apt,150,88,0.62,238
33579,Tamiris,2,Private room,110,66,1.5,176
33580,Romulo,1,Private room,53,0,0.26,53
33581,Missy & Julien,2,Entire home/apt,150,62,2.54,212
33582,Emma,1,Private room,35,0,0.09,35
33583,Ailin,4,Entire home/apt,149,0,0.09,149
33584,Dening,1,Entire home/apt,190,0,0.25,190
33585,David,1,Private room,143,0,0.34,143
33586,Chris & Grace,2,Private room,57,348,3.43,405
33587,Vady,1,Private room,59,126,5.38,185
33588,Zoë,1,Entire home/apt,299,0,0.99,299
33589,Syeda,3,Private room,70,339,4.25,409
33590,Siri,3,Private room,49,89,0.5,138
33591,Theodoros,3,Private room,68,53,0.89,121
33592,Hiten,2,Entire home/apt,120,4,1.86,124
33593,Ezequiel,2,Entire home/apt,135,13,0.45,148
33594,Lucie,1,Private room,80,0,0.19,80
33595,Barbara,2,Private room,80,55,0.41,135
33597,Jaime,1,Private room,90,70,0.55,160
33598,Sushmita,1,Entire home/apt,150,0,0.08,150
33599,Elizabeth,3,Entire home/apt,197,232,2.11,429
33600,Jennifer,1,Private room,181,0,0.12,181
33601,Ari,2,Entire home/apt,180,0,0.25,180
33603,Joe,1,Private room,76,19,6.59,95
33604,Kevin Unal,1,Entire home/apt,139,96,4.89,235
33605,Ana,3,Private room,51,151,1.86,202
33606,Selin,2,Private room,50,0,0.25,50
33607,Maggie,2,Private room,55,0,0.16,55
33608,Barbara,1,Entire home/apt,250,0,1.62,250
33609,Christian,2,Private room,55,36,0.17,91
33610,Sean,2,Private room,80,294,2.09,374
33611,Ana,3,Private room,51,167,2.97,218
33612,Myles,1,Private room,69,4,2.36,73
33613,Rose,1,Entire home/apt,255,0,0.33,255
33614,Barbara,1,Private room,150,364,0.26,514
33615,Figo,1,Private room,85,180,0.62,265
33617,Joe,1,Private room,52,11,5.42,63
33618,Joey,2,Entire home/apt,70,0,0.08,70
33619,Joe,1,Private room,76,16,6.28,92
33621,Kelly,1,Private room,63,16,7.92,79
33622,Nina,5,Entire home/apt,100,312,0.43,412
33623,Borna,1,Private room,55,0,0.09,55
33624,El,1,Private room,90,353,0.6,443
33625,Talia,1,Entire home/apt,110,0,0.33,110
33628,Rachel,1,Private room,66,0,0.49,66
33630,Ankeen,2,Entire home/apt,65,0,0.08,65
33631,Elik,2,Entire home/apt,133,307,0.52,440
33632,Danny,3,Entire home/apt,100,0,1.33,100
33633,Bryan,1,Private room,30,0,0.09,30
33635,Janli,2,Private room,85,0,2.39,85
33636,Marco,2,Entire home/apt,125,48,1.53,173
33638,Matthew,1,Entire home/apt,100,0,0.26,100
33639,Sarah & Bruce,2,Entire home/apt,125,0,0.94,125
33640,Jasmine,1,Entire home/apt,91,47,0.41,138
33641,Esteem,4,Private room,26,311,1.24,337
33642,Candi,2,Private room,66,0,0.36,66
33643,Ally,4,Private room,60,35,1.09,95
33644,Jeff,1,Private room,150,20,2.64,170
33645,Daniella,1,Entire home/apt,222,0,0.26,222
33646,Tyrone,2,Entire home/apt,148,102,3.28,250
33647,Ildiko,1,Entire home/apt,225,330,0.42,555
33649,Anna,3,Private room,60,0,0.28,60
33650,Oscar,2,Private room,45,20,4.37,65
33651,Cesar,4,Entire home/apt,102,349,4.19,451
33652,John,1,Private room,50,358,0.99,408
33654,Fifi,1,Entire home/apt,250,0,0.31,250
33655,Zephyr,2,Private room,44,4,0.25,48
33656,Dara,1,Entire home/apt,130,0,0.59,130
33657,Tal,2,Private room,55,0,0.51,55
33658,Fernando,2,Entire home/apt,78,6,0.09,84
33659,Richard,3,Entire home/apt,165,242,1.15,407
33661,Jessica,1,Entire home/apt,90,6,0.64,96
33663,Eric,1,Entire home/apt,500,114,3.24,614
33664,Alex,2,Private room,75,70,9.17,145
33665,Mary,3,Private room,44,314,0.68,358
33666,Arnaud,2,Private room,75,0,0.19,75
33667,Jack,1,Private room,120,354,4.96,474
33668,Jack,1,Private room,120,351,4.76,471
33669,Jack,1,Private room,110,358,4.06,468
33670,Molly,2,Private room,125,45,0.1,170
33671,Fei,2,Shared room,25,50,2.25,75
33672,Sien,1,Private room,89,160,1.07,249
33673,Stella,1,Private room,81,61,2.29,142
33674,Anna,3,Private room,60,0,0.09,60
33675,Yann,1,Entire home/apt,95,0,0.18,95
33676,John,1,Private room,75,348,0.29,423
33677,John,1,Private room,80,329,0.66,409
33678,Tony,3,Entire home/apt,159,58,1.83,217
33679,Carolina,3,Private room,80,346,0.93,426
33680,Alex,2,Entire home/apt,165,0,0.19,165
33682,Sue,2,Private room,69,30,5.79,99
33683,Laura,1,Entire home/apt,140,101,3.27,241
33685,Stacy,2,Private room,50,0,0.35,50
33686,Elizabeth,2,Entire home/apt,135,15,0.97,150
33687,Irma,1,Entire home/apt,120,6,2.06,126
33688,Kazuya,3,Private room,39,0,0.23,39
33689,Emily,3,Private room,69,16,1.92,85
33690,Iris,2,Private room,65,361,2.71,426
33691,James,2,Private room,25,0,0.34,25
33692,Katia,2,Entire home/apt,120,9,1.09,129
33693,Ezgin,1,Entire home/apt,128,136,3.06,264
33694,Erica,1,Entire home/apt,125,4,0.82,129
33695,Carles,2,Private room,65,48,4.76,113
33696,Lou,2,Entire home/apt,172,133,3.07,305
33697,Dejuan,2,Entire home/apt,150,84,0.68,234
33698,Kent,3,Private room,195,160,0.35,355
33699,Jeremy,2,Private room,60,54,3.27,114
33700,Lou,2,Entire home/apt,330,174,0.12,504
33701,Margaux,1,Entire home/apt,195,3,0.16,198
33702,Cheolwoo,3,Entire home/apt,60,40,1.42,100
33704,Galina,1,Private room,110,89,0.79,199
33705,Richard,1,Entire home/apt,154,113,0.3,267
33706,Marina,2,Entire home/apt,76,323,2.22,399
33707,Aida,1,Private room,70,0,0.18,70
33708,Stacie,2,Entire home/apt,220,0,0.52,220
33709,Freddy,3,Private room,55,136,4.98,191
33712,Irina,1,Entire home/apt,99,2,0.35,101
33713,Daniel,2,Entire home/apt,95,0,3.32,95
33714,Vincent,2,Private room,118,285,1.9,403
33715,Danielle,1,Private room,80,13,4.92,93
33716,Kyle,3,Entire home/apt,60,15,3.46,75
33717,George,2,Private room,20,1,0.73,21
33718,Sandee,2,Private room,70,0,1.16,70
33719,Anchor,2,Shared room,33,85,2.78,118
33720,Anchor,2,Shared room,30,85,2.66,115
33721,Jessica,2,Private room,98,73,2.1,171
33722,William And Julian,2,Private room,70,334,2.3,404
33723,Eddie,3,Entire home/apt,110,332,1.02,442
33724,Tiffany,2,Private room,55,0,0.58,55
33725,Melissa,2,Shared room,40,332,0.93,372
33726,Diana,1,Entire home/apt,189,312,1.51,501
33727,Melissa,2,Shared room,36,365,1.53,401
33728,Nadine,2,Private room,65,348,3.04,413
33729,Josh,2,Private room,49,73,4.43,122
33730,Andrew,2,Private room,52,13,5.26,65
33731,Christof,2,Entire home/apt,97,62,5.66,159
33732,HyeSuk & Alex,2,Private room,80,154,0.78,234
33733,Diana,1,Entire home/apt,189,365,0.25,554
33734,Melissa,2,Shared room,35,346,1.34,381
33735,Melissa,2,Shared room,36,361,1.24,397
33736,Hilary,2,Entire home/apt,150,52,1.57,202
33737,Tabea,2,Entire home/apt,100,0,0.16,100
33738,Ollie,2,Private room,60,217,0.27,277
33739,Freehand,1,Private room,179,331,3.11,510
33741,Lauren,1,Entire home/apt,200,67,2.14,267
33742,Vincent,2,Private room,123,251,2.72,374
33743,Andrea,2,Entire home/apt,80,0,0.19,80
33744,Roberto,2,Entire home/apt,90,107,2.75,197
33745,Jimmy,3,Private room,40,351,8.64,391
33746,Cyril,1,Entire home/apt,490,179,1.48,669
33747,Michal,2,Entire home/apt,70,0,0.19,70
33748,Jessica,2,Entire home/apt,188,19,0.59,207
33749,Sue,2,Private room,69,15,6.2,84
33750,Juan,2,Entire home/apt,289,60,3.06,349
33751,Pablo,2,Private room,130,86,0.68,216
33752,Rachel,2,Private room,75,0,0.37,75
33753,Mary,3,Shared room,79,0,0.09,79
33754,Vincent,1,Private room,100,351,1.13,451
33756,Sadat,3,Entire home/apt,150,121,3.84,271
33757,Anchor,2,Shared room,21,78,2.92,99
33758,Polina,2,Entire home/apt,68,0,0.37,68
33759,Michael,2,Private room,135,5,0.99,140
33760,Mathew,1,Entire home/apt,145,43,2.43,188
33761,Charlie,3,Private room,45,50,0.81,95
33762,Yvonne,2,Private room,50,250,0.25,300
33763,Vicky,3,Private room,60,46,2.34,106
33764,Vicky,3,Private room,49,46,2.12,95
33765,Vicky,3,Private room,40,15,4.32,55
33766,William,2,Private room,62,26,5.35,88
33767,Jennifer,1,Entire home/apt,345,37,1.01,382
33768,Syeda,3,Private room,80,309,2.4,389
33769,Rebecca,2,Entire home/apt,90,2,4.47,92
33770,Syeda,3,Private room,60,336,2.23,396
33771,Henry,4,Entire home/apt,150,191,0.53,341
33772,Creighton,2,Private room,68,139,1.4,207
33773,Rohan,1,Private room,150,0,0.38,150
33774,Alex,2,Entire home/apt,120,230,0.43,350
33775,Bhavin,1,Private room,70,90,0.09,160
33777,The Bowery House,1,Private room,109,0,0.17,109
33778,Jasmine,3,Entire home/apt,74,41,0.25,115
33779,Carmen,1,Private room,125,118,2.23,243
33780,The Bowery House,1,Private room,109,0,0.2,109
33781,Filippo,2,Entire home/apt,120,13,0.19,133
33782,Nadine,2,Private room,65,328,1.42,393
33783,Kevin,2,Private room,47,106,1.63,153
33784,Ilya,1,Private room,120,78,3.22,198
33785,David,1,Private room,110,187,6.48,297
33786,David,1,Private room,110,251,4.84,361
33787,David,1,Private room,115,194,5.25,309
33788,David,1,Private room,105,241,5.98,346
33789,Yeena,1,Entire home/apt,119,0,0.57,119
33790,Ral,4,Entire home/apt,42,32,2.74,74
33791,Francesca,2,Private room,65,5,0.87,70
33792,David,2,Private room,54,13,1.81,67
33793,Teddy,1,Entire home/apt,325,0,0.76,325
33794,David,2,Entire home/apt,265,0,0.42,265
33795,Rachel,2,Private room,95,85,1.61,180
33796,Christopher,1,Entire home/apt,199,0,0.82,199
33797,Fleur,2,Entire home/apt,125,59,0.42,184
33798,David,1,Entire home/apt,174,5,2.12,179
33799,Nhia,3,Private room,50,348,3.96,398
33800,Meredith,2,Entire home/apt,140,7,0.59,147
33801,HyeSuk & Alex,2,Private room,95,244,0.92,339
33802,David,2,Entire home/apt,120,3,0.83,123
33803,青明,2,Private room,39,224,0.53,263
33804,Thom & Moses,2,Private room,75,71,4.18,146
33805,青明,2,Private room,65,186,0.85,251
33806,青明,2,Private room,58,232,0.92,290
33807,Pavel,2,Entire home/apt,100,6,1.42,106
33808,Florencia,2,Private room,73,249,0.12,322
33809,青明,2,Private room,65,262,1.02,327
33810,青明,2,Private room,57,222,1.35,279
33811,Célestine,2,Private room,60,0,0.43,60
33812,Iris,2,Private room,65,362,2.51,427
33813,Diana,2,Private room,100,109,0.33,209
33815,Bryant,2,Private room,65,365,2.7,430
33816,Bryant,2,Private room,70,347,2.38,417
33817,Daniella,1,Private room,130,32,1.58,162
33818,HyeSuk & Alex,2,Private room,60,318,0.75,378
33819,Courtney,1,Entire home/apt,102,293,1.21,395
33820,Tiffanie,3,Entire home/apt,100,0,0.6,100
33821,HyeSuk & Alex,2,Private room,170,167,0.44,337
33822,Fransheska,2,Private room,65,365,2.86,430
33823,Genesiss,2,Private room,30,0,1.5,30
33824,Fransheska,2,Private room,60,0,2.08,60
33825,Fransheska,2,Private room,65,365,3.06,430
33826,"Roo, Nadine And Neil",2,Private room,90,320,2.37,410
33827,"Roo, Nadine And Neil",2,Private room,65,354,1.54,419
33828,John,1,Private room,50,238,1.3,288
33830,Elizabeth And Timothee,2,Entire home/apt,142,219,1.04,361
33831,Katya,2,Entire home/apt,80,0,0.32,80
33832,Reda,1,Private room,92,125,0.69,217
33833,Yelle,2,Private room,70,11,0.5,81
33834,Cydney,2,Entire home/apt,275,0,1.83,275
33835,Jennifer,1,Entire home/apt,157,0,0.91,157
33837,Viktoriya,2,Shared room,100,85,0.78,185
33838,The Bowery House,1,Private room,94,0,0.28,94
33839,Tim,1,Private room,88,227,1.63,315
33840,Daniel,1,Private room,56,0,0.65,56
33841,Cagkan,3,Private room,55,37,3.75,92
33844,Olivia,1,Entire home/apt,150,23,0.46,173
33845,Nick,1,Private room,244,5,3.35,249
33846,Rory,1,Entire home/apt,180,4,0.17,184
33849,Tara,4,Entire home/apt,62,42,2.79,104
33851,MIchele,2,Entire home/apt,145,69,0.26,214
33853,Owen,1,Entire home/apt,225,5,1.07,230
33854,Eliran,1,Entire home/apt,69,0,1.94,69
33855,Elena,1,Entire home/apt,96,40,4.37,136
33856,Giorgi,2,Private room,37,36,0.44,73
33857,Hiroki,3,Private room,33,39,0.15,72
33858,Irina,1,Entire home/apt,120,346,0.33,466
33859,Gail And Yordanis,2,Entire home/apt,180,0,0.71,180
33860,Malik,1,Private room,52,0,0.85,52
33861,Danielle,3,Private room,108,333,1.74,441
33862,Chemme,1,Private room,140,365,0.42,505
33863,Jessica,3,Entire home/apt,75,125,2.97,200
33864,Geheng,3,Private room,48,56,6.2,104
33865,Tatjana,1,Shared room,150,142,2.0,292
33866,Lily2R,3,Entire home/apt,60,144,2.0,204
33867,Andre,2,Entire home/apt,110,267,2.21,377
33868,Kelvin,2,Entire home/apt,70,13,5.65,83
33869,Chloe,2,Private room,100,131,2.27,231
33870,Nick,2,Entire home/apt,200,4,0.43,204
33872,Joseph,1,Entire home/apt,125,262,5.55,387
33873,Annie,1,Entire home/apt,140,0,0.19,140
33875,Jeremy & Laura,1,Entire home/apt,140,311,0.26,451
33876,Kristina,2,Entire home/apt,200,141,3.58,341
33877,소정,2,Private room,40,0,0.09,40
33878,Ben,2,Private room,44,1,0.52,45
33879,Leila,2,Entire home/apt,115,0,0.09,115
33880,Charles,2,Entire home/apt,120,99,2.59,219
33881,Lou,2,Entire home/apt,460,113,2.75,573
33882,Mayda,2,Private room,40,0,2.92,40
33883,George,1,Private room,90,283,1.82,373
33884,James,2,Entire home/apt,150,127,0.28,277
33885,Monica,1,Entire home/apt,260,141,4.62,401
33887,Leni,1,Entire home/apt,350,0,0.17,350
33888,Angie,2,Private room,65,365,1.89,430
33889,Natiya,2,Entire home/apt,63,0,0.86,63
33890,Coco,1,Entire home/apt,129,12,4.78,141
33891,Lev,2,Entire home/apt,75,169,4.02,244
33892,Willi,3,Entire home/apt,100,31,3.0,131
33894,Ramona,1,Private room,111,0,4.17,111
33895,Hoover,2,Entire home/apt,80,43,2.14,123
33896,Kathy,3,Private room,80,317,0.29,397
33897,Geheng,3,Private room,59,72,4.31,131
33898,Daniel,2,Entire home/apt,159,258,3.14,417
33899,Geheng,3,Private room,55,81,3.58,136
33900,Mayda,2,Private room,65,0,3.1,65
33901,Angie,2,Private room,65,365,2.05,430
33902,Daniele,2,Private room,85,55,2.2,140
33903,Cagla,2,Private room,70,0,0.1,70
33904,Anwar,2,Private room,40,0,0.25,40
33905,Ney,2,Entire home/apt,300,61,1.56,361
33906,Emily Wes,2,Private room,75,318,1.83,393
33907,Emily Wes,2,Private room,68,365,1.26,433
33908,Sydney,1,Private room,60,310,1.35,370
33909,Christina,1,Private room,90,0,0.09,90
33910,Dolphy,2,Entire home/apt,110,327,2.51,437
33911,Marko,3,Private room,80,330,1.74,410
33912,Tatiana,2,Private room,190,0,0.36,190
33913,Audrey,2,Private room,66,0,0.33,66
33914,Cecille,3,Private room,60,148,0.29,208
33915,Donavan,2,Entire home/apt,125,55,2.17,180
33916,Kirsten,3,Entire home/apt,65,7,1.88,72
33917,Angie,2,Private room,55,365,2.03,420
33918,Danielisa,4,Private room,38,188,0.52,226
33919,Hoover,2,Entire home/apt,80,60,1.93,140
33920,Alan,2,Private room,200,22,1.24,222
33921,Jennifer,1,Entire home/apt,200,0,0.26,200
33923,Michael,2,Entire home/apt,89,18,4.38,107
33924,Jessie,1,Private room,82,0,0.68,82
33925,Conrad,2,Private room,115,322,4.21,437
33926,Conrad,2,Private room,100,363,3.65,463
33929,Sebastian,2,Entire home/apt,100,55,0.52,155
33930,David,1,Entire home/apt,300,4,0.87,304
33931,Joica,2,Private room,119,180,2.22,299
33932,Petter,1,Entire home/apt,150,0,0.2,150
33933,Geheng,3,Private room,55,88,5.2,143
33934,Kierra,1,Entire home/apt,150,0,0.37,150
33935,Rohan,1,Private room,149,65,2.03,214
33936,Edgar,2,Entire home/apt,79,174,1.27,253
33937,Nina & Keith,2,Entire home/apt,150,57,2.58,207
33938,Paul,3,Private room,49,345,1.33,394
33939,Reyna,2,Entire home/apt,175,84,4.91,259
33940,Sonya,2,Private room,40,0,0.42,40
33941,Brian,3,Entire home/apt,280,104,3.53,384
33942,Kazuya,1,Private room,33,189,0.46,222
33943,Jae,1,Private room,100,36,12.05,136
33944,Quinn,2,Private room,31,0,0.85,31
33945,Jacob,1,Shared room,75,225,2.79,300
33946,Aaron & Ivy,2,Private room,109,365,3.72,474
33947,Aaron & Ivy,2,Private room,109,361,3.14,470
33948,Ivy And Andrew,2,Private room,95,365,3.15,460
33949,Ivy And Andrew,2,Private room,95,365,2.97,460
33950,David,1,Entire home/apt,300,0,0.94,300
33951,E Vera,1,Private room,90,104,2.09,194
33952,Tim,5,Entire home/apt,130,96,4.6,226
33953,Nazli,2,Entire home/apt,125,33,0.28,158
33954,Ben,2,Entire home/apt,125,0,0.17,125
33956,Griffin,2,Private room,35,0,0.18,35
33957,Isabel,4,Private room,45,205,3.66,250
33958,Idris,2,Entire home/apt,250,17,0.71,267
33959,Mina,1,Entire home/apt,300,168,3.11,468
33960,Drew,2,Entire home/apt,135,0,0.36,135
33961,Julie,2,Entire home/apt,108,0,1.67,108
33962,John,1,Private room,45,347,0.32,392
33963,Libby,2,Private room,50,0,1.01,50
33964,2018Serenity,1,Private room,50,32,0.39,82
33965,Rodrigo,1,Private room,80,0,1.7,80
33966,John,1,Private room,45,336,0.49,381
33967,Charlie,1,Private room,150,66,2.59,216
33968,Mary Angelica,2,Entire home/apt,115,19,0.19,134
33969,Camile,3,Private room,40,0,0.61,40
33970,Mala,3,Private room,75,65,1.77,140
33971,Georgina,3,Entire home/apt,80,209,4.15,289
33973,Dami,1,Entire home/apt,125,1,1.02,126
33974,Hiroki,3,Private room,39,32,0.29,71
33975,Shogo,3,Private room,40,0,0.29,40
33976,Haifeng,3,Private room,60,51,2.04,111
33977,Akinwole,3,Entire home/apt,100,171,2.86,271
33978,K,1,Entire home/apt,110,1,0.28,111
33979,Adam,2,Entire home/apt,350,0,0.53,350
33980,Bonnie,1,Private room,65,188,0.38,253
33981,Linda,2,Private room,40,0,2.29,40
33982,Petr,2,Private room,74,44,2.6,118
33983,Diana Carolina,3,Private room,40,236,2.86,276
33984,Monica,2,Entire home/apt,70,0,0.93,70
33985,Amanda,1,Private room,113,1,5.13,114
33986,Tolga,1,Private room,74,280,1.34,354
33987,Matt,1,Entire home/apt,125,12,3.11,137
33988,Septina,2,Private room,75,337,0.19,412
33989,Kalina,2,Entire home/apt,99,146,2.49,245
33990,Septina,2,Private room,79,338,0.19,417
33991,Jennifer,1,Entire home/apt,190,79,0.79,269
33993,Davis,1,Private room,67,37,6.19,104
33994,Russell,2,Private room,82,64,2.17,146
33995,Teres,2,Private room,45,30,3.01,75
33996,Frank,1,Entire home/apt,146,158,3.31,304
33998,Sergii,2,Shared room,38,365,0.11,403
33999,Luis,1,Private room,150,316,3.54,466
34001,Blake And Madia,2,Private room,95,361,2.08,456
34002,Blake And Madia,2,Private room,82,365,2.14,447
34003,Julian And Michael,2,Private room,67,348,2.8,415
34004,Julian And Michael,2,Private room,67,359,2.88,426
34005,J.D.,1,Entire home/apt,250,14,1.01,264
34006,Dima,1,Entire home/apt,250,88,0.09,338
34007,Soledad,3,Private room,70,0,1.89,70
34008,Mike & Glenna,2,Entire home/apt,85,19,2.41,104
34009,Michelle,1,Entire home/apt,150,0,1.36,150
34011,Imogene,1,Entire home/apt,104,34,1.53,138
34012,Olga,1,Private room,75,0,0.4,75
34013,Marcia,2,Private room,60,0,0.09,60
34014,Carlos,1,Entire home/apt,250,20,3.01,270
34016,Allison,2,Private room,50,0,1.22,50
34017,Mayan,2,Entire home/apt,185,304,0.32,489
34019,Mark,3,Entire home/apt,285,0,0.78,285
34020,Chris,1,Private room,125,79,4.81,204
34022,Tatiana,2,Private room,45,0,1.13,45
34023,Mat,1,Entire home/apt,250,205,0.1,455
34024,Adam,1,Entire home/apt,425,13,0.44,438
34025,Shanley,3,Private room,50,0,0.43,50
34026,Rashidi,3,Private room,46,5,1.02,51
34028,Isai Jesse,1,Private room,58,10,1.69,68
34029,Nick,2,Private room,86,75,1.02,161
34030,Greg,2,Entire home/apt,111,12,0.58,123
34031,Helen,1,Entire home/apt,207,0,0.26,207
34032,Giulia,2,Private room,47,88,0.26,135
34033,Natalie,4,Entire home/apt,140,27,0.27,167
34034,Masashi,2,Private room,90,38,0.51,128
34035,Vancila,3,Private room,40,361,1.34,401
34036,Dov,2,Entire home/apt,750,364,1.2,1114
34037,Manuel,2,Private room,80,0,0.53,80
34038,Edwin,3,Entire home/apt,100,0,0.18,100
34039,Troy,1,Private room,180,16,0.48,196
34040,Jacob,1,Shared room,75,225,4.21,300
34042,Outpost,2,Private room,95,311,0.09,406
34043,Miss,2,Private room,46,19,1.01,65
34044,Outpost,2,Private room,96,333,0.1,429
34045,Donnihe Jhans,3,Private room,44,126,1.73,170
34046,James,2,Entire home/apt,100,0,3.22,100
34047,Mark,3,Entire home/apt,139,282,0.58,421
34048,Blueground,1,Entire home/apt,280,218,0.36,498
34049,Kreshnik,3,Entire home/apt,125,0,0.09,125
34050,Michael,2,Private room,80,365,2.71,445
34052,Michael,2,Private room,70,362,3.14,432
34053,Cherri,2,Private room,95,365,3.5,460
34054,Jess,2,Entire home/apt,130,17,0.09,147
34055,Cherri,2,Private room,110,335,4.14,445
34056,Michael,1,Private room,54,35,0.7,89
34057,Kat,2,Entire home/apt,100,0,0.77,100
34058,Robert,2,Private room,45,32,0.61,77
34059,Robert,3,Entire home/apt,99,16,0.69,115
34060,Stefania,2,Entire home/apt,145,0,0.26,145
34061,Ollie,2,Private room,60,221,0.45,281
34063,Jessica,2,Entire home/apt,119,0,0.18,119
34064,Nicola,3,Private room,70,365,3.61,435
34065,Kathryn,2,Entire home/apt,350,0,0.81,350
34066,Laura,2,Private room,225,5,0.16,230
34067,Emanuel & Orion,2,Private room,95,342,2.19,437
34068,Emanuel & Orion,2,Private room,95,335,1.28,430
34069,Anchor,2,Shared room,30,83,2.74,113
34070,Anchor,2,Shared room,30,84,3.99,114
34071,Michelle & Lily,3,Entire home/apt,165,122,3.31,287
34072,Victor,1,Private room,62,310,5.86,372
34073,Dave,2,Entire home/apt,149,145,2.11,294
34074,Luis,4,Entire home/apt,80,280,3.79,360
34077,Septina,2,Shared room,79,90,0.19,169
34078,Septina,2,Private room,80,82,0.26,162
34079,Hongzhi,1,Private room,72,0,1.19,72
34080,Jacob,1,Shared room,75,225,3.26,300
34081,Jacob,1,Shared room,75,225,2.47,300
34082,Jacob,1,Shared room,75,221,3.32,296
34083,Dionyssios,1,Entire home/apt,140,176,3.3,316
34085,Max,1,Shared room,35,322,0.15,357
34086,Nicole,1,Entire home/apt,71,1,0.67,72
34087,Cansu,2,Private room,50,0,0.12,50
34090,Chris,2,Entire home/apt,200,0,0.31,200
34091,Drea,1,Entire home/apt,199,255,2.96,454
34092,Steve,4,Private room,75,29,0.55,104
34093,Phillip,1,Entire home/apt,150,159,2.59,309
34094,Bassam,2,Entire home/apt,145,139,3.63,284
34096,Richie,1,Entire home/apt,100,67,0.28,167
34098,Charles,1,Entire home/apt,140,11,0.97,151
34099,Israel,2,Private room,65,75,3.73,140
34100,Nina,2,Private room,67,24,1.33,91
34101,Nina,2,Private room,67,23,0.43,90
34102,Sofiya,2,Private room,65,0,0.65,65
34104,Thomas,1,Private room,150,27,2.09,177
34106,Hongzhi,1,Private room,87,0,1.19,87
34107,Jeff,1,Entire home/apt,200,21,0.55,221
34108,Ashley,2,Entire home/apt,250,266,1.3,516
34109,Hongzhi,1,Private room,79,1,4.16,80
34110,Pierre,2,Private room,100,0,0.69,100
34111,Melissa,2,Entire home/apt,135,246,2.44,381
34112,Teola,2,Entire home/apt,98,223,4.15,321
34114,Mat,1,Entire home/apt,350,365,0.19,715
34115,Ronald,1,Private room,90,0,0.81,90
34116,Josh,1,Shared room,40,341,1.82,381
34117,Luxury Lofts,1,Entire home/apt,1250,125,2.26,1375
34118,Shell,2,Entire home/apt,999,365,0.22,1364
34120,Michael,2,Private room,65,302,1.21,367
34121,Jerry,1,Entire home/apt,99,95,2.28,194
34122,Christina,1,Entire home/apt,150,0,0.54,150
34123,Nicki,2,Entire home/apt,250,0,0.18,250
34124,Jessica,2,Entire home/apt,179,130,2.99,309
34126,Maria,1,Shared room,115,72,3.72,187
34127,Helen,2,Entire home/apt,158,0,0.69,158
34128,Brendan,1,Private room,200,0,0.47,200
34129,Stephany,2,Private room,49,0,8.64,49
34132,Judd,2,Entire home/apt,200,11,0.34,211
34135,Alexo & JC,3,Entire home/apt,180,363,0.21,543
34136,Spencer,2,Private room,80,0,0.19,80
34137,Son,1,Private room,59,3,0.43,62
34138,Christian,2,Entire home/apt,180,106,1.45,286
34139,Shreyasi,1,Private room,189,0,0.09,189
34140,Tile,2,Entire home/apt,95,0,0.54,95
34141,Shreyasi,1,Private room,199,0,0.09,199
34142,Paloma,1,Private room,100,1,2.8,101
34143,Robert,1,Private room,200,90,0.09,290
34144,Casey,1,Entire home/apt,275,0,0.26,275
34146,Matt,2,Private room,62,356,1.8,418
34147,Anna & Ben,1,Private room,93,11,1.08,104
34148,Matt,2,Private room,62,324,3.13,386
34149,Camry,1,Shared room,60,0,1.48,60
34150,Matt,2,Private room,55,353,1.7,408
34151,Scott,2,Private room,50,21,2.26,71
34152,Pj,2,Private room,35,1,1.88,36
34153,Raquel,5,Private room,22,261,1.77,283
34154,Eddie,1,Private room,70,4,1.07,74
34155,Eddie,1,Entire home/apt,350,135,0.88,485
34157,Marie-Claude,2,Entire home/apt,189,14,0.32,203
34158,Cynthia,4,Entire home/apt,95,311,0.66,406
34160,Stefan & Marianne,2,Entire home/apt,230,0,0.3,230
34161,David,5,Entire home/apt,249,351,0.8,600
34162,Beau,1,Private room,75,68,0.55,143
34163,Jesse,1,Private room,80,193,3.04,273
34164,Conrad,1,Entire home/apt,250,0,1.33,250
34165,Jimmy,1,Entire home/apt,450,48,0.31,498
34166,Kamali,1,Entire home/apt,130,0,0.78,130
34167,Seneca,1,Entire home/apt,151,27,0.73,178
34168,Roland,3,Private room,90,86,1.11,176
34169,Ardinia,2,Private room,290,364,0.75,654
34170,Yvonne,2,Private room,60,152,0.84,212
34171,Bryan,1,Private room,115,204,1.31,319
34172,Benjamin,1,Entire home/apt,200,0,0.46,200
34173,Tori,1,Entire home/apt,250,0,0.39,250
34174,Israel,2,Private room,44,77,2.7,121
34175,Sheryl,1,Private room,160,0,1.48,160
34176,Lena,1,Entire home/apt,329,252,1.53,581
34177,Annika,1,Entire home/apt,135,5,2.78,140
34178,Anna,2,Private room,70,0,0.4,70
34179,T.,1,Entire home/apt,275,275,4.05,550
34180,Anna,1,Private room,37,0,0.17,37
34181,Jeanne,2,Entire home/apt,175,198,0.46,373
34182,Danny,1,Private room,100,174,2.87,274
34183,Dominique,2,Private room,55,79,0.53,134
34184,Renee,1,Entire home/apt,86,0,1.08,86
34185,Mary,1,Entire home/apt,200,0,1.24,200
34186,Ivon,3,Private room,59,331,0.76,390
34187,Cezar,1,Entire home/apt,85,16,0.15,101
34189,Hiroki,3,Private room,45,1,0.51,46
34190,Max,2,Entire home/apt,315,113,3.84,428
34191,Kristiina,2,Shared room,47,0,0.93,47
34192,Thomas,2,Entire home/apt,149,11,0.18,160
34193,Paloma,1,Entire home/apt,100,5,1.39,105
34194,Ester,3,Entire home/apt,250,363,0.09,613
34195,Daisy,2,Private room,65,283,3.82,348
34196,Claudia,1,Private room,50,0,0.42,50
34197,Sarah,2,Private room,65,287,0.19,352
34198,Jp,1,Entire home/apt,106,8,0.25,114
34199,Giana,2,Private room,59,178,3.19,237
34200,Austin,1,Entire home/apt,195,2,1.83,197
34201,Vince,2,Entire home/apt,150,145,3.62,295
34202,John,2,Private room,65,27,5.34,92
34203,Weihao,1,Entire home/apt,700,134,1.63,834
34204,Derrick,1,Entire home/apt,275,29,2.87,304
34205,Ashley,1,Entire home/apt,137,40,2.19,177
34206,Sarah,2,Private room,55,287,0.19,342
34207,Selika,2,Private room,70,287,0.1,357
34208,Caroline,2,Entire home/apt,165,29,3.72,194
34209,Figo,4,Private room,47,332,0.82,379
34210,Justin,2,Private room,35,0,0.27,35
34211,Melissa,3,Entire home/apt,85,0,3.72,85
34212,Katie,2,Private room,46,0,0.47,46
34213,Lucas,2,Entire home/apt,130,194,0.51,324
34214,Aleksandar,1,Entire home/apt,185,292,1.26,477
34215,Laura,2,Entire home/apt,100,0,0.46,100
34216,Darryl,1,Private room,52,167,1.34,219
34217,Anthony,2,Private room,150,29,3.23,179
34218,Kurtis,2,Entire home/apt,88,0,0.81,88
34219,Joseph,1,Shared room,39,31,4.0,70
34220,Syeda,3,Shared room,40,343,1.88,383
34221,Michael,1,Entire home/apt,155,84,4.78,239
34224,Joseph & Joséphine,1,Private room,90,11,0.18,101
34225,Sarah,2,Private room,54,286,0.28,340
34226,Sarah,2,Private room,40,260,0.37,300
34227,Yva,2,Entire home/apt,85,322,3.26,407
34229,Zak,2,Entire home/apt,132,0,0.55,132
34230,Rachael,1,Private room,80,0,1.71,80
34234,Reuben,2,Private room,140,334,3.69,474
34237,Raghav,2,Private room,120,0,0.63,120
34238,Michael,1,Entire home/apt,165,2,1.04,167
34239,Brigid,2,Private room,50,0,0.18,50
34240,Patrola,1,Private room,49,180,2.41,229
34241,Michael,1,Private room,165,93,3.0,258
34242,Praise,2,Entire home/apt,192,0,0.17,192
34243,Judy,2,Entire home/apt,150,0,2.34,150
34244,Terry,2,Entire home/apt,1200,0,0.09,1200
34245,Adonis,1,Private room,415,0,0.23,415
34246,Laura,2,Private room,75,123,0.91,198
34247,Paige,2,Private room,60,2,0.48,62
34248,Kristopher,1,Entire home/apt,100,0,1.42,100
34249,Unai,2,Entire home/apt,329,0,0.16,329
34250,Gina,2,Private room,39,309,2.29,348
34251,Meng,1,Entire home/apt,89,2,4.82,91
34252,Olivia,2,Entire home/apt,150,29,2.39,179
34253,John,1,Entire home/apt,139,0,0.27,139
34254,Jaimi,1,Entire home/apt,230,77,1.0,307
34255,J,2,Private room,75,0,0.09,75
34256,Lilia & Gaby,2,Entire home/apt,135,7,4.11,142
34257,Eddie,1,Entire home/apt,185,314,2.06,499
34258,Brenton,1,Entire home/apt,128,30,0.96,158
34259,Amit,2,Entire home/apt,110,32,0.2,142
34260,Siyu,1,Private room,80,0,0.17,80
34261,Barry,1,Entire home/apt,175,5,0.57,180
34262,Raphaël,2,Entire home/apt,160,28,0.55,188
34263,Nina,1,Entire home/apt,250,135,1.72,385
34264,Leni,1,Entire home/apt,225,0,1.54,225
34265,Aramis,3,Private room,45,0,1.67,45
34267,Paul,5,Private room,120,350,0.31,470
34268,Ariel,2,Private room,50,80,2.5,130
34269,Eddy,1,Private room,60,110,5.67,170
34270,Blake And Madia,2,Private room,70,359,2.43,429
34271,Blake And Madia,2,Private room,80,361,2.71,441
34272,Alex,1,Entire home/apt,200,155,2.06,355
34273,Marisa,3,Entire home/apt,120,152,2.09,272
34275,Tatiana,3,Entire home/apt,200,0,0.09,200
34276,Sarah,1,Entire home/apt,175,215,0.27,390
34277,John,1,Private room,75,0,1.25,75
34278,Daniel,1,Entire home/apt,149,0,0.45,149
34279,O,2,Private room,150,179,0.09,329
34280,Mansura,2,Entire home/apt,110,13,2.96,123
34281,Lauren,2,Entire home/apt,150,0,0.11,150
34282,Itay,1,Entire home/apt,147,11,0.86,158
34283,David,2,Entire home/apt,150,0,0.48,150
34284,Catherine,2,Private room,138,269,0.14,407
34285,Vincent,2,Private room,135,249,1.21,384
34286,Sergiy,2,Shared room,100,363,0.09,463
34287,Douglas,4,Private room,90,0,0.09,90
34288,Dee,2,Entire home/apt,500,53,0.13,553
34289,Maria,5,Private room,115,115,3.8,230
34290,Dee,2,Entire home/apt,300,53,0.12,353
34291,Eibhlin,2,Private room,43,140,0.43,183
34292,Youmie,1,Private room,75,357,1.74,432
34293,Meg,2,Private room,52,0,1.19,52
34294,Danny,2,Private room,85,58,2.58,143
34295,Jian,2,Private room,50,108,2.26,158
34302,Michele,2,Private room,80,282,0.61,362
34307,Natasha,2,Private room,75,146,2.47,221
34308,John,1,Private room,120,338,0.41,458
34309,Mary And Ryan,2,Private room,70,345,1.9,415
34311,Billy,1,Entire home/apt,195,257,4.08,452
34312,Dustin,1,Entire home/apt,89,15,4.21,104
34313,Annie,2,Private room,65,334,2.04,399
34314,Kaedin,1,Private room,45,1,0.1,46
34315,Patricia,3,Private room,53,252,0.61,305
34316,Sophie,3,Entire home/apt,125,315,4.18,440
34317,Masha,1,Entire home/apt,140,0,0.55,140
34319,Annie,2,Private room,65,347,2.52,412
34320,Yerddy,4,Entire home/apt,75,188,0.69,263
34321,Vanessa,1,Private room,80,364,0.11,444
34322,Annie,2,Private room,65,350,1.65,415
34323,Annie,2,Private room,55,359,1.6,414
34324,Christina,1,Entire home/apt,110,8,3.73,118
34325,J,1,Entire home/apt,120,2,1.41,122
34326,Dawn,2,Private room,130,26,1.07,156
34327,Jennifer,1,Private room,120,171,0.31,291
34328,Alain,2,Entire home/apt,162,314,3.34,476
34329,Vanessa,1,Private room,80,357,1.04,437
34330,Farah,5,Private room,135,293,6.13,428
34331,Evelyn,2,Entire home/apt,85,306,4.68,391
34332,Red Awning,1,Entire home/apt,699,204,1.21,903
34333,Red Awning,1,Entire home/apt,699,204,0.5,903
34334,Red Awning,1,Entire home/apt,699,204,0.3,903
34335,Red Awning,1,Entire home/apt,699,204,0.82,903
34336,Red Awning,1,Entire home/apt,699,204,0.48,903
34337,Red Awning,1,Entire home/apt,699,164,0.46,863
34338,Red Awning,1,Entire home/apt,699,204,1.18,903
34339,Red Awning,1,Entire home/apt,699,204,2.45,903
34340,Red Awning,1,Entire home/apt,699,206,0.74,905
34341,Red Awning,1,Entire home/apt,737,216,0.42,953
34342,Red Awning,1,Entire home/apt,737,200,0.21,937
34343,Red Awning,1,Entire home/apt,737,188,1.02,925
34344,Red Awning,1,Entire home/apt,737,222,0.21,959
34346,Red Awning,1,Entire home/apt,737,249,0.36,986
34347,Red Awning,1,Entire home/apt,737,235,0.4,972
34348,Red Awning,1,Entire home/apt,737,230,1.17,967
34349,Red Awning,1,Entire home/apt,699,190,1.09,889
34350,Red Awning,1,Entire home/apt,699,176,1.27,875
34351,Red Awning,1,Entire home/apt,699,196,0.33,895
34352,Red Awning,1,Entire home/apt,737,153,0.44,890
34353,Red Awning,1,Entire home/apt,737,224,0.71,961
34354,Kais,3,Private room,52,353,3.38,405
34355,Anthony Michel,2,Private room,46,301,1.13,347
34356,Mary And Ryan,2,Private room,76,330,2.54,406
34357,Jolene And Ryan,2,Private room,86,365,2.61,451
34358,Kais,3,Private room,85,349,3.66,434
34359,Anne,1,Entire home/apt,200,0,0.27,200
34360,Petera,2,Private room,60,360,2.22,420
34361,Kathy,1,Private room,50,34,0.3,84
34362,Kais,3,Private room,52,355,2.83,407
34363,Diana,3,Private room,65,79,2.34,144
34364,Kay,2,Entire home/apt,89,180,1.48,269
34368,Loreta,3,Entire home/apt,120,40,0.27,160
34370,Nadira,2,Private room,40,0,1.9,40
34371,John,1,Private room,55,351,0.71,406
34372,Antoine,1,Private room,95,5,0.26,100
34373,Jeremy,2,Entire home/apt,250,260,2.37,510
34374,Oh,2,Private room,55,5,1.61,60
34375,Jolene And Ryan,2,Private room,86,365,2.18,451
34376,Jolene And Ryan,2,Private room,86,342,1.53,428
34377,Mondell,2,Entire home/apt,250,314,1.94,564
34378,Caitlin,1,Private room,50,57,0.81,107
34379,Fernando,2,Entire home/apt,245,128,0.79,373
34380,Ellie,1,Entire home/apt,125,35,3.37,160
34381,Juan,4,Entire home/apt,132,103,3.91,235
34382,Shana,1,Entire home/apt,112,24,0.37,136
34383,Michael,2,Private room,65,0,0.44,65
34384,Shamyra,3,Private room,53,0,0.36,53
34387,Lilian,1,Private room,81,110,0.97,191
34389,Daniel,2,Private room,55,0,0.29,55
34391,Tina,2,Entire home/apt,175,54,0.63,229
34392,David,1,Private room,110,232,6.22,342
34393,David,1,Private room,110,267,5.71,377
34394,David,1,Private room,115,230,7.34,345
34396,David,1,Private room,105,241,6.99,346
34398,Diana And Peter,2,Private room,60,349,2.29,409
34399,Nina,2,Private room,87,310,2.0,397
34402,Diana And Peter,2,Private room,65,362,1.95,427
34403,Claire,1,Entire home/apt,120,0,1.24,120
34405,Nina,3,Private room,45,314,0.14,359
34406,Nina,3,Private room,45,347,0.71,392
34407,Nina,3,Private room,45,163,0.14,208
34408,Nina,3,Private room,45,321,0.54,366
34409,Nina,3,Private room,45,331,0.77,376
34411,Sandra,3,Private room,80,342,0.36,422
34412,Clara,1,Private room,85,0,0.53,85
34413,Sam,1,Entire home/apt,118,10,1.86,128
34414,Patrick,1,Private room,50,0,0.46,50
34415,Samet,1,Private room,99,0,1.66,99
34416,James,2,Entire home/apt,204,225,2.96,429
34417,Paola,1,Entire home/apt,220,45,2.52,265
34419,Salem,2,Private room,81,48,0.66,129
34420,Valentina,4,Private room,60,269,0.17,329
34421,Salem,2,Private room,50,351,2.17,401
34422,Maxime C/Armande C,1,Private room,90,0,3.36,90
34423,Robert,2,Private room,45,32,0.75,77
34429,Kent,3,Private room,195,59,0.09,254
34430,Cynthia,3,Entire home/apt,170,0,0.09,170
34431,Richard,1,Entire home/apt,140,104,0.31,244
34432,Juliana,2,Entire home/apt,125,0,1.94,125
34433,Carly,1,Private room,85,30,0.7,115
34434,Jun Jun,3,Private room,73,317,2.43,390
34437,Thomas,2,Entire home/apt,135,100,3.82,235
34438,Tracy,2,Private room,60,308,1.65,368
34439,Jenny,1,Entire home/apt,199,232,0.1,431
34440,Liqin,3,Private room,80,365,2.87,445
34441,Yaw,2,Private room,50,198,7.7,248
34442,Esther,1,Private room,55,0,0.18,55
34443,Dadrine,2,Private room,80,365,0.16,445
34444,Liqin,3,Private room,95,353,2.66,448
34445,Ivin,1,Entire home/apt,120,180,2.43,300
34448,Christine,1,Private room,40,105,2.33,145
34449,Rony,2,Private room,50,0,0.18,50
34450,Kazuya,3,Private room,40,216,0.45,256
34451,Robert,2,Entire home/apt,99,173,7.18,272
34452,Angela,2,Private room,65,37,2.89,102
34453,Mary,1,Entire home/apt,195,0,0.53,195
34454,A-B,1,Entire home/apt,150,86,1.0,236
34455,Chelsea,1,Private room,120,5,0.56,125
34456,Cynthia,3,Entire home/apt,170,0,0.44,170
34457,Ada,3,Private room,80,175,0.3,255
34458,Rawn,4,Private room,35,179,0.77,214
34459,Gabriela,2,Entire home/apt,130,305,1.24,435
34460,Clara,3,Private room,30,153,1.46,183
34461,Pilar,2,Private room,53,13,3.79,66
34462,Max,1,Entire home/apt,350,242,2.48,592
34463,Steven,2,Private room,50,180,0.5,230
34465,Ala,2,Private room,30,0,0.27,30
34466,Keilyn,2,Private room,56,158,2.97,214
34467,Margaret,1,Private room,98,209,1.86,307
34470,Jehan,4,Entire home/apt,75,169,3.13,244
34471,Leslie,2,Entire home/apt,130,2,3.27,132
34472,Joachim,1,Private room,98,29,1.49,127
34473,Haley,1,Entire home/apt,180,2,2.04,182
34475,Johnny,2,Entire home/apt,250,0,0.38,250
34476,Larry,2,Private room,75,29,2.45,104
34477,Ben,1,Entire home/apt,300,119,5.2,419
34478,Russell,2,Entire home/apt,180,69,2.77,249
34479,Howard,1,Entire home/apt,199,248,1.65,447
34480,Robianddebbie,2,Private room,65,287,1.42,352
34481,Robianddebbie,2,Private room,45,313,2.11,358
34482,Joan,1,Private room,90,29,3.42,119
34483,Andrew,2,Entire home/apt,150,0,1.09,150
34484,Max,3,Private room,55,364,3.31,419
34485,Denisse,3,Private room,51,87,2.45,138
34486,Brian,2,Private room,45,0,0.18,45
34489,Max,3,Private room,60,363,3.52,423
34491,James,2,Entire home/apt,375,0,0.25,375
34493,Patty,2,Private room,125,8,0.39,133
34494,Patty,2,Entire home/apt,250,0,0.32,250
34495,Isidro,1,Private room,40,0,0.64,40
34496,Alexander,5,Private room,89,65,0.12,154
34497,Maria,1,Private room,80,9,2.09,89
34498,Arielle,2,Entire home/apt,600,328,2.2,928
34499,Shamira,4,Private room,75,210,1.26,285
34500,Elen,2,Entire home/apt,110,223,5.06,333
34501,Mauro,2,Entire home/apt,150,144,2.18,294
34502,Henry,2,Private room,90,9,1.62,99
34508,Sonder,1,Entire home/apt,239,254,0.37,493
34510,Sonder,1,Entire home/apt,232,311,0.29,543
34512,Juline,1,Entire home/apt,175,49,0.74,224
34513,Idalia,3,Private room,60,315,3.76,375
34515,Jeff,1,Entire home/apt,200,6,1.09,206
34516,Erica,3,Entire home/apt,200,311,0.62,511
34517,Raymond,2,Entire home/apt,650,168,1.0,818
34519,Chadanut,2,Private room,40,28,1.69,68
34520,Lily,2,Entire home/apt,123,128,2.57,251
34521,Sam,1,Private room,150,67,4.17,217
34522,Yana,2,Private room,47,0,0.18,47
34523,Abraham,2,Private room,31,62,0.1,93
34524,Charles,3,Private room,54,0,0.2,54
34534,Brian,2,Entire home/apt,100,2,1.08,102
34536,Suanny,2,Private room,130,90,1.08,220
34538,Nicole,1,Private room,99,0,0.61,99
34540,Homemattie,3,Entire home/apt,150,162,0.55,312
34548,Peter,2,Private room,50,179,1.36,229
34549,Olvin,2,Private room,59,0,2.85,59
34550,Vanessa,1,Private room,180,365,0.91,545
34551,Lily,2,Entire home/apt,113,96,2.22,209
34552,Liqin,3,Private room,80,189,2.69,269
34553,Rwaida,3,Private room,45,249,0.37,294
34554,Sarah,1,Private room,100,0,0.28,100
34555,WeWork,1,Entire home/apt,525,203,2.53,728
34557,Erin,3,Entire home/apt,105,93,0.22,198
34558,Jorge,1,Entire home/apt,250,188,0.97,438
34559,Arika,5,Entire home/apt,67,45,3.45,112
34560,Brooke,1,Private room,100,0,0.36,100
34562,Brooke,1,Entire home/apt,226,0,0.09,226
34563,Gayle,1,Entire home/apt,175,0,0.09,175
34564,Michael,1,Entire home/apt,550,353,0.09,903
34565,Cazzie,2,Entire home/apt,120,0,0.77,120
34566,Chao,2,Entire home/apt,126,35,2.88,161
34567,Aysu,2,Private room,61,349,1.0,410
34568,Samet,1,Private room,99,0,1.59,99
34569,Sean,1,Entire home/apt,200,206,4.48,406
34570,Gil,2,Private room,54,0,0.75,54
34571,Maxime C/Armande C,1,Private room,90,178,3.4,268
34572,Jasna,2,Entire home/apt,155,6,1.16,161
34575,Sara,3,Entire home/apt,150,3,0.32,153
34576,Dave,1,Private room,85,90,0.79,175
34577,Melissa,2,Shared room,38,365,1.07,403
34578,Hellen,1,Shared room,220,41,0.2,261
34579,Melissa,2,Shared room,37,362,0.9,399
34580,Anthony,2,Private room,58,126,4.19,184
34582,Ava,2,Private room,55,45,3.45,100
34583,Domitille,2,Entire home/apt,93,0,0.28,93
34585,Anthony,2,Private room,58,188,4.26,246
34586,Eugene,1,Entire home/apt,140,24,1.23,164
34587,George,1,Entire home/apt,160,81,0.24,241
34588,Cheryl,2,Entire home/apt,125,250,0.65,375
34589,Eddie,3,Entire home/apt,140,335,1.17,475
34590,Harold & Rose,1,Entire home/apt,126,90,3.12,216
34591,Shogo,3,Private room,35,5,0.58,40
34592,Tony,3,Entire home/apt,159,67,2.44,226
34593,Cando,3,Private room,99,38,5.88,137
34594,Timothy,2,Private room,63,133,0.54,196
34595,Gabrielle,2,Entire home/apt,180,0,0.47,180
34596,Timothy,2,Private room,63,187,0.27,250
34597,Crystal,1,Private room,65,0,0.25,65
34598,John,2,Private room,48,0,0.28,48
34599,Yulia,2,Private room,42,0,0.1,42
34600,Chris And Jocelyn,3,Entire home/apt,85,290,3.4,375
34601,Ridhima,2,Private room,50,0,0.09,50
34602,Chris,1,Entire home/apt,199,230,1.4,429
34605,David,2,Entire home/apt,199,353,0.81,552
34606,Lucile,1,Private room,80,0,2.25,80
34607,Melissa,2,Shared room,36,361,1.06,397
34608,Lucy,2,Private room,40,331,0.27,371
34609,Michael,2,Private room,106,5,0.22,111
34610,Leigh,1,Entire home/apt,195,33,1.43,228
34611,Shondel,3,Entire home/apt,75,61,6.1,136
34614,William,2,Entire home/apt,160,23,5.46,183
34616,Mat,1,Entire home/apt,264,343,0.25,607
34617,Gwen,2,Private room,40,357,2.31,397
34618,Lev,3,Entire home/apt,120,16,2.1,136
34619,John,2,Private room,65,134,3.75,199
34620,Timothy,1,Entire home/apt,350,52,0.73,402
34621,Ernesto,1,Private room,75,0,0.19,75
34622,Jordan,1,Entire home/apt,190,130,0.6,320
34623,Kristen,1,Entire home/apt,65,0,0.87,65
34624,Elijah,1,Entire home/apt,180,179,2.0,359
34625,Isobel,2,Entire home/apt,100,0,0.09,100
34626,Cristina,2,Private room,65,0,0.54,65
34627,Saeko,2,Entire home/apt,150,160,0.47,310
34628,Kate,1,Private room,225,8,2.03,233
34629,Carlos Ivan,1,Private room,111,3,0.88,114
34630,Vanessa,1,Private room,150,55,2.34,205
34631,Maria,1,Entire home/apt,145,1,0.18,146
34632,Mansimran,2,Private room,57,0,0.32,57
34634,James,2,Entire home/apt,150,5,0.63,155
34635,Erik,3,Private room,53,357,1.3,410
34637,Victor,2,Private room,35,15,4.08,50
34638,Ashley,2,Private room,65,0,0.28,65
34639,Henry,3,Entire home/apt,100,77,6.0,177
34640,Sarah,3,Entire home/apt,100,178,1.82,278
34641,Kathy,1,Entire home/apt,144,0,0.18,144
34642,Bethany,2,Private room,49,0,1.15,49
34643,Heather,1,Entire home/apt,120,0,0.62,120
34644,Alex And Tatiana,3,Entire home/apt,77,0,0.29,77
34645,Ollie,2,Private room,60,0,0.14,60
34646,Ana Sophia,1,Entire home/apt,160,0,0.73,160
34647,Jackie,3,Private room,62,90,0.92,152
34648,Dennis,3,Private room,90,69,0.11,159
34649,Paolo,3,Private room,38,362,1.42,400
34650,Vanessa,1,Private room,150,47,2.38,197
34651,Juan Eduardo,1,Entire home/apt,160,0,0.56,160
34652,Savannah,1,Entire home/apt,128,0,0.71,128
34653,Rachel,2,Entire home/apt,139,62,3.7,201
34654,Veronica,2,Entire home/apt,80,8,4.5,88
34655,Alejandro,2,Private room,85,63,0.77,148
34656,Linda,2,Private room,45,0,0.76,45
34657,Mariana,2,Entire home/apt,148,82,5.61,230
34658,Sandy,2,Entire home/apt,115,48,1.42,163
34660,Sylvia,2,Private room,75,82,0.13,157
34661,Elisa,2,Private room,75,294,3.34,369
34662,Charles,3,Entire home/apt,196,202,1.87,398
34663,Jacqueline,1,Private room,100,0,0.09,100
34664,Jean,1,Entire home/apt,290,85,1.02,375
34665,Michelle,3,Private room,46,340,6.51,386
34666,Charlène,1,Private room,68,0,0.1,68
34667,Jonathan,1,Entire home/apt,150,0,0.18,150
34668,Andrew,1,Entire home/apt,149,0,0.09,149
34669,Sophia Yi,3,Private room,39,0,0.09,39
34670,Risa,2,Entire home/apt,175,8,1.33,183
34671,Kristine,2,Private room,100,2,1.24,102
34673,Eitan,2,Private room,60,0,0.36,60
34675,Sobe,2,Entire home/apt,100,0,0.09,100
34676,Connor,1,Entire home/apt,76,0,0.13,76
34677,Megan,2,Entire home/apt,91,0,0.21,91
34678,Michael,2,Private room,65,310,1.2,375
34679,Sharat,1,Entire home/apt,240,0,0.71,240
34680,Carlos,3,Shared room,30,157,2.78,187
34682,Jennyfer,1,Entire home/apt,106,0,1.53,106
34683,Sydney,2,Private room,59,0,0.73,59
34684,Holly,2,Private room,45,168,0.53,213
34686,Jonathan,5,Private room,55,154,0.55,209
34688,Tala,2,Entire home/apt,165,127,2.42,292
34689,Chris,1,Entire home/apt,450,80,3.37,530
34690,Miranda,3,Entire home/apt,115,179,0.53,294
34691,Veronica,2,Private room,50,0,0.18,50
34693,Maya,1,Entire home/apt,799,340,0.55,1139
34694,Foteinos,2,Private room,100,0,0.52,100
34695,Chris,3,Private room,70,108,5.28,178
34696,Frances,3,Private room,50,188,1.81,238
34697,Roger,2,Entire home/apt,138,151,5.67,289
34698,Alessandra,3,Private room,50,15,0.22,65
34699,Sam,1,Entire home/apt,250,60,0.11,310
34701,Eliana,3,Private room,89,212,2.6,301
34703,Cris,3,Entire home/apt,125,0,1.74,125
34704,Kazuya,1,Private room,36,199,0.11,235
34706,Camile,3,Private room,55,0,0.18,55
34707,Mariah,1,Entire home/apt,160,5,1.62,165
34708,Jonathan,3,Entire home/apt,170,106,1.0,276
34711,Conley,1,Private room,77,0,0.36,77
34712,Amado,2,Entire home/apt,175,137,5.26,312
34713,Jorge,2,Entire home/apt,90,3,2.43,93
34714,Chrisann,1,Entire home/apt,299,96,2.97,395
34715,Rashmi,2,Private room,79,91,4.06,170
34716,Douglas,1,Entire home/apt,285,70,4.05,355
34717,Linda,2,Private room,45,0,0.81,45
34718,Linda,2,Private room,40,0,1.16,40
34719,Linda,2,Private room,40,0,0.82,40
34720,Linda,2,Private room,40,0,1.09,40
34721,Maura,1,Entire home/apt,124,0,0.46,124
34722,Nour,1,Private room,60,0,4.85,60
34723,Liqin,3,Private room,89,342,3.49,431
34724,Nate,1,Entire home/apt,159,124,5.21,283
34725,Derek,1,Private room,180,48,0.99,228
34726,Jun Jun,3,Private room,63,347,1.99,410
34727,George,2,Private room,125,180,0.84,305
34728,Sania,2,Private room,70,39,1.0,109
34729,Pao,3,Private room,51,146,3.65,197
34730,Michelle,2,Entire home/apt,115,249,4.43,364
34731,Jermaine,4,Private room,55,333,2.96,388
34732,Grant,1,Entire home/apt,250,0,1.68,250
34734,Luis,3,Private room,149,340,0.46,489
34735,Joel And Jamila,2,Entire home/apt,55,311,3.43,366
34736,Ayesha,1,Private room,100,0,0.45,100
34737,Elena,2,Entire home/apt,170,0,1.64,170
34738,Faateh,1,Private room,85,0,0.55,85
34739,Kirill,1,Entire home/apt,295,70,2.28,365
34740,David,1,Entire home/apt,125,32,3.77,157
34741,Omar,2,Private room,52,329,0.36,381
34742,Ros,1,Entire home/apt,151,56,2.1,207
34743,Jane,1,Private room,90,13,0.82,103
34744,John,1,Private room,55,342,0.46,397
34745,John,1,Private room,55,360,0.65,415
34747,Marcia,4,Private room,50,61,0.21,111
34748,Ada,3,Private room,89,175,0.33,264
34749,Katie Graham,2,Private room,90,281,0.23,371
34750,Margaret,3,Entire home/apt,200,324,3.02,524
34752,Agnese,2,Private room,116,16,0.32,132
34753,Andrei,1,Entire home/apt,150,3,0.82,153
34754,Gennaro,2,Private room,80,311,4.98,391
34755,Dafna Irit,1,Private room,70,33,0.11,103
34756,Siham,2,Private room,65,49,5.27,114
34757,Vanessa,2,Entire home/apt,170,308,1.17,478
34758,Jenn & JJ,2,Entire home/apt,689,340,1.61,1029
34759,Youssef,2,Entire home/apt,99,0,0.19,99
34761,Priya,1,Private room,111,0,0.63,111
34762,Sebastián Y Natalia,2,Private room,43,0,1.02,43
34764,Marissa,2,Private room,125,54,0.27,179
34765,Michael,2,Entire home/apt,200,0,0.37,200
34766,Tina,2,Private room,100,31,3.19,131
34767,Tina,2,Private room,63,0,0.56,63
34768,Theodore,1,Private room,150,83,0.48,233
34769,Raluca,1,Private room,60,0,0.47,60
34770,Izzie,2,Entire home/apt,100,46,0.76,146
34771,Arianna,2,Private room,39,35,0.11,74
34772,Amy,1,Private room,90,119,2.39,209
34773,Lee + Amber,2,Entire home/apt,195,241,3.2,436
34774,Corporate Housing,1,Entire home/apt,142,364,0.11,506
34775,Deniz,2,Private room,55,310,1.73,365
34776,Corporate Housing,1,Entire home/apt,142,213,0.32,355
34777,Thaddeus,2,Entire home/apt,150,0,0.89,150
34778,Joe And Shelly,2,Private room,65,154,0.44,219
34779,Lydia,3,Private room,86,0,1.28,86
34780,Mark,2,Entire home/apt,200,163,0.1,363
34781,Jonathan,2,Private room,65,0,0.19,65
34782,Oliver,1,Entire home/apt,400,0,0.12,400
34783,Melissa,2,Private room,55,330,1.19,385
34785,Alli,1,Entire home/apt,175,128,2.53,303
34786,Shivani,1,Entire home/apt,150,5,0.1,155
34787,Tobias,2,Private room,59,177,0.74,236
34788,Michael,1,Entire home/apt,339,0,0.74,339
34789,Pariis,5,Private room,100,0,0.12,100
34790,Michael,1,Entire home/apt,339,0,0.41,339
34792,Yianni,1,Private room,105,90,0.28,195
34793,Genisley,1,Entire home/apt,195,150,4.86,345
34794,Paul A,1,Private room,79,0,0.75,79
34795,Yuting,2,Private room,55,149,5.87,204
34796,Barron,2,Entire home/apt,200,27,0.16,227
34797,Andy,1,Entire home/apt,159,0,0.31,159
34798,Markus,2,Private room,82,175,1.94,257
34799,Maggie,3,Entire home/apt,65,127,5.5,192
34801,Joel And Jamila,2,Private room,75,125,0.21,200
34802,Miriam,2,Entire home/apt,136,3,1.32,139
34803,Joel And Jamila,2,Private room,65,125,0.39,190
34804,Marlon,1,Private room,49,12,1.37,61
34805,Kelli,1,Entire home/apt,300,0,0.48,300
34806,Chelsea,2,Entire home/apt,160,4,0.23,164
34807,Mina,1,Entire home/apt,150,290,0.79,440
34809,Melissa,2,Shared room,36,365,0.82,401
34810,Karina,3,Entire home/apt,79,0,0.54,79
34811,Freehand,1,Private room,129,365,3.3,494
34812,Sophia,2,Entire home/apt,159,262,1.05,421
34813,Wale,1,Entire home/apt,100,177,0.92,277
34814,Michael,1,Entire home/apt,93,332,0.14,425
34816,Donna,1,Entire home/apt,86,0,0.28,86
34817,Loris,1,Private room,60,365,2.36,425
34819,Fran,3,Private room,60,167,0.58,227
34820,Elena,1,Entire home/apt,185,0,0.97,185
34821,Hugh,3,Private room,75,139,6.11,214
34822,Pedro,1,Entire home/apt,95,2,4.0,97
34823,Javonne,2,Private room,42,9,3.29,51
34824,Sophia,2,Private room,120,179,0.79,299
34828,Legera,1,Entire home/apt,350,0,0.19,350
34829,Philip,3,Entire home/apt,125,123,1.51,248
34830,Adrian,2,Entire home/apt,165,37,5.11,202
34831,Nico,1,Private room,230,0,1.28,230
34832,Kelly,1,Entire home/apt,200,341,0.09,541
34833,Jk,1,Entire home/apt,250,58,5.82,308
34834,Nicole,2,Entire home/apt,290,117,1.25,407
34835,Liqin,3,Private room,80,362,1.9,442
34836,Dan,2,Shared room,25,88,0.77,113
34837,Dan,2,Shared room,35,50,0.32,85
34838,Nazma,3,Entire home/apt,150,147,1.92,297
34839,Celia,2,Entire home/apt,180,98,1.98,278
34840,Zizi,1,Entire home/apt,150,0,0.69,150
34841,Тest,1,Entire home/apt,95,0,0.27,95
34842,Silvia,1,Private room,120,10,2.1,130
34843,Ben,1,Entire home/apt,400,0,0.25,400
34844,Ken,1,Entire home/apt,1100,180,0.52,1280
34846,Shinhee,2,Entire home/apt,60,0,0.13,60
34848,Mehdi,2,Entire home/apt,150,0,0.65,150
34849,Andre,2,Private room,49,132,0.83,181
34850,Dafni,3,Entire home/apt,120,0,0.52,120
34852,David,2,Entire home/apt,100,0,0.63,100
34853,Siyi,2,Entire home/apt,139,20,0.94,159
34855,Kriti,2,Private room,59,0,2.39,59
34856,Ismael,3,Private room,60,318,1.05,378
34857,Vanja,1,Entire home/apt,197,12,0.14,209
34858,Féven,1,Entire home/apt,112,89,1.04,201
34859,Jeff,1,Entire home/apt,140,18,1.76,158
34861,Clay,1,Entire home/apt,245,262,3.14,507
34862,Travis,2,Entire home/apt,175,1,0.58,176
34863,Ana,2,Entire home/apt,199,250,1.28,449
34864,Elizabeth,2,Entire home/apt,65,7,8.87,72
34867,Sophie,3,Entire home/apt,229,0,3.58,229
34868,Shareef,1,Private room,70,22,4.55,92
34869,Lili,2,Private room,88,54,1.91,142
34870,Anne& Peter,2,Private room,55,358,3.73,413
34871,Anne& Peter,2,Private room,55,346,2.47,401
34872,Anne& Peter,2,Private room,55,351,2.46,406
34873,Liset,2,Private room,65,28,0.28,93
34874,Dawn,2,Entire home/apt,350,127,1.58,477
34875,Daisy,2,Private room,52,328,2.31,380
34876,Daisy,2,Private room,55,347,2.32,402
34878,Edyta,2,Entire home/apt,125,68,1.17,193
34879,Mitchell,1,Private room,200,172,1.23,372
34880,Victoria,2,Private room,65,0,0.46,65
34881,Petr,2,Private room,85,0,0.1,85
34882,Spencer,1,Entire home/apt,379,238,3.24,617
34883,Hongzhi,1,Private room,69,0,0.91,69
34884,Victoria,2,Private room,65,6,0.48,71
34885,Donald,1,Entire home/apt,175,89,0.11,264
34886,Alicia,2,Entire home/apt,100,0,0.55,100
34887,Patricia,2,Private room,50,300,3.79,350
34889,John,1,Entire home/apt,225,87,0.57,312
34890,Edwin,1,Entire home/apt,175,14,0.09,189
34891,Oscar,4,Private room,80,72,2.91,152
34892,Siyi,2,Entire home/apt,155,118,1.65,273
34893,Liqin,3,Private room,75,360,2.31,435
34894,Yuting,2,Private room,55,0,4.31,55
34895,Cal,1,Entire home/apt,239,0,0.21,239
34896,Diana,2,Private room,50,55,0.65,105
34898,Mason,2,Entire home/apt,300,125,0.83,425
34899,Wayne,2,Entire home/apt,285,36,2.35,321
34900,Mark,2,Entire home/apt,250,202,3.34,452
34901,Devaughn,2,Private room,85,65,0.15,150
34902,Sabina,1,Entire home/apt,330,5,0.74,335
34903,Liqin,3,Private room,85,337,2.81,422
34904,Kristina,1,Private room,120,0,1.11,120
34905,Maxime,4,Private room,50,280,1.26,330
34906,Joseph,2,Entire home/apt,150,0,0.61,150
34907,Moné,2,Private room,63,0,0.52,63
34908,Samantha,2,Private room,85,170,1.04,255
34909,Mari,3,Entire home/apt,85,44,3.07,129
34910,Guy,2,Private room,43,81,5.52,124
34911,Max & Katie,1,Private room,80,12,6.35,92
34912,Sahar,2,Entire home/apt,172,78,3.12,250
34913,Paula And Jorge,2,Entire home/apt,125,89,5.03,214
34914,Stan,2,Private room,45,39,1.0,84
34915,Daphnee/Allan,3,Entire home/apt,54,12,4.18,66
34916,Zani,1,Entire home/apt,170,180,0.28,350
34917,Marie,2,Private room,50,77,2.0,127
34918,Candace,2,Private room,80,345,7.0,425
34920,Kazuya,3,Private room,33,246,0.21,279
34921,Stephanie,2,Private room,45,4,2.44,49
34922,Julie,1,Entire home/apt,150,0,2.0,150
34923,Layla,2,Private room,37,1,4.04,38
34924,Alice,1,Entire home/apt,150,0,2.41,150
34925,Miguel,3,Private room,60,40,0.45,100
34926,Vasily,2,Entire home/apt,71,0,0.28,71
34927,Walid,1,Entire home/apt,158,18,3.07,176
34928,Theodora,1,Entire home/apt,150,38,2.92,188
34929,Omar,3,Private room,58,88,2.96,146
34930,Omar,3,Private room,57,125,1.94,182
34932,Ley,1,Private room,155,312,1.25,467
34933,Sami,3,Entire home/apt,185,55,3.21,240
34934,Claudina,2,Private room,86,342,0.97,428
34935,Peach,2,Private room,65,0,0.09,65
34936,Ashley,2,Entire home/apt,139,0,2.02,139
34937,Mohit,1,Entire home/apt,187,0,0.53,187
34938,Dawid,5,Private room,36,178,1.67,214
34939,Meryl,1,Entire home/apt,120,0,1.8,120
34940,Linda,1,Private room,65,58,1.94,123
34941,Mansi,1,Private room,120,179,0.85,299
34942,Nathan,4,Shared room,65,0,0.39,65
34943,Francesca,1,Entire home/apt,250,28,1.51,278
34944,Richard,3,Entire home/apt,120,41,0.9,161
34945,Bryant,3,Entire home/apt,175,317,0.97,492
34946,Bryant,3,Entire home/apt,200,321,0.92,521
34947,Abbey,1,Entire home/apt,148,1,1.74,149
34948,Maria,2,Entire home/apt,120,3,0.52,123
34949,Laurence,1,Entire home/apt,159,358,3.07,517
34950,Adam,1,Entire home/apt,200,56,1.46,256
34951,Paula,1,Entire home/apt,85,16,2.24,101
34952,Olga,1,Private room,90,112,3.0,202
34953,Emily,2,Entire home/apt,104,0,2.0,104
34955,Deborah/Aston,2,Entire home/apt,125,95,4.13,220
34956,Erica,1,Entire home/apt,275,0,0.19,275
34957,Paula,3,Private room,60,341,1.14,401
34958,Carmen,5,Private room,46,0,1.55,46
34959,Ace,2,Entire home/apt,80,0,0.53,80
34960,Alkhadher,2,Entire home/apt,136,130,2.26,266
34961,Chantal,2,Entire home/apt,125,261,6.26,386
34962,Nada,2,Private room,85,81,1.38,166
34963,Woods,2,Entire home/apt,175,0,1.63,175
34964,Christine,1,Private room,400,184,1.23,584
34965,Dee Daisy And Peter,2,Private room,60,319,2.7,379
34966,Dee Daisy And Peter,2,Private room,60,361,1.02,421
34967,Aaron,2,Private room,95,0,0.19,95
34968,Dee Daisy And Peter,2,Private room,65,365,2.84,430
34969,Harriet,4,Private room,69,311,0.87,380
34970,Qiongyao,3,Private room,89,33,0.18,122
34971,Anna,1,Private room,110,90,3.9,200
34972,Karen,1,Entire home/apt,150,302,0.77,452
34973,Manon,2,Private room,52,0,0.29,52
34974,Adriana,1,Private room,75,58,1.67,133
34975,Anika,2,Private room,60,61,3.19,121
34976,Sultan,2,Entire home/apt,100,0,0.58,100
34977,Jeff,2,Private room,90,0,4.92,90
34978,Sean,3,Entire home/apt,170,0,1.07,170
34979,Polina,2,Entire home/apt,105,36,0.59,141
34980,Theresa,2,Entire home/apt,295,25,2.99,320
34981,Henry,2,Private room,98,11,3.24,109
34982,Jaran,2,Entire home/apt,150,252,4.14,402
34984,Candia,2,Private room,99,41,4.96,140
34987,Omar,3,Private room,53,156,2.15,209
34988,Abraham,1,Shared room,49,12,2.31,61
34989,Sebastien,2,Private room,40,0,0.1,40
34990,Carlos,1,Entire home/apt,300,2,1.14,302
34991,Abraham,1,Shared room,49,109,5.54,158
34992,Corie,2,Entire home/apt,124,273,3.59,397
34993,Abraham,1,Shared room,60,120,2.58,180
34994,Louis,1,Private room,100,64,3.8,164
34995,Astrid,2,Private room,78,30,3.19,108
34997,Louis,1,Private room,90,36,4.07,126
34998,Louis,1,Entire home/apt,180,30,4.73,210
34999,Ley,1,Entire home/apt,300,62,1.06,362
35000,Susan,2,Entire home/apt,110,0,0.19,110
35001,Ryan,1,Entire home/apt,269,55,1.67,324
35002,Hajah,1,Private room,61,95,0.85,156
35003,Samet,1,Private room,99,0,0.74,99
35004,Luz Carime,2,Private room,60,0,0.32,60
35006,Mk,1,Entire home/apt,199,3,1.33,202
35007,Rojé,3,Private room,75,0,8.56,75
35008,Catarina,1,Private room,150,56,0.21,206
35009,Mariluz,1,Private room,150,0,6.04,150
35010,Eibhlin,2,Private room,42,216,0.36,258
35011,Harriet,4,Private room,53,356,1.2,409
35012,Teen,1,Entire home/apt,290,41,0.87,331
35013,Mariluz,1,Private room,135,0,7.24,135
35014,Mariluz,1,Shared room,62,0,10.77,62
35015,Samuel,1,Entire home/apt,800,270,0.31,1070
35016,Amit,1,Entire home/apt,175,0,0.7,175
35017,Christina,4,Private room,50,163,2.24,213
35018,Bei,3,Private room,55,38,2.37,93
35019,Yu,1,Entire home/apt,149,96,3.07,245
35020,Bryan,1,Entire home/apt,200,0,2.79,200
35021,Brik,1,Entire home/apt,350,267,4.49,617
35023,Ashley,1,Entire home/apt,250,9,0.38,259
35024,Rachel,2,Entire home/apt,185,44,1.89,229
35025,Evelyn,2,Entire home/apt,185,17,2.42,202
35026,Laura,1,Entire home/apt,140,333,2.71,473
35027,Linda,1,Private room,45,128,1.34,173
35028,Haruhisa,3,Private room,40,0,0.11,40
35029,Boer,2,Private room,150,276,0.1,426
35030,Isabel,1,Private room,145,5,7.61,150
35031,Angie,3,Entire home/apt,125,0,0.22,125
35032,Rafa' S,3,Private room,70,177,2.31,247
35034,Nathan,4,Private room,65,0,0.29,65
35035,Elaine,2,Entire home/apt,350,5,0.49,355
35036,Kandi,2,Private room,66,173,0.66,239
35037,Kandi,2,Private room,65,173,2.25,238
35038,Anchor,2,Shared room,31,85,3.08,116
35040,Elizabeth,2,Private room,55,68,2.64,123
35041,Kandi,2,Private room,75,215,1.55,290
35042,Sruthi,2,Entire home/apt,210,120,1.24,330
35043,Matthew,2,Private room,120,85,1.55,205
35046,Adam,2,Private room,90,89,0.58,179
35047,Adam,2,Private room,90,87,1.32,177
35048,Azia,2,Entire home/apt,115,165,1.23,280
35049,Layla,2,Private room,45,0,0.14,45
35050,Gordon,1,Entire home/apt,200,16,0.24,216
35051,Eleanor,2,Private room,105,0,1.34,105
35052,Abraham,1,Shared room,49,9,3.23,58
35053,Abraham,1,Shared room,49,5,4.71,54
35054,Abraham,1,Shared room,49,10,2.12,59
35055,Abraham,1,Shared room,49,3,5.81,52
35056,J-,2,Private room,73,104,0.76,177
35057,Nicholas,1,Entire home/apt,150,17,0.29,167
35058,Lo,1,Entire home/apt,220,48,0.92,268
35059,Jimmy,3,Private room,35,344,8.87,379
35060,Heidi,2,Entire home/apt,125,0,1.22,125
35061,Luis,1,Shared room,85,365,2.19,450
35064,Ry,2,Entire home/apt,190,364,0.99,554
35065,Danielle,1,Entire home/apt,300,343,0.21,643
35067,John,1,Private room,65,361,0.23,426
35068,Bev,2,Private room,48,94,3.13,142
35070,Maeve,2,Entire home/apt,250,12,0.39,262
35071,Justin,3,Entire home/apt,150,118,2.04,268
35072,Richie,1,Private room,150,67,0.24,217
35073,Cheryl,2,Entire home/apt,80,209,6.0,289
35074,Freddy,3,Private room,80,180,0.47,260
35075,Catherine,4,Private room,65,365,2.18,430
35076,Corporate Housing,1,Entire home/apt,150,311,0.45,461
35077,Moira,2,Entire home/apt,275,0,0.19,275
35078,Elena,1,Entire home/apt,250,46,0.95,296
35079,Holden,2,Private room,49,28,2.78,77
35080,Paul,3,Private room,61,171,4.5,232
35081,Zak,2,Private room,90,129,0.75,219
35082,Onyuka,2,Private room,75,55,0.59,130
35083,Krystalee,1,Private room,110,0,0.1,110
35084,Mofizur,3,Entire home/apt,125,95,3.2,220
35085,Catherine,4,Private room,140,365,3.01,505
35086,Liat,2,Entire home/apt,250,101,2.98,351
35087,Yeon,1,Private room,100,112,3.3,212
35088,Lucy,2,Private room,90,0,0.19,90
35089,Öykü,1,Private room,45,0,0.47,45
35090,Tyrany,2,Private room,65,0,2.52,65
35091,Luigi,2,Private room,45,10,0.87,55
35093,Ben,2,Private room,70,0,0.18,70
35095,Anastasia,1,Private room,400,67,0.87,467
35097,Tunde,1,Entire home/apt,119,103,3.02,222
35098,Abbey,1,Private room,197,95,0.3,292
35099,Dr. Jihene,2,Private room,30,93,3.6,123
35100,Sonder,1,Entire home/apt,245,311,0.26,556
35101,Joe,1,Entire home/apt,149,1,2.4,150
35102,Dio,2,Private room,66,158,3.75,224
35103,Sarah,1,Private room,76,66,0.32,142
35104,Aaron,2,Entire home/apt,100,0,0.52,100
35105,Raisa,2,Private room,55,0,0.39,55
35107,Violet,3,Entire home/apt,130,352,1.69,482
35108,Maiko,3,Entire home/apt,130,0,0.47,130
35109,Jason C,3,Entire home/apt,51,2,1.0,53
35110,Samantha,2,Private room,65,179,0.19,244
35111,Caroline,2,Entire home/apt,100,4,0.66,104
35112,Andrzej,3,Entire home/apt,170,308,2.55,478
35113,Jason,2,Entire home/apt,144,71,0.16,215
35114,Jenna,1,Entire home/apt,250,0,0.34,250
35115,Ryan,1,Entire home/apt,349,255,3.04,604
35116,Bassam,2,Private room,65,169,3.79,234
35118,Gabriel,4,Private room,45,153,1.93,198
35119,Haidy,4,Private room,80,78,2.69,158
35120,Amarjit S,5,Private room,34,290,0.85,324
35121,Laine,2,Private room,80,0,0.2,80
35122,Kazuya,3,Private room,36,235,0.77,271
35123,Alice,1,Entire home/apt,180,0,0.56,180
35125,Ali,2,Private room,66,0,0.31,66
35126,Karim,2,Private room,95,28,4.35,123
35127,Martha,2,Entire home/apt,119,31,2.61,150
35128,Yemisi,1,Entire home/apt,199,0,0.69,199
35129,Viswanadha,1,Entire home/apt,300,0,0.2,300
35130,Christian,1,Private room,150,188,1.65,338
35132,Julie,2,Private room,39,0,0.19,39
35133,Jenna,2,Entire home/apt,125,207,0.1,332
35134,Alex,1,Private room,300,0,0.45,300
35135,Buke,1,Private room,150,127,0.31,277
35136,Pauline,2,Private room,60,131,1.59,191
35138,Julie,2,Entire home/apt,180,9,0.11,189
35139,Aaron,2,Private room,40,84,0.45,124
35140,Sophia,2,Private room,65,281,0.19,346
35141,Dani,2,Entire home/apt,150,281,0.64,431
35142,Swetha,1,Private room,100,361,0.81,461
35143,Joyce,2,Entire home/apt,150,0,0.87,150
35144,Alexandra,2,Private room,90,10,2.0,100
35145,Linda,3,Private room,40,0,0.1,40
35146,Nathan,2,Private room,69,1,1.22,70
35147,Jeff,5,Private room,85,353,0.19,438
35148,Bryce,2,Entire home/apt,200,4,0.61,204
35149,Holden,2,Private room,59,28,3.14,87
35150,Elena,1,Entire home/apt,248,100,0.31,348
35151,Linda,2,Private room,60,50,0.21,110
35152,Naor,1,Private room,95,0,2.71,95
35153,Luis,3,Private room,77,354,0.98,431
35154,Ivan,2,Private room,70,0,0.81,70
35156,Kc,2,Private room,45,36,4.68,81
35158,Kc,2,Private room,45,39,4.07,84
35159,Patrick,2,Entire home/apt,75,167,1.21,242
35160,Dalva,3,Private room,64,8,2.21,72
35161,Shachi,2,Entire home/apt,150,330,0.48,480
35162,Greetings From Saul And Diana,2,Private room,80,65,1.32,145
35163,Jasmine,2,Entire home/apt,75,77,2.17,152
35164,Jackie,3,Private room,64,90,0.73,154
35165,Keagon,2,Entire home/apt,154,19,1.16,173
35166,Joanne,2,Private room,40,282,0.65,322
35167,Inna,2,Entire home/apt,160,45,6.18,205
35168,Tyler,1,Entire home/apt,210,0,0.68,210
35169,Zsanett,2,Private room,54,59,5.16,113
35170,(Email hidden by Airbnb),1,Private room,139,0,0.31,139
35171,Jasmine,3,Private room,39,82,2.14,121
35172,Enrica,1,Entire home/apt,180,0,0.31,180
35173,Colette,1,Entire home/apt,400,64,0.68,464
35174,Brittany,1,Entire home/apt,189,0,0.48,189
35175,Jasmine,1,Private room,60,0,2.64,60
35176,Sara,3,Private room,55,0,0.32,55
35177,Kinga,1,Entire home/apt,140,89,0.29,229
35178,Olive,2,Private room,46,0,0.11,46
35179,Lana,2,Entire home/apt,122,61,1.87,183
35181,Siham,2,Private room,65,67,3.99,132
35183,Anthony J,1,Private room,70,10,4.45,80
35185,Christina,1,Entire home/apt,180,162,2.09,342
35186,Tajudeen,5,Private room,40,56,10.12,96
35187,Melissa,3,Private room,55,155,0.76,210
35188,Jesus,2,Private room,80,0,0.29,80
35189,Ada,1,Private room,99,0,4.44,99
35191,Rachel Leigh,1,Private room,90,6,2.05,96
35192,Cherie,3,Entire home/apt,107,0,0.38,107
35193,Lucie,4,Private room,50,0,3.77,50
35194,Amal,2,Entire home/apt,300,0,0.58,300
35195,David,2,Entire home/apt,123,0,2.35,123
35196,Kazuya,1,Private room,36,215,0.22,251
35197,Jeff,3,Entire home/apt,399,324,2.3,723
35198,Yahaira,4,Entire home/apt,145,0,0.48,145
35199,Mat,2,Entire home/apt,140,213,1.04,353
35200,John,1,Private room,54,352,0.23,406
35201,Flannery,2,Entire home/apt,177,214,2.28,391
35202,Rahat,1,Private room,65,275,2.06,340
35203,Geoffrey,2,Entire home/apt,150,0,1.68,150
35204,Esther,2,Private room,50,41,1.16,91
35205,Jan,2,Entire home/apt,104,179,0.54,283
35206,Zsanett,2,Private room,54,36,4.31,90
35207,Kristina,2,Private room,74,95,0.13,169
35208,Diana,2,Private room,75,64,1.43,139
35209,Jimmy,1,Entire home/apt,300,8,1.07,308
35210,Jazzy,1,Entire home/apt,280,147,2.83,427
35211,Marie,2,Private room,150,362,0.1,512
35212,Carolina,1,Private room,73,0,0.47,73
35213,Maxime,3,Private room,70,0,0.29,70
35215,Eli,2,Entire home/apt,97,148,2.68,245
35216,Caleb,2,Entire home/apt,130,2,0.16,132
35217,Yasser,2,Private room,95,65,5.83,160
35218,Momoyo,3,Private room,40,0,0.24,40
35219,Bedly Bushwick,3,Private room,38,7,0.36,45
35220,Florence,2,Private room,70,0,0.33,70
35222,Natalie,2,Entire home/apt,600,139,2.27,739
35223,Marina,2,Private room,44,0,0.2,44
35224,Shimin,2,Private room,29,0,1.73,29
35225,Elle,1,Entire home/apt,135,68,0.87,203
35226,Xavier,2,Private room,58,3,1.25,61
35227,Daniela,1,Private room,120,0,0.47,120
35228,Marcos,2,Private room,110,173,0.28,283
35229,Julianne,1,Private room,130,117,0.41,247
35230,Nina,5,Private room,50,37,0.77,87
35231,Nina,5,Private room,40,37,0.39,77
35234,Amber,2,Entire home/apt,495,194,4.55,689
35235,Hardik,3,Private room,80,0,1.54,80
35236,Daniel,1,Private room,200,0,0.84,200
35237,Nick,1,Private room,89,2,1.27,91
35238,J.S.,2,Private room,40,13,0.69,53
35239,Maka,2,Private room,60,83,0.33,143
35240,Melissa,2,Shared room,36,365,1.45,401
35241,Sharon & Erika,4,Private room,69,330,0.19,399
35242,Sheki,2,Private room,45,143,0.1,188
35243,Michele,2,Private room,75,65,2.36,140
35245,Lindsay,2,Entire home/apt,125,33,3.75,158
35246,Ann,2,Private room,55,314,2.98,369
35247,Douglas,1,Private room,90,0,4.84,90
35248,Marie,1,Entire home/apt,300,90,1.0,390
35249,Jennifer,2,Private room,88,86,0.53,174
35250,Melissa,2,Shared room,36,365,1.51,401
35251,Greg,1,Entire home/apt,225,0,1.35,225
35252,Andrei,2,Private room,79,180,0.67,259
35253,Yaasha,1,Private room,80,0,0.58,80
35254,Austin,2,Private room,39,4,6.08,43
35255,Melissa,2,Private room,43,344,1.96,387
35256,Blaine,2,Private room,37,0,0.12,37
35257,William,1,Entire home/apt,394,68,2.19,462
35258,Lea,1,Entire home/apt,799,364,0.1,1163
35259,John,1,Entire home/apt,499,233,2.95,732
35260,ZhongJei,2,Private room,60,53,0.81,113
35261,Qusuquzah,2,Private room,68,365,0.49,433
35262,Michael,2,Private room,70,11,0.68,81
35263,Teresa,1,Private room,149,123,1.26,272
35264,Chang,3,Entire home/apt,69,121,8.06,190
35265,Nina,5,Shared room,75,37,0.1,112
35266,Antonio,3,Private room,95,245,2.44,340
35267,Cate,1,Entire home/apt,214,296,0.75,510
35269,Georgian,1,Entire home/apt,269,216,6.18,485
35270,Sam,2,Entire home/apt,80,105,0.29,185
35271,Rafael,3,Private room,30,0,2.32,30
35272,David,2,Entire home/apt,200,45,0.9,245
35273,Kazuya,3,Private room,39,251,0.31,290
35274,Kazuya,3,Private room,38,233,0.21,271
35275,Carrie,5,Entire home/apt,65,247,2.89,312
35276,Yuting,2,Private room,70,168,6.54,238
35277,Nikole,3,Shared room,30,365,0.41,395
35278,Nikole,3,Shared room,31,365,0.11,396
35279,Camilla,2,Entire home/apt,170,0,0.37,170
35280,Noah,1,Private room,45,0,1.37,45
35281,H,1,Entire home/apt,90,3,0.56,93
35282,Juan,1,Entire home/apt,400,7,0.16,407
35284,Raul,1,Entire home/apt,200,13,0.28,213
35285,Will,1,Entire home/apt,199,30,2.48,229
35286,Marie & Tyler,2,Private room,35,4,0.12,39
35287,Sasha,2,Private room,60,90,0.29,150
35290,Alejandro,3,Entire home/apt,195,0,8.84,195
35291,Dylan,1,Entire home/apt,180,0,0.2,180
35292,Allam,2,Entire home/apt,150,57,0.24,207
35293,Roger,3,Entire home/apt,115,38,2.75,153
35295,Rachel Leigh,1,Private room,80,5,2.78,85
35296,Jessica,2,Private room,200,357,1.62,557
35297,Justin,1,Entire home/apt,639,108,0.38,747
35298,Maria C.,2,Private room,150,26,0.1,176
35299,Nicole,2,Private room,70,0,0.1,70
35300,Sammy,3,Entire home/apt,115,169,3.31,284
35301,Lou,1,Entire home/apt,225,0,0.22,225
35302,Shaun,1,Entire home/apt,140,6,1.24,146
35303,Caroline,2,Entire home/apt,200,220,0.21,420
35304,Stephanie,1,Entire home/apt,250,0,0.48,250
35306,Taitu,2,Entire home/apt,125,55,0.16,180
35307,Piyush,1,Private room,150,0,0.11,150
35308,Alexis,1,Private room,270,365,0.45,635
35309,Maribel,1,Private room,72,361,0.53,433
35310,Panos,1,Entire home/apt,250,179,0.51,429
35311,Ahmet,1,Private room,100,14,0.99,114
35312,Lee And Teri,2,Private room,68,47,3.96,115
35313,Philip,2,Entire home/apt,200,35,0.49,235
35314,Farhan,3,Entire home/apt,129,296,4.92,425
35315,Vanessa,2,Entire home/apt,80,0,1.49,80
35316,Jason,1,Entire home/apt,175,247,4.16,422
35317,Igor,3,Entire home/apt,160,19,0.19,179
35318,Tassie,1,Entire home/apt,460,27,1.07,487
35319,Candace,2,Private room,89,365,0.22,454
35320,Sarah,2,Entire home/apt,99,0,0.3,99
35321,Kevin,2,Private room,55,4,1.15,59
35323,Kazuya,1,Entire home/apt,76,219,0.36,295
35324,Jewell,2,Private room,50,365,0.52,415
35325,5 Star Stays,2,Entire home/apt,175,321,8.29,496
35326,Nicolas,1,Entire home/apt,160,351,0.69,511
35327,Kyle,3,Private room,65,0,0.16,65
35328,Mira,1,Entire home/apt,80,56,0.59,136
35329,Judy,1,Private room,99,0,2.03,99
35330,Selina,2,Entire home/apt,480,63,1.3,543
35331,Ariel,2,Private room,60,78,3.1,138
35332,Amaru,2,Private room,35,59,1.62,94
35333,Kenny,3,Private room,110,365,4.92,475
35334,Gabrielle,2,Private room,60,62,1.91,122
35335,Rafael,5,Entire home/apt,150,259,2.74,409
35336,Cebile,2,Entire home/apt,350,334,2.88,684
35337,Mayda,2,Private room,65,0,2.52,65
35338,Gonzalo,2,Entire home/apt,298,74,0.2,372
35339,Christine,3,Entire home/apt,101,135,4.4,236
35341,Kendra,3,Private room,75,0,0.29,75
35342,Murtland,3,Entire home/apt,165,51,2.32,216
35344,Cando,3,Private room,80,57,9.34,137
35345,Cando,3,Private room,80,48,7.56,128
35346,Christina,1,Entire home/apt,170,0,0.59,170
35347,Lucy,2,Entire home/apt,530,249,0.9,779
35348,Nikole,3,Shared room,34,365,0.23,399
35350,Nikole,3,Shared room,29,365,0.1,394
35351,Jt,1,Entire home/apt,209,83,0.58,292
35352,Annie,1,Entire home/apt,300,239,8.29,539
35353,Clarissa,2,Private room,50,0,0.1,50
35354,Amy,2,Private room,65,303,1.0,368
35355,Linda,2,Private room,45,0,0.68,45
35357,Tamara,3,Private room,105,343,0.76,448
35358,Daphna,3,Private room,45,0,0.43,45
35359,Jose,1,Entire home/apt,215,0,0.68,215
35360,Kais,3,Private room,220,346,0.61,566
35361,Leah,1,Private room,100,89,1.19,189
35362,Nutrice,2,Entire home/apt,120,232,4.94,352
35364,Vaughn,2,Entire home/apt,110,2,5.27,112
35365,Lili,2,Entire home/apt,97,81,2.57,178
35366,Jordan,2,Private room,75,0,0.61,75
35367,Ricky,1,Private room,150,362,1.63,512
35368,Mike,1,Private room,50,270,1.36,320
35369,Mike,1,Private room,47,90,1.67,137
35370,David,1,Private room,150,0,1.95,150
35371,Morgan,2,Private room,75,64,7.28,139
35372,Martin & Soledad,3,Private room,58,156,3.97,214
35373,Giraud,1,Entire home/apt,150,26,2.01,176
35374,Seyoum,1,Private room,70,123,2.8,193
35375,Florence,2,Entire home/apt,150,54,2.43,204
35376,Ashley,2,Entire home/apt,130,0,0.28,130
35377,Yulia,2,Private room,53,1,6.5,54
35378,Deloris,2,Entire home/apt,200,89,1.26,289
35379,Naomi,2,Private room,35,338,2.58,373
35381,Lucy,2,Entire home/apt,285,275,1.26,560
35382,Lucy,2,Entire home/apt,245,278,0.48,523
35383,Andy,4,Entire home/apt,280,344,3.09,624
35384,Janet,3,Private room,60,66,7.21,126
35385,Emilie,2,Entire home/apt,98,0,0.1,98
35386,Arthur,3,Private room,10,180,0.41,190
35387,Studioplus,1,Entire home/apt,200,358,1.38,558
35388,Tony,2,Private room,75,29,0.3,104
35389,Chris,2,Private room,78,266,1.8,344
35391,Charles,1,Private room,590,125,0.6,715
35393,Shandor,2,Entire home/apt,145,177,0.11,322
35395,Maria,2,Private room,70,0,0.2,70
35396,Elisabeth,1,Private room,135,197,0.93,332
35397,Sarahya,2,Private room,65,164,2.09,229
35398,Joshua,3,Shared room,120,14,1.62,134
35399,Lenore,1,Entire home/apt,175,195,0.1,370
35400,Liqin,3,Private room,85,341,2.31,426
35401,Julien,1,Private room,79,0,0.29,79
35402,Charlie,4,Entire home/apt,130,349,3.68,479
35403,Sarahya,2,Private room,80,78,1.83,158
35404,Grisel,2,Private room,70,0,0.1,70
35405,Liqin,3,Private room,89,346,2.78,435
35406,Camilo,4,Private room,40,132,3.08,172
35407,Greg,1,Entire home/apt,185,162,5.2,347
35408,Bianca,3,Private room,120,90,0.21,210
35409,Emily,2,Entire home/apt,122,152,0.76,274
35410,Antonio,3,Private room,55,281,2.16,336
35411,Blueground,1,Entire home/apt,285,324,0.12,609
35412,Andrea,2,Private room,30,2,0.68,32
35413,Kathy,2,Entire home/apt,80,229,1.0,309
35414,R R,2,Entire home/apt,335,81,1.67,416
35415,SamariSankofa,1,Private room,848,355,1.89,1203
35416,James,2,Private room,75,48,1.44,123
35417,Ajay,3,Private room,55,142,3.58,197
35418,Chloe,2,Entire home/apt,119,0,0.3,119
35419,Nicole,2,Entire home/apt,143,0,0.29,143
35420,Enrique,1,Private room,80,3,0.16,83
35421,Robert,1,Entire home/apt,175,142,4.08,317
35422,Sam,2,Entire home/apt,150,11,1.73,161
35423,Jonathan,4,Private room,48,47,3.21,95
35425,Carrie,1,Entire home/apt,167,164,5.75,331
35426,Sonder,1,Entire home/apt,169,214,0.58,383
35427,Kalaya'An,3,Private room,86,88,0.29,174
35428,Axelle,1,Entire home/apt,110,157,0.96,267
35429,Samuel,3,Private room,55,1,4.81,56
35430,Ram Anthonie,1,Private room,85,0,2.6,85
35431,V,1,Entire home/apt,200,11,2.02,211
35432,Justin,2,Entire home/apt,100,0,1.74,100
35433,Nina,2,Private room,59,60,3.07,119
35434,Pm,4,Private room,68,347,1.55,415
35435,Minying,3,Private room,65,335,0.61,400
35436,Hugo,2,Entire home/apt,380,0,0.11,380
35437,Michael,1,Entire home/apt,165,0,0.53,165
35439,Prav,1,Private room,45,86,6.99,131
35440,Jeff,1,Private room,79,61,5.75,140
35441,Sonder,1,Entire home/apt,244,240,0.3,484
35443,Melissa,2,Private room,65,288,2.16,353
35445,Jesse,1,Private room,80,181,1.0,261
35446,Edgard,3,Entire home/apt,200,0,0.11,200
35448,Yordanos,2,Private room,37,0,0.19,37
35449,Brian,2,Private room,40,343,2.08,383
35450,Chris,1,Entire home/apt,280,70,1.06,350
35451,Jonathan,2,Private room,99,0,3.06,99
35452,Kay,2,Entire home/apt,160,167,0.29,327
35453,Tyson,2,Entire home/apt,275,0,0.11,275
35454,Alexandra,3,Private room,65,0,1.51,65
35455,Claire,2,Entire home/apt,104,0,1.05,104
35456,Gail,3,Entire home/apt,60,42,4.98,102
35459,Selma,1,Entire home/apt,250,25,2.75,275
35460,Jessi,1,Private room,66,5,2.23,71
35461,Danila,2,Private room,85,257,1.45,342
35462,Tong,2,Shared room,25,16,1.91,41
35463,Camille,1,Private room,140,0,0.39,140
35464,Tong,2,Shared room,25,23,2.57,48
35465,Andi,3,Entire home/apt,100,26,0.19,126
35466,Martha Liliana,3,Private room,75,363,0.1,438
35467,Tong,2,Shared room,25,2,2.52,27
35468,Marina,1,Entire home/apt,150,287,0.37,437
35470,Wendy,2,Entire home/apt,134,34,3.4,168
35471,Apostle John,3,Private room,100,365,0.1,465
35472,Katherine,3,Private room,140,79,0.45,219
35473,Apostle John,3,Private room,95,90,0.11,185
35475,Katelyn,1,Private room,100,0,1.55,100
35476,Sara,3,Entire home/apt,190,0,0.16,190
35477,Ben,2,Entire home/apt,240,0,0.1,240
35478,Richard,2,Entire home/apt,102,0,2.0,102
35479,Naomi,2,Private room,40,310,1.84,350
35480,Jessica,1,Entire home/apt,120,1,0.49,121
35481,Hiroki,3,Private room,43,0,0.28,43
35482,Julianne,1,Entire home/apt,375,289,0.55,664
35483,Aj,3,Entire home/apt,156,0,0.88,156
35484,Nazanin,2,Entire home/apt,100,33,0.24,133
35485,Amita,1,Entire home/apt,199,0,0.58,199
35486,Wendy,2,Entire home/apt,115,168,3.49,283
35487,Jean,2,Shared room,50,179,0.11,229
35488,Ronald,2,Private room,109,179,1.58,288
35489,Ronald,2,Private room,99,179,2.36,278
35490,Adham,2,Private room,76,52,5.04,128
35491,Ade,3,Entire home/apt,185,146,2.9,331
35493,Juline,1,Entire home/apt,150,43,0.6,193
35494,Florence,1,Entire home/apt,225,326,0.95,551
35495,Jewel,2,Private room,70,51,3.0,121
35497,Camilo,4,Private room,40,8,0.11,48
35498,Mariana,2,Private room,85,0,0.1,85
35500,Olayode,3,Private room,50,155,4.57,205
35501,Sarah,1,Entire home/apt,150,53,0.41,203
35502,Melissa,2,Entire home/apt,200,362,0.24,562
35503,James,1,Private room,57,13,5.9,70
35505,James,1,Shared room,45,22,5.61,67
35506,Soheil,2,Entire home/apt,90,0,0.81,90
35507,Howard,3,Entire home/apt,90,193,1.38,283
35508,Prez,1,Entire home/apt,160,10,0.22,170
35510,James,3,Private room,63,74,1.18,137
35511,François,2,Entire home/apt,180,15,0.21,195
35512,Rushella,2,Private room,100,89,0.2,189
35514,Evelyn,3,Private room,42,244,1.14,286
35515,Grayson,1,Entire home/apt,160,6,0.65,166
35516,Brad,1,Entire home/apt,430,365,1.06,795
35517,Ms. Debra,3,Entire home/apt,83,48,2.82,131
35518,Ruben,1,Private room,95,137,1.39,232
35519,Maria,2,Entire home/apt,75,19,1.48,94
35520,Mike,1,Private room,48,176,1.09,224
35521,Joe,3,Entire home/apt,150,317,2.69,467
35522,Jeremy,2,Entire home/apt,200,0,1.72,200
35523,Jean,1,Private room,150,112,1.8,262
35525,Studioplus,1,Entire home/apt,260,276,0.84,536
35526,Ashton,2,Private room,34,1,6.84,35
35527,John,2,Private room,85,90,1.04,175
35528,Kam,3,Entire home/apt,179,0,5.74,179
35529,Sophia,2,Entire home/apt,88,362,3.77,450
35530,Zineb,2,Private room,60,38,0.61,98
35531,Steve,4,Private room,50,22,0.87,72
35532,Steve,4,Private room,85,365,0.49,450
35533,Cen,3,Private room,56,45,2.0,101
35534,Jaime,2,Entire home/apt,75,20,9.36,95
35535,Francisca,2,Private room,69,359,1.48,428
35536,Tamara,3,Private room,95,0,0.47,95
35537,Cen,3,Private room,120,0,3.85,120
35538,Cen,3,Private room,55,0,1.84,55
35539,Martin,3,Entire home/apt,261,240,1.47,501
35540,Adriana,4,Private room,100,49,3.69,149
35541,Joshua,1,Private room,120,4,5.81,124
35542,Bobbi,2,Private room,100,0,0.1,100
35543,Desmond,3,Private room,250,365,0.2,615
35544,Fiona,1,Private room,62,265,0.45,327
35546,Candace,2,Private room,89,365,1.73,454
35548,Sarah,1,Entire home/apt,225,128,3.46,353
35549,Amparo,2,Private room,75,88,0.11,163
35550,Amy,2,Entire home/apt,140,125,5.02,265
35551,Kizzie,2,Entire home/apt,85,0,0.62,85
35552,Maya,2,Private room,58,6,2.62,64
35553,Hattie Grace,1,Private room,195,0,1.37,195
35554,Michael,2,Private room,89,247,0.99,336
35555,Ade,2,Private room,50,179,2.49,229
35556,Talia,3,Entire home/apt,75,361,3.01,436
35557,Fran,1,Private room,95,0,1.11,95
35559,John,1,Private room,75,352,0.51,427
35561,Martha Liliana,3,Private room,60,325,0.4,385
35562,Jelani,2,Entire home/apt,119,9,0.71,128
35563,Darry,2,Private room,60,364,0.53,424
35564,Karen,2,Entire home/apt,99,3,0.32,102
35565,May,2,Private room,75,167,0.63,242
35566,Sixta,2,Private room,32,27,5.62,59
35567,Lyndon & Christine,1,Entire home/apt,250,0,0.12,250
35568,Dadrine,2,Private room,65,365,0.49,430
35569,Agustina,3,Shared room,40,165,1.76,205
35570,Jon,1,Private room,100,3,0.63,103
35571,Steve,1,Private room,149,337,1.62,486
35572,Gregory,1,Entire home/apt,199,62,5.18,261
35573,Felix,1,Entire home/apt,500,179,0.13,679
35574,Kimberlee,1,Entire home/apt,249,363,0.12,612
35575,Elena,1,Entire home/apt,140,8,0.64,148
35576,Jillian,1,Entire home/apt,145,5,0.57,150
35577,Xander,1,Entire home/apt,95,140,1.62,235
35578,Danny,2,Private room,90,73,0.42,163
35579,Piret,1,Entire home/apt,300,12,0.71,312
35580,Enzo,1,Private room,115,0,0.59,115
35581,Desmar,4,Entire home/apt,102,288,2.76,390
35582,Janilssa,1,Private room,60,359,0.39,419
35583,Courtney,2,Private room,75,1,1.24,76
35584,Tj,1,Entire home/apt,75,69,0.88,144
35585,Raz,1,Private room,86,87,0.69,173
35586,KImberly,3,Shared room,65,179,0.42,244
35587,Ely,2,Entire home/apt,149,83,2.22,232
35588,Heather Marie,2,Private room,50,0,0.53,50
35589,Fernando,3,Entire home/apt,90,0,0.82,90
35590,Olivier & Priscilla,3,Private room,50,0,0.53,50
35591,Noah And Jordan,2,Entire home/apt,215,13,1.45,228
35592,Brandywine,1,Entire home/apt,250,37,0.8,287
35594,Allison,2,Entire home/apt,350,319,1.53,669
35595,Nma,3,Private room,66,0,0.94,66
35596,Darian,1,Private room,85,364,0.9,449
35597,Blan,1,Private room,52,310,1.1,362
35598,Julia,3,Entire home/apt,78,0,0.44,78
35599,Oliver,2,Private room,48,0,0.49,48
35600,Lucky,3,Entire home/apt,268,5,0.76,273
35601,Caterina,2,Entire home/apt,10,0,0.51,10
35602,Lucky,3,Entire home/apt,268,173,1.0,441
35603,Rory,1,Private room,149,109,3.94,258
35604,Meenakshi,1,Private room,75,0,0.3,75
35605,Sam,2,Entire home/apt,250,0,0.2,250
35606,Ryan,3,Private room,75,341,0.2,416
35607,Daniel,2,Private room,56,0,0.11,56
35608,Jivani,2,Entire home/apt,125,70,0.48,195
35609,Livinus,4,Private room,35,150,2.38,185
35610,Alyona,1,Private room,130,147,1.13,277
35611,Ivy,1,Private room,105,176,4.24,281
35612,Shama,2,Entire home/apt,75,258,7.58,333
35613,Charmine,2,Entire home/apt,325,124,1.56,449
35614,Amanda,2,Private room,70,0,0.82,70
35615,Najah,1,Entire home/apt,125,0,0.52,125
35616,Jennifer,2,Private room,40,334,1.68,374
35617,Lucy,2,Entire home/apt,245,280,1.11,525
35618,Doreen,2,Private room,75,309,8.31,384
35619,Sean,2,Private room,48,0,2.8,48
35620,Roberta,3,Entire home/apt,50,356,1.53,406
35621,Sahar,1,Entire home/apt,115,192,0.53,307
35622,Maryam,2,Entire home/apt,197,104,4.86,301
35624,Maria,1,Private room,99,351,6.55,450
35625,Willy,1,Entire home/apt,220,230,1.29,450
35626,Julian,1,Private room,106,0,2.83,106
35627,Katy,1,Entire home/apt,140,0,0.44,140
35628,Robert & Nira,1,Entire home/apt,199,8,0.22,207
35629,Jen,1,Entire home/apt,345,262,3.44,607
35630,Freda,3,Entire home/apt,600,272,0.25,872
35631,Elvis,1,Entire home/apt,300,14,5.96,314
35632,Arkell,2,Entire home/apt,200,0,1.3,200
35633,Jimmy,3,Private room,70,347,0.7,417
35634,Joshua,1,Entire home/apt,149,3,1.95,152
35635,Rem,4,Shared room,28,60,1.93,88
35636,Jamie,3,Entire home/apt,125,0,2.74,125
35637,Brian,2,Private room,65,339,2.35,404
35638,Marie,2,Private room,75,0,1.05,75
35639,Jayden & Minea,2,Private room,50,15,3.98,65
35641,Suzi,2,Private room,60,0,0.39,60
35642,Nicole,2,Private room,48,0,0.1,48
35643,Peter,2,Private room,90,179,0.11,269
35644,Tiba,1,Private room,85,0,2.87,85
35645,Sofia,3,Private room,70,156,0.62,226
35646,George & Kevin,3,Entire home/apt,100,0,1.21,100
35647,Elsa,2,Entire home/apt,135,0,1.75,135
35648,Michael,2,Private room,97,0,0.21,97
35649,Valerie,1,Entire home/apt,590,42,4.33,632
35650,Andrew,2,Entire home/apt,320,78,0.16,398
35651,Aliu,2,Private room,200,85,0.53,285
35652,Anting,2,Private room,99,365,0.51,464
35653,Lilly Rose,4,Private room,28,123,2.65,151
35654,Robertina,3,Private room,55,112,2.28,167
35655,Ramon,1,Entire home/apt,350,74,4.29,424
35656,Dawn,1,Entire home/apt,115,0,0.12,115
35657,Naftaly,2,Entire home/apt,180,109,1.31,289
35658,Daisy,2,Private room,65,204,2.34,269
35659,Waise Omid,1,Entire home/apt,200,129,1.51,329
35660,David,3,Private room,49,196,4.64,245
35661,Rosi,2,Entire home/apt,100,106,1.2,206
35662,Genenne,2,Entire home/apt,115,0,0.82,115
35663,Willy,1,Private room,80,238,1.29,318
35664,Michelle,1,Entire home/apt,59,24,0.44,83
35665,Willy,1,Private room,70,230,1.71,300
35666,Chris,2,Private room,100,88,0.52,188
35667,Willy,1,Private room,70,238,1.4,308
35668,Oliver,2,Private room,63,0,0.14,63
35669,John,1,Private room,120,351,0.21,471
35670,Alex,1,Entire home/apt,269,49,2.6,318
35671,Robertina,3,Private room,55,149,2.96,204
35672,Rebeca,2,Private room,70,97,0.45,167
35673,Carol,1,Entire home/apt,600,280,3.46,880
35674,Roland,3,Private room,60,363,2.16,423
35675,John,1,Entire home/apt,80,41,2.98,121
35676,Madelyn,2,Entire home/apt,115,95,0.44,210
35677,MateusDaniela,2,Private room,45,327,3.63,372
35678,Isaura,2,Private room,63,7,2.48,70
35679,MateusDaniela,2,Private room,47,303,3.63,350
35680,Catarina,1,Entire home/apt,300,14,0.31,314
35681,Sacha,1,Entire home/apt,169,280,0.7,449
35682,Ayodele,3,Private room,50,71,1.79,121
35683,Elmie,2,Private room,274,0,0.31,274
35684,Nayira,2,Entire home/apt,110,19,2.22,129
35685,Blueground,1,Entire home/apt,263,327,0.12,590
35686,Nicole,1,Private room,75,66,0.4,141
35687,Matthew,1,Entire home/apt,250,156,0.11,406
35688,Ms. Debra,3,Private room,83,26,0.26,109
35689,Jonathan,1,Entire home/apt,225,0,1.2,225
35690,Alison,2,Private room,175,0,0.3,175
35691,Meghann,3,Entire home/apt,125,0,0.42,125
35692,Allen,2,Private room,70,47,3.83,117
35693,Michelle,1,Entire home/apt,154,0,0.77,154
35694,Rem,4,Shared room,28,83,1.79,111
35695,Andrea,1,Entire home/apt,1500,32,1.86,1532
35696,Drew,2,Private room,95,0,0.91,95
35697,Rem,4,Shared room,28,89,3.09,117
35698,Jon,2,Private room,75,0,0.72,75
35699,Rem,4,Shared room,28,0,1.7,28
35700,Samridhi,2,Entire home/apt,125,0,0.21,125
35702,Desmond,3,Private room,180,180,0.33,360
35703,Desmond,3,Private room,200,179,0.22,379
35704,Michael Dan,1,Private room,115,0,0.61,115
35705,Samantha,1,Private room,135,0,1.73,135
35706,Al,2,Private room,69,36,2.75,105
35707,Mohd Tahmid,3,Entire home/apt,99,31,9.63,130
35708,Sophie,3,Entire home/apt,80,0,0.21,80
35709,Rebecca,2,Entire home/apt,150,0,0.11,150
35711,Edlyne,3,Entire home/apt,150,175,2.34,325
35712,Vik,3,Entire home/apt,134,163,0.93,297
35713,Vik,3,Entire home/apt,134,144,1.1,278
35714,Mollie,2,Entire home/apt,145,0,1.45,145
35715,Rubi&Danny,1,Entire home/apt,189,180,4.49,369
35716,Stav,1,Private room,120,0,0.33,120
35717,Sherry,3,Private room,65,23,1.67,88
35718,Angela,3,Entire home/apt,280,294,3.34,574
35719,Francesca,1,Private room,100,0,0.1,100
35720,Haruhisa,3,Private room,40,1,0.29,41
35721,Monze,1,Private room,120,264,3.74,384
35722,Monze,1,Private room,130,277,4.87,407
35723,Gregory,1,Entire home/apt,180,24,4.69,204
35724,Ociel,4,Private room,55,76,3.31,131
35725,Donald,2,Entire home/apt,175,69,3.51,244
35726,Elizabeth,1,Private room,36,284,0.47,320
35727,Iara,3,Private room,50,155,1.0,205
35728,Steph,1,Entire home/apt,165,0,0.42,165
35729,Ameera,1,Private room,90,56,0.52,146
35730,Pavel And Sarah,3,Private room,65,6,6.34,71
35731,Margaret,2,Entire home/apt,175,54,1.23,229
35732,Tae,1,Private room,110,38,4.66,148
35734,Giorgio,1,Entire home/apt,300,82,0.94,382
35735,Pranjal,1,Entire home/apt,175,342,1.0,517
35736,Md,3,Entire home/apt,150,78,7.55,228
35737,Karen,3,Entire home/apt,100,76,5.31,176
35738,Stella,1,Private room,68,21,2.84,89
35739,Feliz,1,Private room,120,16,4.37,136
35740,Una,2,Entire home/apt,99,1,0.46,100
35742,Evelyn,2,Entire home/apt,110,63,3.04,173
35743,James,1,Entire home/apt,84,257,2.53,341
35744,Raj,3,Private room,60,157,1.09,217
35745,Brittanie,3,Private room,100,0,0.3,100
35746,Brian,2,Private room,65,351,2.59,416
35748,Brian,2,Private room,65,348,2.46,413
35749,Brian,2,Private room,65,359,2.96,424
35750,Camorine,3,Private room,50,232,8.02,282
35751,Fiona,1,Private room,70,340,0.59,410
35752,Mohamed,1,Private room,120,89,0.73,209
35753,Sam,2,Private room,70,18,0.2,88
35754,Sata,3,Private room,225,364,0.11,589
35755,Allen,2,Private room,70,55,5.03,125
35756,Iara,3,Private room,45,132,0.35,177
35757,Alina,1,Private room,105,26,3.41,131
35758,Sophie & Grégoire,2,Private room,175,17,0.89,192
35759,Allen,2,Private room,98,25,0.89,123
35761,Samantha,4,Shared room,55,83,0.31,138
35762,Tom,1,Entire home/apt,110,0,0.4,110
35763,Lawrence,2,Private room,55,36,0.96,91
35764,Antoinette,2,Entire home/apt,95,26,4.18,121
35765,Javier,1,Private room,130,38,4.16,168
35766,JoAnn,3,Entire home/apt,80,109,0.44,189
35767,Megan,2,Private room,100,330,0.92,430
35768,Danite,2,Private room,70,0,0.21,70
35769,Milly & George,3,Entire home/apt,160,361,1.31,521
35770,Nima,2,Private room,85,240,2.91,325
35771,Elireth,3,Private room,45,324,0.4,369
35772,Qasim,2,Private room,71,0,0.81,71
35773,Angel,3,Entire home/apt,170,238,3.32,408
35774,Jackie,3,Private room,65,90,0.52,155
35775,Han,3,Private room,65,356,1.95,421
35776,Gina,3,Entire home/apt,100,36,2.92,136
35779,Roman,1,Entire home/apt,449,326,2.36,775
35780,Michelle,3,Private room,50,358,5.1,408
35781,Joe,3,Entire home/apt,150,309,2.91,459
35782,Terrence And Teresa,2,Entire home/apt,101,170,4.19,271
35783,Rita,3,Private room,69,74,0.23,143
35784,Natalie,3,Private room,57,65,0.66,122
35785,Iva,2,Entire home/apt,190,179,1.2,369
35786,Michael,1,Entire home/apt,325,83,0.83,408
35787,Mel,1,Entire home/apt,200,0,0.81,200
35788,Jessica,1,Entire home/apt,250,63,0.52,313
35789,Fengxiang,5,Entire home/apt,71,0,1.01,71
35790,Amo,2,Entire home/apt,190,4,0.21,194
35791,Alex,1,Private room,109,0,0.21,109
35792,John Drue,2,Private room,35,0,0.53,35
35794,Timothy,1,Private room,130,0,1.56,130
35795,Adele,1,Private room,149,75,3.21,224
35796,Guadalupe,2,Entire home/apt,59,173,2.63,232
35797,Elireth,3,Private room,45,324,0.31,369
35798,Peter,3,Private room,70,74,3.95,144
35799,Jany,3,Private room,75,164,0.42,239
35800,Lloyd,3,Private room,120,57,3.21,177
35801,Catarina,1,Private room,126,15,1.0,141
35802,Artem,2,Entire home/apt,207,271,3.08,478
35803,Khaula,2,Private room,70,8,4.33,78
35804,Martin,3,Private room,90,319,1.1,409
35805,Michelle,3,Entire home/apt,64,259,3.47,323
35806,John,2,Private room,40,95,2.69,135
35807,Sophie And Linda,3,Entire home/apt,300,298,3.83,598
35808,Tina,3,Private room,55,184,1.92,239
35809,James,1,Entire home/apt,800,90,3.88,890
35810,Monica,3,Private room,120,362,0.1,482
35811,Myra,2,Private room,66,74,1.0,140
35812,Katie,1,Private room,100,58,1.7,158
35813,Kazuya,3,Private room,38,247,0.39,285
35814,Ashley And Cayla,2,Entire home/apt,750,179,0.64,929
35816,Natalia,2,Private room,99,221,1.32,320
35817,Yoo MI,2,Private room,110,234,1.96,344
35818,John,1,Entire home/apt,225,188,0.23,413
35819,Olga,5,Private room,41,0,0.71,41
35820,Emilio,2,Entire home/apt,120,231,0.31,351
35821,Jose,4,Private room,37,332,1.42,369
35822,Yun,1,Private room,179,349,0.97,528
35823,Han,3,Private room,75,342,1.84,417
35824,Megan,2,Private room,63,0,0.85,63
35825,Han,3,Private room,65,341,1.49,406
35826,Kin,2,Private room,55,361,3.1,416
35827,Freddy,2,Private room,67,329,3.59,396
35828,Steve,1,Entire home/apt,255,0,0.65,255
35829,Han,3,Private room,65,355,2.8,420
35830,Glenis,1,Entire home/apt,325,0,0.2,325
35831,Roman,1,Entire home/apt,389,339,0.83,728
35832,Tyler,2,Private room,40,34,0.84,74
35833,Stella,3,Private room,44,52,5.38,96
35834,Tyler,2,Private room,40,37,0.27,77
35836,Cathal,1,Entire home/apt,285,7,0.1,292
35837,David,1,Entire home/apt,200,42,2.4,242
35838,Greg,2,Entire home/apt,75,0,0.44,75
35839,Matthew,1,Entire home/apt,230,4,0.64,234
35840,Lizania,2,Entire home/apt,80,14,0.44,94
35841,John,1,Private room,99,352,0.59,451
35842,Darry,2,Shared room,30,365,1.0,395
35843,Lore,2,Entire home/apt,145,1,0.53,146
35844,Jolie,2,Entire home/apt,150,132,0.93,282
35845,DuChess,3,Private room,41,163,3.99,204
35846,Minying,3,Private room,65,334,0.5,399
35847,Jonathan,1,Private room,150,66,4.26,216
35848,Lisa,1,Entire home/apt,145,0,0.29,145
35849,Lindsay,2,Private room,50,0,0.32,50
35850,Jesse,2,Entire home/apt,185,0,1.67,185
35851,Nubia,3,Private room,65,254,0.43,319
35852,Courtney,1,Entire home/apt,150,0,0.21,150
35853,Martin,3,Entire home/apt,260,267,1.71,527
35854,Kerem,1,Entire home/apt,125,70,1.76,195
35855,Petrina,1,Entire home/apt,199,22,8.72,221
35856,Edna,4,Private room,45,161,3.07,206
35857,Elenora And Jason,2,Private room,37,38,2.84,75
35858,Brian,1,Entire home/apt,500,357,0.93,857
35859,Tae,1,Private room,100,169,5.15,269
35860,Bojan,1,Private room,100,6,4.32,106
35861,Alicia,4,Private room,42,109,2.54,151
35863,Andres,2,Entire home/apt,85,208,4.51,293
35864,Adama,4,Private room,50,325,5.17,375
35865,Inho,1,Entire home/apt,575,46,4.43,621
35866,Sean,2,Private room,85,173,5.4,258
35869,Kazuya,3,Private room,50,269,0.5,319
35871,Mohammed,3,Entire home/apt,166,280,3.52,446
35872,Han,3,Shared room,39,344,1.96,383
35873,Mariana,1,Entire home/apt,97,8,1.0,105
35874,Christa,2,Entire home/apt,200,0,0.3,200
35875,Kesha,2,Entire home/apt,155,0,1.25,155
35876,Eliran,2,Entire home/apt,220,16,0.32,236
35877,Patrick,2,Private room,75,0,0.32,75
35879,Scott,2,Entire home/apt,195,67,3.01,262
35880,Elisha,2,Entire home/apt,125,139,4.55,264
35881,Jeff,3,Private room,45,45,5.39,90
35882,William,1,Private room,425,0,0.53,425
35883,Madeleine,2,Entire home/apt,90,122,4.1,212
35884,Carine,2,Private room,95,0,0.62,95
35885,Michelene,1,Entire home/apt,100,18,2.12,118
35886,Erasmo,3,Private room,100,0,1.42,100
35888,Candace,2,Private room,89,365,0.59,454
35889,Anthony,2,Entire home/apt,400,30,2.62,430
35890,Hattie Grace,1,Entire home/apt,403,0,0.45,403
35891,Sam,1,Entire home/apt,325,319,3.67,644
35893,Meng,1,Entire home/apt,135,7,1.38,142
35894,Matilde,4,Private room,26,3,2.07,29
35895,Dave + Suzanne,2,Entire home/apt,330,18,1.05,348
35896,Bianca,1,Private room,200,332,0.83,532
35897,Siyi,2,Entire home/apt,139,118,0.86,257
35898,Chris,2,Private room,50,4,0.91,54
35899,Diana,2,Entire home/apt,125,0,0.23,125
35900,Leah,1,Entire home/apt,350,331,0.26,681
35901,Yngrid And Jiovanni,2,Entire home/apt,175,285,2.89,460
35903,Leo,2,Private room,130,212,0.32,342
35904,Anna,1,Entire home/apt,150,0,0.76,150
35905,Christina,2,Entire home/apt,120,4,1.18,124
35906,Brit,2,Entire home/apt,150,2,1.45,152
35907,Steven,2,Entire home/apt,180,5,0.53,185
35908,Erica,2,Private room,105,55,7.34,160
35909,Bladimil,2,Private room,63,365,0.31,428
35910,Kennyd,1,Entire home/apt,300,154,6.31,454
35911,Franco,2,Entire home/apt,70,0,0.5,70
35912,Olena,1,Entire home/apt,250,0,0.21,250
35914,Marissa,2,Private room,43,179,0.68,222
35915,Andrea,2,Private room,40,63,3.74,103
35916,Labeat,1,Entire home/apt,471,188,0.42,659
35917,John,2,Private room,40,180,0.95,220
35920,Martha,1,Entire home/apt,1000,66,1.97,1066
35921,Jess,2,Entire home/apt,94,0,0.83,94
35922,Meg,2,Entire home/apt,750,365,0.67,1115
35923,Xiaowen,2,Private room,69,0,1.11,69
35924,Paul,3,Entire home/apt,150,0,0.32,150
35925,Mr. G,2,Private room,80,354,1.28,434
35926,Roman,1,Entire home/apt,399,229,1.48,628
35927,Kathleen,1,Private room,95,90,1.9,185
35928,Diego,2,Entire home/apt,52,0,3.47,52
35929,Rebecca,1,Entire home/apt,150,179,0.32,329
35930,Rose,3,Private room,65,89,1.06,154
35931,Javier & Jorge,2,Private room,60,0,0.52,60
35932,Hawk,3,Private room,55,138,2.04,193
35933,Hawk,3,Private room,49,106,1.44,155
35935,Sonder,1,Entire home/apt,249,220,0.1,469
35936,Kathleen,1,Private room,100,90,1.18,190
35937,Ali,2,Private room,60,340,1.75,400
35938,Kin,2,Private room,59,352,3.79,411
35939,Jackie,3,Private room,65,90,0.22,155
35940,Ally,2,Private room,120,37,2.46,157
35941,Maria Fernanda,2,Private room,45,57,0.85,102
35942,Angie,1,Private room,150,58,3.69,208
35943,Gúney,1,Shared room,90,169,1.11,259
35944,Simon,2,Entire home/apt,140,14,0.83,154
35945,Sanjeev,2,Private room,50,0,0.1,50
35946,Omar,1,Private room,70,66,5.54,136
35947,Dan,2,Entire home/apt,90,0,0.44,90
35948,Hannah,1,Private room,125,0,1.01,125
35949,Bill,3,Entire home/apt,150,97,7.24,247
35950,Jamie,1,Private room,150,45,0.26,195
35951,Thirza,1,Private room,98,0,0.8,98
35952,Ivy,1,Private room,120,180,3.79,300
35953,Ruben,2,Entire home/apt,100,0,1.76,100
35954,Joseph,2,Entire home/apt,110,15,0.93,125
35955,Boris,1,Entire home/apt,250,301,4.62,551
35956,Charlie And Selena,2,Private room,65,348,2.93,413
35957,Charlie And Selena,2,Private room,65,349,2.82,414
35958,Charlie And Selena,2,Private room,50,362,2.48,412
35959,Charlie And Selena,2,Private room,65,362,2.8,427
35960,Gaurab,3,Private room,35,16,2.23,51
35961,Magdalena,2,Entire home/apt,160,48,2.38,208
35963,Keanna,1,Private room,200,38,2.35,238
35964,Stella,4,Entire home/apt,60,208,2.29,268
35965,Colleen,2,Private room,53,11,0.11,64
35966,Kazuya,3,Private room,38,201,0.3,239
35967,Brian,2,Private room,99,0,1.2,99
35970,Ana,3,Entire home/apt,65,123,4.44,188
35971,Tal & Amarelle,2,Entire home/apt,110,156,0.51,266
35972,Ny,2,Entire home/apt,140,134,2.33,274
35973,Christine,3,Entire home/apt,175,112,0.11,287
35974,Tal & Amarelle,2,Entire home/apt,115,212,0.32,327
35975,Jirayus,1,Entire home/apt,199,200,4.29,399
35976,Eva,1,Private room,60,8,4.97,68
35977,Vitaly,2,Private room,50,0,0.54,50
35978,Nancy,1,Private room,78,38,1.0,116
35979,Kate,2,Private room,70,37,1.06,107
35981,Shola,2,Private room,125,281,0.31,406
35982,Andrew,3,Private room,35,233,3.35,268
35983,Jacqueline,3,Private room,54,35,2.83,89
35984,Jo,3,Private room,175,39,0.16,214
35985,Julia,1,Entire home/apt,500,362,0.7,862
35986,Jessy & Christian,3,Shared room,25,330,1.77,355
35987,Jessy & Christian,3,Shared room,26,352,2.58,378
35988,Suleidy,3,Entire home/apt,63,129,4.52,192
35989,Kay,1,Entire home/apt,127,0,1.78,127
35991,Sonder,1,Entire home/apt,225,332,0.79,557
35993,Magdalena,2,Private room,60,162,2.07,222
35994,Russ,2,Private room,47,362,0.42,409
35995,Rachele,2,Entire home/apt,195,0,0.19,195
35996,Joana,1,Private room,355,308,1.49,663
35997,Arq,3,Shared room,70,365,0.32,435
35998,Melissa,2,Shared room,39,365,1.33,404
35999,Hiroki,3,Private room,35,32,0.56,67
36000,Melissa,2,Shared room,39,343,0.62,382
36002,Dion,4,Entire home/apt,90,301,6.8,391
36004,Melissa,2,Shared room,39,359,1.36,398
36005,Melissa,2,Shared room,39,365,1.36,404
36006,Mel,1,Entire home/apt,165,87,0.88,252
36007,Nina,3,Private room,45,248,0.48,293
36008,Muneeb,5,Entire home/apt,200,244,1.0,444
36009,Savannah,2,Private room,80,325,0.15,405
36010,Mr. G,2,Private room,65,365,2.26,430
36011,Marina,3,Private room,70,63,0.68,133
36012,Shareef,1,Private room,53,299,3.88,352
36013,Gulshan,4,Entire home/apt,87,326,5.61,413
36014,Magdalena,2,Private room,50,169,2.28,219
36015,Magdalena,2,Private room,55,161,1.87,216
36016,Guy,1,Entire home/apt,240,0,0.24,240
36017,Frederik,1,Private room,120,25,0.6,145
36018,Sunny,3,Entire home/apt,225,49,4.01,274
36019,Tanya,1,Private room,89,179,1.56,268
36020,Damon,2,Private room,65,254,9.41,319
36021,Regina,2,Private room,75,20,3.45,95
36022,Vanessa,2,Entire home/apt,108,46,8.4,154
36023,Andres,3,Private room,75,3,0.82,78
36024,Maneh,1,Private room,150,124,3.46,274
36026,Elliot,1,Private room,150,0,2.97,150
36027,Michael,2,Entire home/apt,89,23,4.88,112
36028,Joe,2,Entire home/apt,180,0,0.98,180
36031,Siyi,2,Entire home/apt,139,7,1.05,146
36032,Erin,2,Entire home/apt,89,0,0.73,89
36033,Micheline,3,Entire home/apt,70,323,1.31,393
36034,Troy,2,Entire home/apt,99,87,2.23,186
36035,Sophie,1,Private room,150,243,4.15,393
36037,Grace,2,Private room,69,174,0.62,243
36038,Sophie,1,Private room,145,256,4.25,401
36040,Jessica,1,Private room,55,0,0.33,55
36041,Simone,2,Private room,99,0,0.92,99
36042,Bret,1,Entire home/apt,209,1,5.82,210
36044,Nadira,3,Private room,55,89,2.13,144
36045,Chai,3,Private room,69,0,0.33,69
36046,Shawn,4,Private room,47,347,1.62,394
36047,Elizabeth,1,Private room,65,255,2.47,320
36048,Padraig,2,Private room,65,31,0.74,96
36049,Sanyam,1,Entire home/apt,108,0,0.62,108
36050,Alessandro,2,Private room,70,3,1.52,73
36051,Samantha,2,Private room,60,0,1.62,60
36054,Elizabeth,1,Private room,70,236,0.14,306
36055,Joseph,2,Entire home/apt,500,247,1.32,747
36056,Elizabeth,2,Private room,95,1,3.38,96
36057,DuChess,3,Private room,41,351,2.47,392
36060,Tarun,1,Entire home/apt,145,0,0.53,145
36061,Nina,2,Private room,55,342,0.45,397
36062,Jay,3,Entire home/apt,95,31,1.31,126
36064,Nina,2,Private room,55,358,0.58,413
36066,Nina,2,Private room,50,184,1.0,234
36067,Nina,2,Private room,55,339,0.15,394
36068,Petera,2,Private room,60,251,2.14,311
36070,Nina,2,Private room,55,365,0.3,420
36071,Nina,2,Private room,50,319,0.47,369
36073,Erik,1,Private room,59,247,2.99,306
36074,Sofia,2,Entire home/apt,200,0,0.52,200
36075,Marcela,2,Private room,85,177,0.12,262
36076,John,1,Private room,120,365,0.44,485
36077,Sixta,2,Private room,39,60,5.63,99
36078,Thomas,2,Private room,65,88,0.65,153
36079,Omoti,2,Private room,80,5,1.15,85
36080,Bryan,2,Private room,46,341,1.41,387
36081,Nicole And Adrian,2,Entire home/apt,80,0,0.33,80
36082,Monze,1,Private room,135,267,3.79,402
36084,Shimin,2,Private room,26,141,1.36,167
36085,Brenda,1,Entire home/apt,170,0,3.13,170
36087,Farah,5,Private room,55,302,4.97,357
36088,Mike,2,Entire home/apt,105,0,6.02,105
36089,Mehdi,2,Private room,95,179,1.3,274
36090,Tosin/Rashon,1,Private room,95,0,4.46,95
36091,Eufemia,2,Private room,40,365,3.93,405
36092,Navin,2,Entire home/apt,100,255,2.79,355
36093,Kaz,2,Private room,60,57,2.31,117
36095,Selena,1,Entire home/apt,135,0,0.41,135
36097,Emil,3,Entire home/apt,95,0,1.39,95
36098,Trevor,2,Entire home/apt,110,41,0.96,151
36099,Min,1,Private room,90,283,7.76,373
36100,Jimmy &Cindy,3,Private room,53,359,2.61,412
36101,Sunny,2,Private room,85,365,0.42,450
36102,Eleonora,3,Entire home/apt,100,2,1.03,102
36103,Annick,4,Private room,65,363,5.4,428
36104,Melissa,3,Private room,55,178,1.71,233
36105,Yizak,2,Entire home/apt,85,82,2.26,167
36106,Jacob,1,Entire home/apt,200,1,0.53,201
36107,Cooper,2,Entire home/apt,225,229,3.84,454
36108,Smith,3,Private room,95,24,0.11,119
36109,Bronica,1,Entire home/apt,175,0,0.76,175
36110,Michael,1,Entire home/apt,189,358,0.88,547
36111,Stat,2,Private room,53,304,1.0,357
36114,Ethan,2,Entire home/apt,80,184,0.24,264
36115,Sam,1,Private room,97,10,0.86,107
36116,Sam,1,Private room,79,0,0.23,79
36117,Eric,2,Private room,80,0,0.33,80
36118,Diana,1,Private room,39,0,0.16,39
36119,Eliza,1,Private room,85,165,3.07,250
36120,Joe,2,Entire home/apt,50,0,0.33,50
36121,Janet,1,Private room,330,176,0.48,506
36122,Kazuya,3,Private room,37,252,0.25,289
36123,Roberto,1,Entire home/apt,799,325,0.66,1124
36124,Diane,1,Entire home/apt,150,0,1.29,150
36125,Christiana,2,Entire home/apt,195,199,4.04,394
36126,Eme,3,Private room,50,0,1.46,50
36127,Michael And Lindsey,2,Private room,100,61,2.07,161
36128,Frans,1,Private room,140,149,0.55,289
36129,Antonio,1,Entire home/apt,275,7,0.21,282
36130,Ree,2,Entire home/apt,85,124,0.55,209
36131,Darry,2,Shared room,31,365,0.78,396
36132,Sophie & Max,2,Private room,99,0,1.05,99
36133,John,2,Private room,117,85,0.43,202
36134,Briana,2,Entire home/apt,160,15,5.39,175
36135,Abraham,1,Shared room,65,10,3.44,75
36137,Gregory,2,Entire home/apt,105,269,1.56,374
36138,Vikki,2,Entire home/apt,225,36,3.14,261
36139,Joanna,2,Entire home/apt,245,255,1.94,500
36140,Matt & Quin,2,Entire home/apt,185,33,0.26,218
36141,Mag,1,Entire home/apt,295,17,0.33,312
36143,Selina,2,Entire home/apt,480,63,3.24,543
36144,Emily,2,Entire home/apt,190,88,0.33,278
36145,Kevin,1,Entire home/apt,225,0,0.26,225
36147,Ina,2,Private room,59,45,0.84,104
36151,Mala,2,Private room,60,60,2.46,120
36152,S,1,Entire home/apt,300,0,0.11,300
36153,Lica,1,Entire home/apt,325,180,6.48,505
36154,Bo,1,Private room,100,23,3.42,123
36155,Rose,1,Entire home/apt,355,31,0.64,386
36156,Ling,2,Private room,60,179,0.76,239
36157,Abraham,1,Shared room,65,11,2.8,76
36158,Antonia,3,Entire home/apt,100,65,2.29,165
36159,Jennifer,1,Entire home/apt,99,6,1.38,105
36160,Ling,2,Private room,65,180,1.73,245
36161,Ling,2,Private room,58,364,1.3,422
36162,Gem,1,Shared room,75,52,1.97,127
36164,Josie,2,Private room,50,0,0.86,50
36165,Vance,3,Entire home/apt,50,20,0.46,70
36166,Nidhi,1,Entire home/apt,300,5,0.44,305
36167,Josie,2,Private room,80,65,0.16,145
36168,Jesse,1,Private room,91,0,1.09,91
36169,Sonia,1,Entire home/apt,140,2,3.94,142
36170,Daniela,1,Entire home/apt,199,37,0.66,236
36171,Kaylee,2,Private room,43,311,0.22,354
36172,Ramon,1,Private room,60,0,1.34,60
36173,Pete,3,Private room,200,90,0.69,290
36174,Akshay,1,Private room,50,0,0.22,50
36175,Saki,1,Entire home/apt,75,161,0.32,236
36176,Michael,1,Entire home/apt,150,0,0.12,150
36177,Alex,2,Entire home/apt,99,365,0.11,464
36178,Fernanda,2,Private room,90,63,1.3,153
36179,Fiona,1,Private room,62,345,0.48,407
36181,Jayceon,4,Private room,35,70,3.88,105
36182,Yosub,2,Entire home/apt,105,3,0.11,108
36183,Milan,1,Entire home/apt,175,83,0.58,258
36185,Yana,1,Private room,100,16,0.77,116
36186,Bea,2,Entire home/apt,76,287,3.1,363
36187,Angela,1,Entire home/apt,299,264,4.4,563
36188,Monica,2,Entire home/apt,150,0,0.39,150
36189,Patricia Rose,3,Entire home/apt,80,24,1.25,104
36191,Natassha,2,Private room,80,11,2.73,91
36192,Andrew,1,Entire home/apt,59,0,1.02,59
36193,Papis,2,Entire home/apt,250,2,0.76,252
36194,Carlos A.,2,Private room,100,0,0.1,100
36195,Launa,1,Private room,115,67,0.32,182
36196,Anton,2,Private room,70,32,5.6,102
36197,Studioplus,1,Entire home/apt,500,272,2.07,772
36198,Bryan,2,Private room,46,311,1.05,357
36199,Patrick,2,Entire home/apt,145,0,0.55,145
36200,Jenni & Eric,2,Private room,80,34,5.5,114
36201,Zoe,2,Entire home/apt,65,19,1.46,84
36202,Adriana,3,Private room,40,30,2.27,70
36203,Freddy,3,Entire home/apt,72,98,7.42,170
36204,Bryan,2,Private room,100,305,0.14,405
36205,Nini,1,Entire home/apt,185,331,1.23,516
36206,Roman,1,Entire home/apt,370,316,0.96,686
36207,Bryan,2,Private room,60,347,1.17,407
36208,Bryan,2,Private room,70,267,0.24,337
36209,Jason,2,Private room,53,333,2.49,386
36210,Karina,2,Entire home/apt,110,7,0.82,117
36211,Jason,2,Private room,53,337,2.93,390
36212,Hanna,1,Entire home/apt,59,79,5.05,138
36213,Ryan,1,Private room,79,51,0.85,130
36214,Christine,2,Entire home/apt,150,123,2.44,273
36215,Kate,2,Entire home/apt,200,20,3.44,220
36216,Katie,1,Private room,125,156,0.83,281
36217,Vanessa,2,Entire home/apt,200,136,1.99,336
36218,Rich,1,Entire home/apt,200,274,4.88,474
36219,Cem,2,Private room,60,0,0.47,60
36221,Just,1,Private room,125,68,2.68,193
36222,Janine,2,Private room,70,156,0.21,226
36223,Bella,1,Private room,100,363,0.33,463
36224,Raymond,1,Entire home/apt,359,252,2.06,611
36225,Robert,4,Shared room,40,88,0.23,128
36227,Carla,2,Private room,30,158,0.46,188
36228,Son,1,Private room,120,119,0.37,239
36229,Ellis,2,Entire home/apt,95,0,0.12,95
36230,Carolyn,1,Entire home/apt,125,45,0.27,170
36231,Sophia,1,Entire home/apt,225,6,1.72,231
36232,Jameelah,2,Private room,57,16,2.22,73
36233,Rose,2,Private room,37,364,0.11,401
36234,Ana,1,Entire home/apt,150,0,1.26,150
36235,Jordan,2,Private room,36,0,0.13,36
36236,Jaime,3,Entire home/apt,115,81,3.72,196
36237,Emma,1,Entire home/apt,350,284,3.42,634
36238,Brent,3,Entire home/apt,75,28,15.78,103
36240,Zachary,1,Private room,149,40,0.23,189
36241,Rafic,1,Private room,90,0,0.43,90
36242,Shimin,2,Private room,29,66,1.37,95
36243,Mira,2,Private room,200,65,7.99,265
36244,Vanya,1,Entire home/apt,275,9,0.71,284
36245,Dan,2,Entire home/apt,130,267,5.12,397
36247,Rosemarie,1,Entire home/apt,140,0,0.66,140
36248,Fone,3,Private room,45,21,0.46,66
36249,Deborah,3,Entire home/apt,80,116,1.79,196
36250,Kaitlyn,1,Private room,110,90,0.33,200
36251,Stephany,3,Entire home/apt,68,282,3.6,350
36252,Julian,2,Entire home/apt,275,123,4.54,398
36253,Dylan,2,Entire home/apt,90,0,0.32,90
36254,Hedda,2,Entire home/apt,250,29,0.85,279
36255,Steven,3,Private room,60,84,1.13,144
36256,Timothy,5,Entire home/apt,89,0,2.43,89
36257,Jason,1,Entire home/apt,288,48,4.78,336
36258,Pablo,2,Private room,70,3,0.63,73
36260,Benjamin,4,Entire home/apt,60,279,2.4,339
36261,Ada,1,Private room,100,195,3.35,295
36262,Ramon,1,Private room,60,0,1.75,60
36263,Teres,2,Entire home/apt,99,0,0.13,99
36264,Giana,2,Private room,59,176,3.85,235
36265,Teddy,3,Private room,119,27,2.88,146
36266,Tommy,2,Private room,89,72,3.09,161
36268,Ben,2,Private room,60,36,0.12,96
36269,Aly,1,Entire home/apt,66,5,1.83,71
36270,Kelly,1,Entire home/apt,175,54,0.16,229
36271,Tucker,2,Entire home/apt,150,0,0.8,150
36272,Andrea,1,Entire home/apt,310,8,0.48,318
36273,Alison,2,Private room,70,0,0.45,70
36274,Cleonides,3,Entire home/apt,109,160,1.0,269
36276,Jack,1,Shared room,65,64,2.0,129
36277,Azarii,1,Private room,83,161,2.69,244
36278,Danielle,1,Private room,200,32,2.0,232
36279,Brendan,2,Private room,90,0,2.88,90
36280,Roman,1,Entire home/apt,380,225,1.12,605
36281,Vanya,1,Private room,175,0,0.11,175
36282,Joseph,3,Entire home/apt,46,135,1.96,181
36283,Patrick,2,Private room,50,32,0.35,82
36284,Jci,2,Private room,200,64,0.57,264
36285,Nubia,3,Private room,31,259,0.65,290
36286,Benjamin,2,Private room,59,0,0.66,59
36287,Erica,1,Entire home/apt,180,88,2.95,268
36290,Ali,2,Entire home/apt,160,10,0.69,170
36291,Lauren,1,Private room,72,165,2.23,237
36292,Julie,2,Private room,72,18,3.94,90
36293,Mayan,2,Entire home/apt,210,335,0.32,545
36294,Ikkyukim,4,Private room,40,321,0.36,361
36298,Emanuel & Orion,2,Private room,105,335,1.79,440
36299,Alberto,3,Private room,95,347,1.91,442
36300,Anthony,1,Entire home/apt,235,135,4.19,370
36301,Kseniya,2,Private room,69,4,0.9,73
36302,Analia,2,Private room,70,5,7.18,75
36303,Tatiana,1,Entire home/apt,75,0,0.27,75
36304,David,1,Private room,139,0,1.19,139
36305,Zach,1,Private room,75,0,0.19,75
36306,Hiroki,3,Private room,41,1,0.15,42
36307,NY Blue House,2,Entire home/apt,120,73,3.61,193
36308,Hiroki,3,Private room,55,1,0.32,56
36309,美德,3,Private room,88,210,4.04,298
36310,美德,3,Private room,78,205,3.05,283
36311,美德,3,Private room,58,235,3.85,293
36312,Nancy,1,Private room,85,41,2.27,126
36313,John,1,Private room,150,358,0.99,508
36314,Emily Wes,2,Private room,67,333,3.41,400
36315,Joseph,3,Shared room,51,141,1.84,192
36316,Alexander,2,Private room,99,48,1.41,147
36317,Kdn,1,Private room,99,365,0.4,464
36318,Momoyo,3,Private room,32,35,0.21,67
36319,Joseph,3,Private room,35,143,3.25,178
36320,Ora & Scout,2,Private room,75,12,0.69,87
36321,Lali,2,Entire home/apt,175,122,4.15,297
36323,Momoyo,3,Private room,29,6,1.0,35
36324,Julie,2,Entire home/apt,150,0,0.5,150
36325,Bere,2,Entire home/apt,90,0,2.85,90
36326,Steven,2,Private room,55,365,0.95,420
36327,Nina,5,Shared room,150,312,0.22,462
36328,Mia,2,Private room,90,118,5.79,208
36329,Sarah,1,Private room,140,0,0.22,140
36330,Veronica,3,Private room,65,47,6.19,112
36331,Sonya,2,Private room,57,0,0.12,57
36332,Joseph,3,Private room,50,137,1.78,187
36333,Christopher,4,Entire home/apt,299,1,0.58,300
36334,Christopher,4,Entire home/apt,125,301,0.99,426
36335,Alexa,1,Private room,85,103,4.47,188
36336,Viktoria,1,Private room,80,156,1.3,236
36337,Kelly,2,Entire home/apt,180,0,0.43,180
36338,Timothy,2,Entire home/apt,65,0,0.77,65
36339,Jason,1,Entire home/apt,270,365,1.34,635
36340,Joy,1,Private room,175,1,0.22,176
36341,Monika,1,Entire home/apt,359,23,0.99,382
36342,Anastasia,2,Entire home/apt,100,59,0.22,159
36343,Jodi,1,Entire home/apt,275,0,0.91,275
36344,Moying,1,Private room,185,233,3.9,418
36345,Carol,1,Private room,119,5,2.99,124
36346,Aubeen,4,Private room,90,362,0.22,452
36347,Patrick,1,Entire home/apt,160,275,5.64,435
36349,Jasmine,2,Entire home/apt,149,165,0.55,314
36350,Kathy,2,Private room,57,365,0.27,422
36351,Rose,2,Private room,39,360,0.12,399
36352,Kathy,2,Private room,50,365,0.24,415
36353,Kathy,2,Private room,55,298,0.11,353
36355,Levi,2,Shared room,30,365,0.55,395
36357,Kathy,2,Private room,45,365,0.37,410
36359,Levi,2,Shared room,30,352,0.55,382
36360,Allan,1,Entire home/apt,195,17,2.42,212
36361,Levi,2,Private room,40,364,0.74,404
36362,Ling,2,Private room,60,180,0.98,240
36363,Ling,2,Private room,60,177,1.0,237
36364,Levi,2,Private room,35,364,0.11,399
36366,James,3,Entire home/apt,120,48,4.14,168
36367,Rita,5,Private room,35,360,2.0,395
36368,Rita,5,Private room,35,177,4.89,212
36369,Jinna,1,Entire home/apt,151,0,0.33,151
36370,Sophia,1,Entire home/apt,478,5,0.71,483
36371,Eli,1,Private room,110,66,0.23,176
36372,Alex,1,Private room,85,54,0.79,139
36373,Katrin,1,Private room,250,0,2.55,250
36375,Madeline,2,Private room,200,79,1.09,279
36376,Tessa,1,Entire home/apt,250,0,0.35,250
36377,Steven,2,Entire home/apt,285,6,0.16,291
36378,Neyir,1,Private room,200,313,2.25,513
36379,Erin,2,Entire home/apt,100,55,1.89,155
36380,Gòn,1,Entire home/apt,80,95,1.9,175
36381,Shogo,3,Private room,35,0,0.25,35
36382,Allia,2,Entire home/apt,220,0,0.11,220
36383,Robbie,1,Private room,57,344,2.82,401
36384,Mia,2,Private room,70,146,4.93,216
36385,Vanessa,1,Entire home/apt,299,277,3.75,576
36386,Jason,1,Entire home/apt,145,227,0.16,372
36387,Molly,4,Entire home/apt,84,166,3.38,250
36388,Jessica,2,Private room,70,0,0.14,70
36389,Wilson,2,Private room,55,311,0.33,366
36390,Dylan,2,Private room,99,0,0.33,99
36391,Kevin,2,Private room,48,10,5.02,58
36393,Kevin,2,Private room,45,25,4.69,70
36394,Kimberly,3,Entire home/apt,69,137,5.63,206
36395,Kevin,2,Private room,50,17,5.02,67
36396,Betty,2,Private room,150,149,0.79,299
36397,J-,2,Private room,73,0,0.11,73
36398,Haruhisa,3,Private room,40,32,0.55,72
36400,Libby,2,Private room,50,0,0.69,50
36402,Ahmad,3,Private room,100,1,0.32,101
36403,Joslin,2,Entire home/apt,100,20,3.2,120
36404,Gigi,2,Entire home/apt,160,364,2.28,524
36405,Natasha,2,Entire home/apt,110,129,0.12,239
36406,John,1,Private room,249,5,0.33,254
36407,Jason,1,Entire home/apt,150,0,0.92,150
36408,Sebastian,1,Private room,150,0,0.57,150
36409,Анита,2,Private room,50,71,3.18,121
36410,Brett,1,Entire home/apt,240,267,2.8,507
36411,Liz,2,Private room,100,292,2.59,392
36412,Anting,3,Private room,119,365,0.26,484
36413,Paul,4,Entire home/apt,75,242,0.63,317
36414,Faysal,3,Entire home/apt,90,90,0.22,180
36415,Maksum,1,Entire home/apt,399,76,3.16,475
36416,Tania And Jimmy,3,Entire home/apt,149,362,3.89,511
36417,Olivia,3,Private room,64,0,1.12,64
36418,Emily Wes,2,Private room,68,242,1.93,310
36419,Laura,1,Entire home/apt,250,80,2.32,330
36420,Emily Wes,2,Private room,63,365,1.8,428
36421,Darryl,1,Private room,56,129,2.19,185
36422,Thomas,2,Entire home/apt,200,89,0.33,289
36423,Merle,3,Private room,65,170,0.99,235
36424,Chels,1,Entire home/apt,300,48,5.87,348
36425,Yizhak,4,Entire home/apt,100,39,2.81,139
36426,Jayleen,2,Entire home/apt,120,0,1.66,120
36427,Voisin,1,Private room,70,356,1.3,426
36428,Joseph,1,Entire home/apt,137,0,0.16,137
36429,Ron And Irit,2,Entire home/apt,275,249,5.04,524
36430,Joseph,1,Private room,65,30,1.43,95
36431,Paul,2,Entire home/apt,150,95,0.33,245
36433,Kian,2,Private room,82,48,0.88,130
36435,Luna,2,Private room,80,6,0.8,86
36437,Billy,2,Private room,39,158,0.6,197
36438,Yun,1,Private room,169,351,1.35,520
36439,Jci,2,Private room,150,33,0.75,183
36440,Raluca,1,Entire home/apt,125,3,0.23,128
36441,Digna,2,Private room,65,357,1.45,422
36442,Jane,1,Entire home/apt,160,170,1.79,330
36443,Whitney,2,Entire home/apt,175,158,0.63,333
36444,Maria,3,Entire home/apt,150,7,4.1,157
36445,Sam,2,Entire home/apt,210,268,2.32,478
36447,Ron,2,Entire home/apt,125,175,4.33,300
36448,Studioplus,1,Entire home/apt,240,279,1.95,519
36451,Blu,2,Entire home/apt,150,105,1.25,255
36452,Sachin,1,Entire home/apt,200,0,0.11,200
36453,Caprice,2,Private room,80,179,0.48,259
36454,Babie,3,Private room,39,89,4.93,128
36455,Shane,2,Entire home/apt,135,365,1.07,500
36456,Julia,2,Private room,55,48,0.14,103
36457,Mark,2,Entire home/apt,230,205,3.36,435
36459,Madi,1,Entire home/apt,175,24,2.52,199
36460,Brianna,2,Private room,50,0,0.56,50
36461,Siyi,2,Entire home/apt,139,7,0.5,146
36462,Pedro,2,Entire home/apt,129,192,4.73,321
36463,Tessa,2,Private room,80,64,1.82,144
36465,Rebeca & John @ Bedly,2,Private room,44,9,0.13,53
36466,Colin,3,Private room,100,0,0.43,100
36467,Jonathan,1,Private room,150,177,1.26,327
36468,Jane,2,Private room,90,29,0.25,119
36469,Leli,2,Entire home/apt,200,4,0.16,204
36470,Adriana,4,Private room,65,46,2.83,111
36471,Victoria,1,Private room,100,0,1.21,100
36472,Richard,1,Entire home/apt,130,332,0.19,462
36473,Carlos,2,Private room,75,0,1.41,75
36474,Mariah,2,Private room,70,0,0.23,70
36475,Carlos,2,Private room,55,0,0.45,55
36476,Isabella,2,Private room,55,0,1.72,55
36477,Marilyn,1,Entire home/apt,125,226,0.34,351
36478,Liz,1,Entire home/apt,175,6,1.2,181
36479,Jennifer,1,Private room,125,315,3.82,440
36480,Kane,3,Private room,48,79,3.79,127
36481,Kane,3,Private room,48,84,4.21,132
36482,Abby,2,Shared room,50,311,0.7,361
36483,John,1,Entire home/apt,80,28,2.59,108
36484,Saron,3,Private room,35,365,0.11,400
36485,Alexandra,1,Private room,95,23,2.0,118
36486,Matt,1,Private room,90,5,0.16,95
36487,Andrew,2,Entire home/apt,85,357,0.59,442
36488,Jana,2,Private room,85,0,1.99,85
36490,Kristin,2,Private room,90,156,0.15,246
36491,Elizabeth,2,Entire home/apt,175,0,1.83,175
36492,Marco,3,Private room,80,85,0.76,165
36493,Shearly,2,Entire home/apt,134,41,1.91,175
36494,Delilah,1,Entire home/apt,150,0,0.9,150
36495,Igam,2,Private room,40,0,1.11,40
36496,Yvonne,2,Private room,55,89,0.16,144
36497,JenJoy,2,Private room,60,5,4.42,65
36498,Maria,2,Private room,74,34,2.9,108
36499,Catalina,2,Private room,69,0,0.45,69
36500,John,2,Entire home/apt,160,335,3.28,495
36501,R.Henry,1,Shared room,65,198,4.77,263
36502,Jamie,3,Entire home/apt,128,325,4.01,453
36503,Curtiss,1,Entire home/apt,250,183,1.02,433
36504,Maria,3,Private room,45,262,1.67,307
36505,Irina,2,Entire home/apt,100,219,0.59,319
36506,Ben And Madi,2,Private room,65,255,0.77,320
36507,Farzona,3,Private room,350,90,0.11,440
36508,Heidrun,1,Private room,120,295,0.36,415
36509,Mike,1,Entire home/apt,135,22,0.53,157
36510,Tsotne (Tut),4,Private room,42,321,1.08,363
36511,Dmitri,1,Private room,66,64,2.63,130
36512,Umar,1,Private room,80,0,0.34,80
36513,Marco,3,Private room,105,359,0.23,464
36515,Bruno,2,Entire home/apt,80,303,5.71,383
36516,Roz,2,Entire home/apt,400,0,0.16,400
36517,Mariana,2,Private room,55,0,0.31,55
36518,Jessy & Christian,3,Shared room,40,356,1.19,396
36519,Chad,3,Private room,70,342,2.0,412
36520,Kian,2,Private room,72,66,0.76,138
36521,Alicia,4,Private room,38,188,1.29,226
36522,Ling,2,Private room,45,357,0.42,402
36524,Francisco,4,Private room,79,88,0.23,167
36525,Jon,1,Entire home/apt,295,77,2.16,372
36526,Noriko,2,Entire home/apt,120,13,4.88,133
36527,Yasha,3,Private room,55,0,0.45,55
36528,Maria,1,Private room,70,0,2.42,70
36529,Ociel,4,Private room,120,312,3.15,432
36530,Paul,3,Private room,90,173,0.77,263
36531,Parrish,2,Private room,125,364,0.76,489
36532,Michele,1,Entire home/apt,135,1,2.74,136
36533,Orit,1,Private room,120,361,0.55,481
36534,Anting,2,Entire home/apt,350,0,0.12,350
36535,Drew,4,Entire home/apt,81,0,0.62,81
36536,Simi,1,Entire home/apt,850,269,3.51,1119
36537,Robertina,3,Private room,68,100,2.45,168
36538,Elena,2,Entire home/apt,105,332,0.85,437
36539,Susan,1,Entire home/apt,200,91,2.81,291
36540,Elif,1,Private room,75,8,3.33,83
36541,Marie & Tyler,2,Private room,40,54,0.13,94
36542,Jovenne Naldrey,2,Entire home/apt,215,165,2.21,380
36543,Diana,2,Private room,80,8,0.12,88
36544,Nadia,3,Private room,150,365,0.16,515
36545,Adam,1,Entire home/apt,112,0,0.5,112
36546,Cj,2,Private room,42,0,0.26,42
36547,Jessica,1,Entire home/apt,80,0,1.51,80
36548,Meng,1,Entire home/apt,89,34,4.93,123
36549,Levi,2,Shared room,25,365,0.53,390
36551,Dionyssios,1,Entire home/apt,120,365,1.8,485
36552,Dylan,1,Entire home/apt,350,65,3.27,415
36553,Nick,2,Shared room,25,62,1.56,87
36554,Rafael,2,Private room,85,354,4.62,439
36555,Nick,2,Shared room,25,80,1.88,105
36556,Daniela,1,Entire home/apt,200,0,1.01,200
36558,Antoine,2,Private room,48,89,0.23,137
36559,Tracey,1,Entire home/apt,350,0,0.59,350
36560,Denise,2,Entire home/apt,78,3,2.17,81
36561,Xue,1,Entire home/apt,69,1,0.24,70
36562,John,2,Private room,55,0,1.2,55
36563,Stephanie,1,Shared room,150,270,1.33,420
36564,Jordan,1,Private room,134,70,0.36,204
36565,Javi,3,Private room,42,178,0.11,220
36566,Jose,1,Private room,100,27,1.74,127
36567,Meir,2,Entire home/apt,80,29,1.86,109
36568,Maxim,2,Private room,67,0,1.65,67
36569,Maxim,2,Private room,66,75,4.91,141
36570,Mala,2,Private room,95,3,0.77,98
36571,Dc,1,Shared room,800,220,1.4,1020
36573,Amanda,2,Entire home/apt,175,119,2.05,294
36574,Sammi,1,Entire home/apt,200,15,0.23,215
36575,Elizabete,3,Private room,100,364,0.94,464
36577,Jun Jun,3,Private room,70,5,0.82,75
36578,Bradley,4,Private room,80,188,2.2,268
36579,Lee,3,Private room,60,331,2.11,391
36580,Godlove,2,Entire home/apt,89,35,2.48,124
36581,Dadrine,2,Private room,90,365,0.79,455
36582,Omar,3,Private room,53,157,3.67,210
36583,Isabela,2,Private room,90,224,5.56,314
36584,Murat,3,Entire home/apt,60,143,3.16,203
36585,Charlotte & Aaron,2,Entire home/apt,125,173,0.71,298
36587,Jonathan,1,Private room,115,1,3.39,116
36588,Martin,1,Entire home/apt,138,1,2.69,139
36589,Cynthia,1,Private room,120,0,0.38,120
36590,Tony,3,Private room,60,0,4.17,60
36591,Kirstie,2,Private room,112,0,1.15,112
36592,Matthew,2,Entire home/apt,140,116,4.01,256
36594,Zumunta,3,Private room,31,0,0.11,31
36595,Matthew,2,Entire home/apt,100,0,0.57,100
36596,Willie,1,Private room,120,188,3.29,308
36597,Anting,1,Entire home/apt,225,179,0.24,404
36598,James,1,Entire home/apt,157,0,0.13,157
36599,Kimbe,2,Entire home/apt,275,77,0.68,352
36600,Michael,2,Private room,80,1,0.42,81
36601,Suket,3,Entire home/apt,99,35,4.94,134
36602,Natalia,2,Entire home/apt,85,42,4.36,127
36603,Janice,4,Entire home/apt,80,0,0.71,80
36604,Rafael,3,Private room,79,96,1.26,175
36605,Laura,1,Entire home/apt,150,0,0.38,150
36606,Leona,1,Private room,100,281,9.58,381
36607,Chantou,2,Private room,87,0,0.35,87
36608,Adonna,2,Private room,150,354,0.14,504
36609,Leona,1,Private room,100,257,7.31,357
36610,Luca,1,Private room,56,228,2.63,284
36611,Alan,2,Private room,70,321,0.46,391
36612,Matthew,2,Entire home/apt,120,121,2.79,241
36613,Adriana,1,Entire home/apt,155,8,5.75,163
36614,Nahi,4,Private room,39,211,2.73,250
36615,Anna,2,Entire home/apt,200,16,0.22,216
36616,Travis,1,Private room,250,365,0.44,615
36617,Melli,1,Entire home/apt,220,0,0.89,220
36618,Bianca,1,Private room,106,117,1.12,223
36619,Sifan,3,Shared room,40,78,2.9,118
36620,Mariela,4,Private room,48,34,2.0,82
36621,Anique,1,Entire home/apt,125,0,1.26,125
36622,Jason,2,Entire home/apt,150,0,0.13,150
36623,Joel,2,Private room,68,4,0.61,72
36624,Irwing,3,Private room,49,5,1.15,54
36625,Marta,2,Entire home/apt,185,2,0.79,187
36626,Andres,1,Private room,50,271,4.85,321
36628,Nadine,2,Private room,65,365,2.31,430
36629,Cristóbal,2,Entire home/apt,120,0,1.03,120
36630,Solina,1,Entire home/apt,230,23,0.95,253
36631,Oriana Alexandra,2,Private room,60,28,0.78,88
36632,Monika,2,Private room,60,90,1.34,150
36633,Yury,2,Private room,60,73,2.55,133
36634,Analia,2,Private room,60,0,8.97,60
36635,Wayne,1,Shared room,79,76,0.5,155
36636,Jasmine,1,Entire home/apt,275,24,0.99,299
36637,Max/Patti,1,Entire home/apt,220,24,4.04,244
36638,Stella,1,Entire home/apt,95,74,4.33,169
36639,Alena,2,Entire home/apt,130,95,1.28,225
36640,Janna,1,Private room,85,0,0.67,85
36641,Alex,1,Private room,120,4,4.91,124
36642,Suanny,2,Entire home/apt,95,363,0.93,458
36643,Elma,2,Private room,45,77,0.61,122
36644,Rafael,3,Private room,49,0,1.9,49
36645,Leen,1,Entire home/apt,175,32,0.66,207
36646,Luke & Madia,2,Private room,70,358,2.0,428
36647,Kevin,3,Entire home/apt,120,5,0.24,125
36648,Joel And Julian,2,Private room,70,365,1.65,435
36649,Rafael,3,Private room,59,0,1.9,59
36650,Farhana,3,Entire home/apt,99,166,3.76,265
36651,Kennedy,2,Private room,155,365,0.11,520
36652,Judyann,2,Entire home/apt,125,85,0.43,210
36653,Dora,2,Entire home/apt,180,0,1.01,180
36654,Valeria,3,Private room,50,272,1.7,322
36655,Lena,1,Entire home/apt,187,56,0.47,243
36656,Sophia,2,Entire home/apt,179,152,1.03,331
36658,Maka,1,Entire home/apt,300,0,1.15,300
36659,Ivan,3,Private room,96,80,7.08,176
36660,Vincent,2,Private room,75,308,2.45,383
36661,Clarke,2,Entire home/apt,151,27,0.63,178
36662,Corporate Housing,1,Entire home/apt,165,347,0.33,512
36663,Corporate Housing,1,Entire home/apt,125,352,1.0,477
36665,Nathalie,3,Private room,87,282,3.24,369
36666,Margaux,1,Private room,100,13,1.0,113
36667,Pedro,2,Private room,50,0,0.34,50
36669,Charlotte,3,Shared room,32,169,0.95,201
36670,Sasha,2,Private room,50,10,5.62,60
36671,Adonna,2,Entire home/apt,150,171,0.69,321
36672,Nick,2,Shared room,25,49,3.01,74
36673,Andrea,2,Private room,55,36,1.55,91
36674,Jean,2,Entire home/apt,200,327,2.79,527
36675,Dora,2,Entire home/apt,135,12,0.62,147
36676,Kisha,2,Entire home/apt,129,233,4.81,362
36677,Curtis Green,1,Private room,60,83,0.14,143
36678,Walter,3,Entire home/apt,165,362,3.23,527
36679,Ismael,3,Private room,55,315,0.9,370
36680,Jessie,1,Private room,59,5,2.01,64
36681,Kane,3,Private room,45,75,6.42,120
36682,Jacqueline,2,Entire home/apt,400,0,0.4,400
36683,Marcelo,2,Private room,75,52,4.8,127
36684,Andrew,2,Entire home/apt,125,225,2.27,350
36685,Marie & Tyler,2,Private room,39,38,0.77,77
36686,Joe,1,Entire home/apt,195,117,2.43,312
36687,Joshua,2,Entire home/apt,125,34,0.65,159
36688,Sonia And Lissette,1,Private room,60,2,1.15,62
36689,Bo,2,Private room,70,121,4.73,191
36690,Rafael,3,Entire home/apt,149,0,5.0,149
36691,Andres,2,Private room,100,0,0.59,100
36692,George,1,Entire home/apt,320,95,4.53,415
36693,Vince,1,Private room,80,123,2.54,203
36694,Uchenna,2,Private room,79,74,2.1,153
36695,Luis,4,Entire home/apt,100,187,3.44,287
36699,Sasha,1,Entire home/apt,150,129,4.36,279
36700,Joshua,1,Private room,60,0,0.29,60
36701,Marian,2,Private room,41,18,2.23,59
36702,Jonathan,1,Entire home/apt,85,118,0.44,203
36703,Javier,1,Shared room,69,335,3.4,404
36704,Fon,2,Private room,65,4,1.13,69
36705,Fon,2,Private room,65,189,0.78,254
36706,Fon,2,Private room,65,98,0.92,163
36707,Ann,2,Private room,60,292,3.95,352
36709,Tricia,1,Entire home/apt,159,343,3.05,502
36710,Zoe,1,Private room,70,19,0.49,89
36711,Rafael,1,Private room,110,14,0.95,124
36712,Simi,1,Private room,999,213,1.4,1212
36713,Kit,2,Private room,75,0,0.34,75
36714,Oz,1,Entire home/apt,150,0,1.12,150
36716,Melissa,2,Private room,49,306,1.7,355
36717,Alan,2,Private room,41,0,0.66,41
36718,Alan,2,Entire home/apt,175,0,0.12,175
36719,Melissa,2,Private room,49,305,1.35,354
36721,Melissa,2,Private room,65,282,1.31,347
36722,Melissa,2,Private room,49,313,1.14,362
36723,Melissa,2,Private room,49,312,1.02,361
36724,Melissa,2,Private room,65,285,0.8,350
36725,Melissa,2,Private room,49,308,1.02,357
36726,Jay,3,Private room,50,308,1.57,358
36727,Terry,2,Private room,45,139,6.86,184
36728,Lancelot,1,Private room,60,5,4.1,65
36729,Sofia,2,Private room,99,249,1.18,348
36730,Anting,1,Entire home/apt,225,179,1.62,404
36731,Stefanie,1,Entire home/apt,105,160,1.67,265
36732,Mella & Justin,2,Entire home/apt,115,131,4.4,246
36733,Martin & Steve,2,Private room,44,84,1.0,128
36735,Patrice,1,Entire home/apt,150,50,2.22,200
36736,Amanda & Rafael,1,Private room,150,0,0.92,150
36737,Slava,2,Entire home/apt,110,81,5.98,191
36738,Jordan,2,Entire home/apt,199,0,1.49,199
36739,Ana,2,Entire home/apt,180,106,2.18,286
36740,Linda,4,Entire home/apt,200,0,6.61,200
36741,Lillian,1,Private room,80,143,1.73,223
36742,Vince,1,Private room,78,91,2.53,169
36744,Alan,2,Private room,75,365,0.74,440
36745,Myra,2,Private room,50,130,0.14,180
36746,Rosie,2,Private room,50,273,3.86,323
36748,Myra,2,Private room,45,42,0.26,87
36750,Babie,3,Private room,49,87,5.58,136
36751,Myra,2,Private room,40,120,1.0,160
36752,Babie,3,Private room,35,86,3.87,121
36753,K,2,Entire home/apt,86,66,0.43,152
36755,Min,2,Entire home/apt,96,58,2.59,154
36757,Aneel,3,Entire home/apt,150,317,0.35,467
36758,Nicolas,2,Private room,45,189,0.11,234
36759,Roger,2,Entire home/apt,110,0,0.79,110
36760,Dada,3,Private room,59,32,2.76,91
36761,Carlton,3,Entire home/apt,150,69,9.3,219
36762,Marie,2,Private room,55,297,0.3,352
36763,Joseph,2,Entire home/apt,89,209,2.1,298
36764,Mariana,2,Private room,55,0,3.81,55
36765,Peter,2,Private room,65,365,1.85,430
36766,Elif,1,Private room,80,7,5.54,87
36767,Elif,1,Private room,75,8,2.74,83
36768,Debora,2,Entire home/apt,90,138,3.17,228
36769,Dio,2,Private room,66,90,0.97,156
36770,Blueground,1,Entire home/apt,264,187,0.17,451
36771,Blueground,1,Entire home/apt,244,218,0.19,462
36773,Anting,1,Entire home/apt,225,179,0.35,404
36774,Sara And Hila,1,Entire home/apt,280,112,3.69,392
36776,Joe,1,Entire home/apt,200,164,2.47,364
36777,Orit,1,Private room,150,219,1.11,369
36778,Boomer,2,Entire home/apt,122,211,4.44,333
36779,N.L.,1,Private room,150,45,0.23,195
36780,Demir,1,Shared room,100,212,0.21,312
36781,Qusuquzah,2,Private room,62,179,0.15,241
36782,N.L.,1,Entire home/apt,240,0,1.51,240
36783,Dedy,2,Private room,46,23,3.22,69
36784,Fabian,3,Private room,49,143,6.71,192
36785,Brenda,3,Shared room,50,0,1.03,50
36786,Ella,2,Entire home/apt,119,276,3.6,395
36787,Jessica,2,Entire home/apt,125,39,1.3,164
36788,Samaya,2,Entire home/apt,140,285,3.15,425
36789,Anting,1,Entire home/apt,179,179,0.47,358
36790,Sara,1,Entire home/apt,600,210,0.84,810
36791,Vivian,1,Entire home/apt,145,4,0.91,149
36792,Robert,2,Private room,45,32,0.57,77
36793,Viktoriia,3,Private room,90,180,1.03,270
36794,Mickael,2,Entire home/apt,150,0,0.47,150
36795,Sasha,1,Entire home/apt,135,0,0.89,135
36796,Jenny,2,Entire home/apt,135,307,2.19,442
36798,Tatianna,1,Private room,90,0,0.46,90
36799,Angely,1,Private room,165,0,0.35,165
36800,Savanna,1,Entire home/apt,195,3,1.16,198
36801,Tim,3,Private room,65,59,3.24,124
36802,Anne-Marie,1,Entire home/apt,500,11,0.48,511
36803,Elisa,1,Shared room,75,365,0.12,440
36804,Jessica,2,Private room,60,144,1.1,204
36805,Jessica,2,Private room,59,54,1.53,113
36806,Eg,2,Entire home/apt,175,276,3.07,451
36807,Viktoriia,3,Private room,90,89,1.24,179
36809,Majd,2,Entire home/apt,125,0,0.27,125
36811,Scott,2,Entire home/apt,88,23,1.14,111
36812,Maurice,2,Entire home/apt,175,325,0.64,500
36813,Boris,2,Entire home/apt,100,24,4.41,124
36814,Colette,2,Private room,175,275,1.73,450
36815,Piro,2,Entire home/apt,121,45,0.31,166
36816,Quincy,1,Private room,89,18,0.13,107
36818,Terry,2,Private room,58,0,0.25,58
36819,Renwick,1,Entire home/apt,150,9,1.15,159
36820,Oliver,2,Private room,35,1,0.57,36
36821,Sean,2,Entire home/apt,90,3,0.95,93
36822,Peter,1,Entire home/apt,250,0,2.3,250
36823,William,2,Entire home/apt,90,82,2.89,172
36824,Fabricio,1,Private room,100,165,0.95,265
36825,Lisette,3,Entire home/apt,100,103,2.83,203
36826,Yngrid,2,Entire home/apt,149,93,8.62,242
36827,Ma,1,Entire home/apt,188,21,0.68,209
36828,Marvin,2,Private room,47,14,1.05,61
36829,Marta,2,Private room,110,8,1.08,118
36830,Danni,2,Private room,33,64,0.96,97
36831,Molly,1,Private room,130,0,0.99,130
36832,Anneka,1,Entire home/apt,230,360,1.04,590
36833,Motty,1,Entire home/apt,899,340,0.71,1239
36834,Alexandra,1,Entire home/apt,130,243,3.01,373
36836,Sarah,2,Entire home/apt,100,4,1.34,104
36837,Zhen Zhen,3,Entire home/apt,150,69,1.73,219
36838,Nora,1,Private room,66,6,3.14,72
36839,Jon,2,Private room,95,101,4.15,196
36840,Erika,1,Entire home/apt,170,365,0.11,535
36841,Anthony,1,Private room,125,14,1.51,139
36844,Norma-Ester-,2,Shared room,45,332,0.93,377
36845,Keziah,1,Entire home/apt,195,239,0.4,434
36847,Nicholas,2,Entire home/apt,250,4,0.23,254
36848,Gerta,1,Private room,93,28,3.87,121
36849,Brandy,2,Private room,196,35,0.65,231
36850,Jeanpaul,3,Entire home/apt,200,38,1.0,238
36851,Kerlyne,4,Entire home/apt,150,0,0.57,150
36853,John,1,Entire home/apt,325,7,1.95,332
36854,Allison,1,Private room,350,169,0.36,519
36855,Noah,2,Private room,99,0,1.6,99
36856,Katey,1,Entire home/apt,99,29,1.55,128
36857,Emma,2,Private room,40,14,1.76,54
36858,Kerry,2,Entire home/apt,90,0,0.73,90
36859,Matt,2,Private room,85,0,0.24,85
36861,Maya,2,Private room,98,135,0.69,233
36862,Ricardo,1,Private room,279,26,0.32,305
36863,Ann,2,Entire home/apt,249,46,4.38,295
36864,Amberjade,1,Private room,85,232,2.53,317
36865,Claudette,3,Private room,50,347,4.53,397
36866,Veronika,3,Entire home/apt,199,113,3.79,312
36867,Liza + Victor,2,Entire home/apt,70,2,2.97,72
36868,Bo,2,Private room,65,125,5.08,190
36869,Alyssa,2,Entire home/apt,149,13,3.11,162
36870,Amer,2,Private room,90,0,1.26,90
36872,Reina,1,Entire home/apt,125,119,1.17,244
36873,Sherley,3,Entire home/apt,105,89,0.24,194
36874,Oriana Alexandra,2,Private room,75,0,0.12,75
36875,Dan & Melisa,2,Entire home/apt,82,288,6.41,370
36877,Magdalena,2,Private room,50,327,2.63,377
36878,Veronika,1,Entire home/apt,250,0,0.14,250
36879,Bruna,3,Private room,44,188,0.16,232
36881,Serdar,3,Private room,130,6,2.34,136
36882,Silver,1,Private room,270,364,0.32,634
36883,Mary,1,Private room,175,365,1.09,540
36884,Harmony,2,Private room,45,160,1.63,205
36885,Uchenna,2,Private room,79,79,1.63,158
36886,Shoshi,2,Private room,70,53,0.21,123
36888,Danielle,1,Entire home/apt,240,53,0.28,293
36889,Peter,2,Private room,70,339,3.06,409
36890,Emily,1,Entire home/apt,199,62,0.68,261
36891,Caroline,1,Entire home/apt,135,240,0.27,375
36894,Ben,1,Private room,57,365,0.36,422
36895,Varun,1,Entire home/apt,300,0,0.94,300
36897,Giselle & Charles,2,Entire home/apt,99,145,3.21,244
36898,Xanthi,1,Entire home/apt,350,179,1.19,529
36899,Yael,1,Shared room,40,0,2.82,40
36900,Amir,1,Entire home/apt,99,8,2.48,107
36901,Joseph,4,Private room,100,319,1.84,419
36902,Melissa,1,Private room,97,0,0.83,97
36903,Janet,1,Private room,425,177,0.36,602
36904,Daniel,3,Entire home/apt,89,12,1.73,101
36905,Kelly,2,Entire home/apt,150,0,1.54,150
36906,Nikole,3,Shared room,30,365,0.45,395
36907,Alan,2,Entire home/apt,150,77,8.95,227
36908,Ned,1,Entire home/apt,225,101,5.38,326
36911,Jeanny,3,Private room,49,318,1.05,367
36912,Diana,3,Private room,65,77,1.49,142
36914,Brenda,3,Entire home/apt,188,59,1.97,247
36916,Ira,3,Entire home/apt,155,358,0.32,513
36917,Terry,2,Entire home/apt,300,175,1.49,475
36918,Rumalia,3,Entire home/apt,150,360,3.32,510
36919,Samuel,4,Private room,300,364,0.11,664
36921,Miki,1,Private room,85,79,2.64,164
36922,Nathalie,2,Private room,35,69,0.16,104
36925,Hailey,1,Private room,90,297,3.42,387
36926,Alex,1,Entire home/apt,199,204,0.77,403
36927,Diana,2,Private room,75,0,1.56,75
36928,Rafa' S,3,Private room,65,364,1.43,429
36929,Andrea,2,Private room,51,189,2.16,240
36930,Marlena,1,Entire home/apt,125,0,1.65,125
36931,Illias,3,Private room,41,123,5.24,164
36932,Tiffany,2,Entire home/apt,200,0,0.16,200
36933,Julia,1,Private room,250,0,0.44,250
36934,Fabrice,1,Entire home/apt,102,75,2.14,177
36935,Robyn,1,Entire home/apt,175,6,1.23,181
36936,Chester,1,Private room,100,90,1.15,190
36937,Jesse,2,Entire home/apt,115,0,1.03,115
36938,Alice,2,Private room,84,31,0.94,115
36940,Betty,3,Private room,65,88,0.64,153
36941,美德,3,Shared room,40,230,2.4,270
36942,David,1,Entire home/apt,599,244,2.92,843
36943,Deslyn,2,Entire home/apt,225,339,3.36,564
36944,Geoffrey,1,Private room,109,0,2.87,109
36945,Julien,1,Entire home/apt,250,323,1.41,573
36946,Rufina,2,Private room,55,251,2.18,306
36947,Takeis,1,Entire home/apt,78,33,3.86,111
36948,Gabrielle,5,Entire home/apt,85,229,1.91,314
36950,Luca,3,Entire home/apt,65,73,1.54,138
36951,Anchor,2,Shared room,35,89,1.52,124
36952,James,1,Private room,80,57,4.4,137
36953,James,1,Private room,85,71,7.59,156
36954,James,1,Private room,98,56,5.86,154
36955,James,1,Private room,90,87,6.4,177
36956,Anting,1,Entire home/apt,179,187,0.68,366
36959,Margaux,2,Private room,60,0,0.12,60
36960,Casey,1,Entire home/apt,200,0,4.66,200
36961,Denise,2,Entire home/apt,130,70,1.09,200
36963,Janine & Reneé,3,Private room,75,40,1.6,115
36964,San,1,Entire home/apt,244,56,1.21,300
36965,William,2,Private room,80,214,5.52,294
36966,XnL,1,Entire home/apt,180,0,1.22,180
36967,Ivan,2,Entire home/apt,100,61,0.41,161
36968,Carlos,3,Entire home/apt,76,326,0.83,402
36969,Rosa,4,Private room,50,0,0.71,50
36970,Julia,2,Entire home/apt,78,223,3.64,301
36972,Ferdy,1,Entire home/apt,180,1,1.36,181
36973,David,2,Private room,65,74,1.82,139
36974,Jeanny,3,Entire home/apt,110,173,0.16,283
36975,Sergio,1,Entire home/apt,190,120,4.64,310
36976,Anna,2,Entire home/apt,150,154,0.13,304
36978,Milosz,2,Entire home/apt,181,37,4.12,218
36979,Aracely,3,Private room,49,358,2.86,407
36980,Maria,5,Private room,100,86,0.73,186
36981,Michelle & Lily,3,Entire home/apt,179,239,3.65,418
36982,Katie,1,Entire home/apt,175,0,2.08,175
36983,Kenny,4,Private room,45,67,2.27,112
36984,Bruno,3,Private room,90,354,0.61,444
36985,Nikki,1,Entire home/apt,168,130,0.78,298
36986,Tania,3,Private room,95,12,1.41,107
36987,Vince,5,Entire home/apt,90,247,2.68,337
36989,Janet,1,Private room,329,178,0.12,507
36990,Charlie,1,Entire home/apt,390,0,0.36,390
36991,Mamy Francine,1,Private room,90,0,0.36,90
36992,Meryl,2,Entire home/apt,120,1,0.82,121
36993,Aracely,3,Private room,45,138,2.58,183
36994,Bryan,2,Private room,139,83,0.14,222
36995,Kyla,2,Private room,45,318,0.34,363
36996,Kyla,2,Private room,36,329,1.51,365
36999,Zulema,3,Entire home/apt,299,52,1.05,351
37000,Freddy,3,Private room,65,48,4.94,113
37001,Asshur,2,Private room,77,0,0.12,77
37002,Ramon,1,Private room,115,0,0.25,115
37003,Karen,1,Private room,149,317,3.86,466
37004,Joel And Julian,2,Private room,75,365,1.53,440
37005,Joel And Julian,2,Private room,70,365,1.61,435
37006,Ruby,1,Shared room,65,169,2.51,234
37007,Nofar,1,Entire home/apt,100,0,0.3,100
37008,Rachel,2,Private room,130,64,1.63,194
37009,Inhee,1,Private room,80,0,3.45,80
37010,Ezra,1,Private room,70,361,1.49,431
37011,Yvonne,2,Shared room,38,365,0.8,403
37012,Topu,3,Entire home/apt,185,99,6.45,284
37013,Lee,1,Entire home/apt,182,12,3.88,194
37015,Nour,1,Private room,97,75,5.71,172
37016,Sophie,1,Private room,110,365,0.14,475
37017,Michael,5,Entire home/apt,62,268,0.56,330
37018,Alex,1,Entire home/apt,150,132,0.97,282
37019,Liza,1,Entire home/apt,250,0,0.28,250
37020,Marisa,1,Entire home/apt,220,0,0.13,220
37021,Amy,1,Entire home/apt,300,0,0.47,300
37022,Ray,2,Entire home/apt,150,160,1.53,310
37023,Agata,3,Private room,69,37,2.43,106
37024,Ami,1,Private room,70,16,1.77,86
37025,Lauren,2,Entire home/apt,190,0,1.99,190
37026,Sophia,2,Entire home/apt,169,41,0.48,210
37027,Daniel,5,Entire home/apt,200,320,0.53,520
37028,Shannon & Ryan,1,Private room,100,23,5.06,123
37029,Jo,1,Entire home/apt,280,166,0.16,446
37030,Nour,1,Private room,63,31,7.5,94
37031,Tom,2,Entire home/apt,200,0,0.4,200
37032,Kaleel,1,Shared room,125,126,1.72,251
37034,Larah,2,Entire home/apt,125,0,0.24,125
37036,Ruby,1,Private room,75,357,0.82,432
37037,Vince,1,Entire home/apt,165,83,0.92,248
37038,Kat,1,Private room,90,89,0.38,179
37040,Tohar,2,Entire home/apt,105,245,2.01,350
37041,Joan,1,Entire home/apt,110,0,0.25,110
37042,Evan,3,Entire home/apt,74,52,0.53,126
37043,Juan Francisco,1,Entire home/apt,239,154,1.04,393
37044,Xiomara,5,Private room,80,362,3.4,442
37045,Tim,1,Entire home/apt,255,0,0.57,255
37046,Juan Francisco,1,Private room,99,0,0.38,99
37049,Thomas,3,Private room,47,0,0.82,47
37050,Shelli,1,Entire home/apt,525,158,0.36,683
37051,Michael,1,Private room,62,194,7.41,256
37052,Felix Lion,2,Private room,70,361,2.24,431
37053,Rachael,2,Entire home/apt,200,0,0.26,200
37054,Anna,3,Private room,75,173,0.12,248
37055,Ruby,1,Private room,75,305,1.76,380
37056,Chiroy,1,Private room,75,27,1.99,102
37057,Anthony,2,Private room,60,43,3.53,103
37059,Felix Lion,2,Private room,68,365,1.76,433
37060,Felix Lion,2,Private room,72,365,1.77,437
37061,Sheila,1,Private room,99,283,1.89,382
37062,Lauren,2,Private room,70,14,2.36,84
37063,Maggy,3,Entire home/apt,86,1,0.79,87
37065,Lyn,1,Private room,45,184,0.6,229
37066,Tanya,1,Private room,119,0,6.72,119
37067,Yoann,1,Entire home/apt,300,25,0.16,325
37069,Mikosya,2,Shared room,100,365,0.56,465
37070,Sarah,2,Entire home/apt,130,5,0.4,135
37071,Kazuya,3,Private room,39,252,0.19,291
37072,Scott,2,Private room,85,326,0.83,411
37073,Brooklyn&   Breakfast    -Len-,2,Private room,55,315,4.55,370
37077,Janet,1,Private room,299,177,0.94,476
37078,Janet,1,Private room,329,178,0.38,507
37080,Alexis,1,Entire home/apt,255,0,0.39,255
37081,Michael,1,Private room,42,77,7.14,119
37082,Aaron,2,Entire home/apt,150,0,0.38,150
37084,Nino,2,Private room,63,12,0.59,75
37085,Andrea,2,Private room,50,342,0.36,392
37086,Vida,2,Entire home/apt,150,31,4.86,181
37087,Nôm,2,Entire home/apt,120,108,0.15,228
37089,Youge,2,Private room,65,148,2.55,213
37090,Youge,2,Private room,65,178,3.66,243
37091,Corporate Housing,1,Entire home/apt,117,345,0.14,462
37092,Sari,2,Entire home/apt,200,23,1.09,223
37093,Melissa,3,Entire home/apt,20,41,13.11,61
37094,Tommy,2,Private room,60,113,2.39,173
37095,Pedro,2,Private room,72,95,5.83,167
37096,Bertrand,2,Entire home/apt,150,34,1.54,184
37097,Nicole,2,Entire home/apt,185,0,0.27,185
37098,Carol,1,Entire home/apt,140,0,2.09,140
37099,Allison,1,Private room,153,32,3.3,185
37100,Charlie,1,Private room,36,16,0.27,52
37102,Alan,2,Private room,70,362,0.95,432
37103,Douglas,1,Entire home/apt,345,100,3.4,445
37104,Madeline,1,Entire home/apt,125,37,2.35,162
37105,Andrew,1,Private room,75,33,1.9,108
37106,Julio,1,Entire home/apt,180,55,1.81,235
37107,Deborah,1,Entire home/apt,155,0,0.18,155
37108,Katherine,1,Entire home/apt,625,321,3.06,946
37109,Dionyssios,1,Entire home/apt,120,365,2.12,485
37110,Mike,1,Entire home/apt,200,0,0.88,200
37111,Karla,1,Entire home/apt,140,3,0.66,143
37112,Soeun & Rolando,2,Private room,55,99,5.31,154
37113,Liv,1,Private room,147,177,1.62,324
37114,Studioplus,1,Entire home/apt,220,283,1.54,503
37115,Natalie,2,Entire home/apt,115,32,1.11,147
37116,Franz,3,Entire home/apt,44,44,2.23,88
37117,Ruth,1,Entire home/apt,298,300,2.0,598
37118,Bob,1,Entire home/apt,499,145,3.36,644
37119,Stephanie,3,Entire home/apt,150,2,2.8,152
37120,Nikia,1,Entire home/apt,80,0,0.12,80
37121,Omar,1,Entire home/apt,145,144,3.61,289
37122,Lisa And Julian,2,Private room,68,365,1.54,433
37123,Maria,2,Entire home/apt,150,35,0.16,185
37124,Lisa And Julian,2,Private room,70,344,2.51,414
37125,Brenda And Tim,1,Entire home/apt,240,93,5.22,333
37126,Renata,2,Entire home/apt,120,128,0.16,248
37127,Diogo,2,Entire home/apt,200,17,0.93,217
37128,Dilenia,3,Private room,50,44,1.36,94
37129,Betty&Sam,1,Private room,99,14,2.32,113
37130,Arianna,2,Private room,80,7,0.48,87
37131,Hayley,2,Entire home/apt,128,13,4.23,141
37132,Anita,2,Private room,49,174,4.08,223
37133,Keanna,1,Private room,100,71,1.58,171
37134,Daniel,2,Entire home/apt,119,0,0.47,119
37135,Ekaterina,2,Private room,60,317,6.78,377
37136,Vic,1,Entire home/apt,700,256,3.57,956
37137,Jay And Josh,2,Private room,65,310,3.83,375
37138,Dave,5,Private room,80,80,3.49,160
37139,Jay And Josh,2,Private room,52,320,1.72,372
37140,Jay And Josh,2,Private room,62,338,2.7,400
37141,Jhila,1,Entire home/apt,108,0,1.99,108
37142,Alvin,1,Private room,120,31,6.14,151
37143,Matthew,2,Private room,60,311,1.44,371
37144,Matthew,2,Private room,72,344,3.85,416
37145,Jonathan,3,Entire home/apt,90,83,0.79,173
37146,Jay,2,Private room,55,332,2.64,387
37147,Jay,2,Private room,55,322,2.96,377
37148,Jay,2,Private room,55,359,2.95,414
37149,Lixia,1,Entire home/apt,120,2,1.08,122
37151,Donna,1,Entire home/apt,170,14,0.27,184
37152,Casa Victoria,3,Private room,75,115,3.45,190
37153,Yoni,2,Private room,31,210,1.72,241
37155,Izzy,2,Private room,60,0,2.7,60
37157,Digna,2,Private room,65,328,1.18,393
37158,Digna,2,Private room,65,336,1.65,401
37159,Marcy,2,Private room,35,89,0.13,124
37160,Charlotte,2,Entire home/apt,300,3,0.8,303
37163,Tina,2,Private room,85,51,7.0,136
37164,Emmie,2,Entire home/apt,115,219,0.16,334
37165,Stacy & Simon,2,Entire home/apt,75,170,0.55,245
37166,Bryan,1,Private room,225,30,0.73,255
37167,Chiroy,1,Entire home/apt,129,0,1.63,129
37168,Nina,2,Private room,50,365,0.45,415
37169,Nina,2,Private room,50,326,0.38,376
37171,Nina,2,Private room,50,333,0.52,383
37174,Jillian,1,Entire home/apt,150,356,1.34,506
37175,Anchor,2,Shared room,24,89,1.65,113
37176,Anchor,2,Shared room,32,87,2.13,119
37177,Thiago Pereira,1,Entire home/apt,200,162,1.13,362
37178,Sara,1,Entire home/apt,119,120,3.43,239
37180,Lauren,2,Entire home/apt,305,43,1.89,348
37182,Simon,1,Entire home/apt,200,4,0.38,204
37183,Bono,1,Entire home/apt,206,199,1.55,405
37184,Mariano,1,Private room,160,0,0.62,160
37187,Youssef,3,Entire home/apt,349,303,3.29,652
37188,Bruna,3,Private room,70,188,0.39,258
37189,Amy,2,Entire home/apt,107,0,0.12,107
37190,Marta,1,Private room,38,73,2.33,111
37192,Siyi,2,Entire home/apt,139,134,1.67,273
37193,Melanie,1,Shared room,39,352,0.74,391
37195,Sidney,3,Entire home/apt,100,123,5.08,223
37196,Marielisa,2,Private room,62,125,0.87,187
37197,Roni,1,Private room,125,230,2.68,355
37198,JohnP,1,Private room,89,7,5.83,96
37199,JohnP,1,Private room,89,4,5.59,93
37200,Matt,2,Entire home/apt,180,76,5.44,256
37202,Estelle,4,Private room,45,123,2.1,168
37204,Mackenzey And Kelly,2,Entire home/apt,350,0,0.16,350
37205,Carmen,2,Private room,29,54,7.25,83
37207,Vance,1,Entire home/apt,200,5,0.12,205
37208,John,2,Private room,99,362,0.12,461
37209,Summer & Kamilya,2,Private room,90,0,0.59,90
37210,Maria,2,Private room,65,29,5.53,94
37211,Mohan,1,Entire home/apt,200,89,0.12,289
37212,Kahrej,1,Entire home/apt,175,0,0.36,175
37214,Etan,2,Entire home/apt,250,35,0.16,285
37215,Jordan,2,Entire home/apt,200,26,0.14,226
37217,Julie,2,Entire home/apt,125,0,1.65,125
37219,Rachel,1,Private room,60,18,0.14,78
37220,Niko,3,Entire home/apt,90,26,2.42,116
37222,Lea,2,Private room,50,0,0.31,50
37223,Radhames,2,Entire home/apt,60,289,3.18,349
37224,Ben,2,Private room,85,82,5.65,167
37225,Rosana,2,Private room,55,192,3.59,247
37226,Sara & Kevin,2,Entire home/apt,250,28,0.4,278
37227,Jamie,2,Private room,85,74,4.0,159
37228,Paul,1,Private room,355,230,0.66,585
37229,Elizabet,1,Entire home/apt,260,0,0.25,260
37230,Donald,2,Private room,55,0,1.3,55
37231,Jci,2,Private room,150,37,0.7,187
37232,Chezky,2,Private room,55,0,5.31,55
37233,Lakisha,2,Private room,58,179,2.14,237
37235,Lucile,2,Private room,90,193,0.33,283
37236,Jones,1,Entire home/apt,90,13,2.18,103
37237,Janet,1,Private room,399,176,1.23,575
37238,Rosana,2,Private room,55,167,3.43,222
37239,Rosana,2,Private room,55,209,4.25,264
37240,Rosana,2,Private room,72,239,6.43,311
37241,Julie,1,Entire home/apt,123,1,1.94,124
37242,Karlie,2,Private room,59,0,0.24,59
37243,Hana,1,Private room,45,66,0.16,111
37244,Raqueli,2,Private room,95,0,0.45,95
37245,Arnaud,1,Private room,65,188,2.34,253
37246,Studioplus,1,Entire home/apt,260,242,3.23,502
37247,Valeria,1,Entire home/apt,260,145,0.24,405
37248,Alex,3,Entire home/apt,73,233,8.35,306
37249,Karim,2,Private room,60,187,0.71,247
37250,Levi,2,Shared room,25,365,0.13,390
37251,Carl,2,Private room,150,0,0.86,150
37254,Dara,2,Entire home/apt,81,8,1.89,89
37256,Sharon,2,Private room,70,86,0.25,156
37257,Melih,3,Shared room,29,23,0.27,52
37258,Shell,1,Entire home/apt,160,71,0.15,231
37262,Alisa,2,Entire home/apt,150,153,1.85,303
37264,Dee,2,Private room,50,0,0.24,50
37265,Ellen,1,Entire home/apt,265,0,0.29,265
37266,Dee,2,Entire home/apt,211,38,0.13,249
37267,Ana,1,Private room,160,5,0.38,165
37268,John,1,Private room,99,332,0.69,431
37269,Alison,1,Entire home/apt,170,184,2.64,354
37270,Rachelle,1,Entire home/apt,299,0,0.9,299
37271,Briana,2,Entire home/apt,150,0,0.26,150
37272,Peter,2,Entire home/apt,200,6,0.68,206
37273,Marc,2,Entire home/apt,140,0,0.48,140
37275,Isaias,2,Private room,35,55,1.09,90
37276,Maria,1,Entire home/apt,125,0,0.26,125
37277,Jordan,2,Private room,90,329,0.37,419
37278,Serim,1,Private room,99,0,1.81,99
37279,Andy,4,Entire home/apt,350,323,0.41,673
37280,Hana,3,Private room,70,0,0.16,70
37281,Alvin,1,Private room,98,64,3.22,162
37282,Kazuya,1,Private room,40,246,0.38,286
37283,Sumana,2,Entire home/apt,150,3,0.68,153
37284,Daniel,1,Private room,66,107,0.12,173
37286,Reni,2,Private room,100,0,0.52,100
37287,Minerva,2,Private room,75,9,4.02,84
37288,Zach,1,Entire home/apt,150,5,0.53,155
37289,Phoebe,2,Entire home/apt,125,9,0.76,134
37290,Alvin,1,Private room,85,20,5.59,105
37291,Jay,2,Entire home/apt,175,164,2.86,339
37292,Alvin,1,Private room,90,61,5.04,151
37293,Song,1,Entire home/apt,199,228,5.37,427
37294,David,1,Entire home/apt,250,0,0.75,250
37295,Dilek,2,Entire home/apt,85,305,2.24,390
37296,Keegan,1,Entire home/apt,150,0,0.25,150
37297,Lewis,1,Entire home/apt,100,301,3.0,401
37298,Takara,1,Entire home/apt,399,201,4.29,600
37299,Alec,2,Private room,149,365,0.95,514
37300,Caitlyn,1,Entire home/apt,250,0,0.3,250
37301,Alec,2,Private room,139,363,2.04,502
37303,William,2,Entire home/apt,250,178,0.16,428
37304,Dot,2,Entire home/apt,174,3,1.13,177
37305,Erin,2,Entire home/apt,150,19,1.88,169
37306,Sophie,1,Private room,80,0,0.24,80
37307,Mr. G,2,Private room,100,348,0.95,448
37308,Firuza,2,Private room,75,133,0.85,208
37309,Banafsheh,2,Entire home/apt,109,0,0.37,109
37310,Dot,2,Private room,65,0,1.8,65
37313,Meaghan,1,Entire home/apt,189,2,0.86,191
37314,Muhammet,2,Private room,45,6,0.96,51
37315,Shuhel,3,Entire home/apt,120,6,3.66,126
37316,Maureen,1,Private room,125,191,4.06,316
37317,Jonathan,2,Private room,45,61,0.96,106
37318,Alfonso,1,Private room,120,0,0.16,120
37319,Caitlin,2,Entire home/apt,82,16,2.02,98
37320,Nipun,2,Private room,72,16,1.73,88
37321,Alex,2,Entire home/apt,200,35,0.38,235
37322,Hannah,2,Private room,500,180,0.14,680
37323,Elen,2,Entire home/apt,110,290,2.41,400
37324,Sophie,2,Private room,75,0,0.37,75
37325,Nikole,3,Private room,64,195,1.0,259
37326,"Roo, Nadine And Neil",2,Private room,100,336,1.55,436
37327,Zhen Zhen,3,Entire home/apt,100,88,2.86,188
37328,Marwa,5,Entire home/apt,140,340,1.57,480
37329,Sarah,1,Private room,83,6,3.0,89
37330,David M,1,Entire home/apt,200,254,2.13,454
37331,Karen,1,Entire home/apt,125,1,2.19,126
37333,Dilenia,3,Private room,60,17,1.44,77
37334,Roxanne,2,Private room,89,88,4.0,177
37335,Michael,3,Private room,90,49,1.0,139
37337,Katie,2,Entire home/apt,139,58,4.48,197
37338,Dan,2,Private room,70,0,0.48,70
37339,Chadanut,2,Private room,42,88,0.59,130
37340,Grace,1,Private room,85,0,1.35,85
37341,Kate,2,Entire home/apt,860,23,0.49,883
37342,Jane,1,Entire home/apt,195,181,6.45,376
37344,Peyton,1,Private room,120,0,0.13,120
37351,Kazuya,3,Private room,31,269,0.62,300
37352,Brey,4,Private room,100,177,0.26,277
37355,Roy,2,Entire home/apt,165,102,2.3,267
37356,Juliet,1,Entire home/apt,95,56,2.43,151
37358,Tiffany,2,Entire home/apt,250,311,3.17,561
37359,Benjamin,3,Private room,30,0,0.26,30
37361,Charles,1,Private room,250,3,0.14,253
37363,Nina,2,Private room,102,14,6.8,116
37364,Kiryl,2,Entire home/apt,200,144,3.57,344
37365,Dina,3,Private room,60,180,0.32,240
37366,Nina,2,Private room,102,20,5.81,122
37367,Marni,2,Entire home/apt,93,2,1.6,95
37368,Sarah,1,Private room,110,176,0.62,286
37369,Valentine,2,Private room,70,307,2.82,377
37370,Ramiro,3,Private room,80,29,2.0,109
37371,Maya,5,Private room,46,0,0.51,46
37372,Ashley,3,Private room,75,0,0.13,75
37373,Maureen,1,Private room,125,255,3.39,380
37374,Adela,1,Entire home/apt,110,0,1.89,110
37375,Sarah,1,Private room,145,0,0.24,145
37376,Alex,2,Entire home/apt,250,282,3.01,532
37377,Nikolas,1,Shared room,100,363,0.24,463
37379,Sylvia,1,Entire home/apt,121,0,1.07,121
37382,Harris,2,Entire home/apt,105,0,0.4,105
37384,Ruby,1,Private room,65,359,1.53,424
37385,Diane,4,Entire home/apt,90,157,0.16,247
37386,Olivia,1,Entire home/apt,109,0,0.45,109
37387,Carla,2,Private room,68,0,0.12,68
37388,Milica,1,Entire home/apt,170,128,2.84,298
37389,Julia,1,Shared room,39,365,0.16,404
37390,Harmony,2,Entire home/apt,100,283,4.25,383
37391,Sherley,3,Entire home/apt,298,365,1.51,663
37392,Kanchana,3,Private room,180,88,0.39,268
37393,Gunmala,1,Entire home/apt,250,1,0.31,251
37394,Amore,2,Private room,120,108,1.73,228
37396,Maria,2,Private room,50,31,6.19,81
37398,Bruce,1,Private room,40,0,0.21,40
37399,"Christine,",1,Entire home/apt,189,323,2.11,512
37400,Stephanie,1,Entire home/apt,500,5,1.55,505
37401,Marcos,2,Private room,56,10,0.13,66
37403,OneBaz106,1,Private room,78,68,1.83,146
37404,Mercedes,2,Private room,45,6,0.78,51
37405,Hannah,2,Entire home/apt,250,0,0.33,250
37406,Jessica,2,Private room,65,175,4.2,240
37408,Sean,2,Private room,45,334,5.0,379
37409,Genesis,1,Private room,42,40,4.23,82
37411,Maryana,2,Private room,100,0,0.13,100
37412,Lana,1,Private room,103,99,4.58,202
37413,Robin,3,Entire home/apt,115,10,1.88,125
37414,Max,1,Entire home/apt,90,170,1.87,260
37415,Bryan,2,Private room,85,127,4.34,212
37416,Evan,1,Entire home/apt,229,70,2.58,299
37417,Javier,2,Private room,95,79,4.34,174
37419,Stella,1,Private room,80,8,3.53,88
37420,Roman,1,Entire home/apt,140,0,0.22,140
37421,Rita,3,Private room,66,327,2.99,393
37422,Onur,2,Private room,20,14,1.66,34
37423,Eugenia,3,Private room,68,0,0.61,68
37424,Laura,2,Entire home/apt,108,8,1.87,116
37425,Laura,2,Entire home/apt,143,9,0.24,152
37426,Morgan,1,Entire home/apt,132,3,1.25,135
37427,Ellouise,5,Entire home/apt,109,121,4.44,230
37428,Laith,1,Entire home/apt,200,263,1.35,463
37429,Mona,1,Entire home/apt,150,3,0.44,153
37430,Anya,1,Private room,70,87,2.9,157
37431,Andrew,2,Entire home/apt,130,10,0.63,140
37432,Gerard,1,Entire home/apt,195,143,0.16,338
37433,Allen,2,Entire home/apt,191,28,5.94,219
37434,Chris,1,Entire home/apt,250,0,0.27,250
37435,Alexander,1,Entire home/apt,350,326,0.74,676
37436,Тest,1,Shared room,147,0,1.32,147
37437,Hope,2,Private room,50,188,0.65,238
37438,Linda,2,Entire home/apt,79,157,0.25,236
37439,Katherine,2,Entire home/apt,150,0,1.03,150
37440,Lucia,2,Private room,70,71,1.45,141
37441,Wu,3,Private room,200,364,1.7,564
37442,Rita,3,Private room,60,19,1.45,79
37443,Caitlin,1,Entire home/apt,300,11,0.26,311
37444,Marie,2,Entire home/apt,200,5,1.0,205
37445,Jeane',1,Private room,100,58,1.81,158
37446,Eli,2,Entire home/apt,200,360,1.21,560
37447,Steven,2,Private room,68,365,0.47,433
37448,Felipe,1,Private room,55,0,4.39,55
37449,Carly,1,Shared room,39,326,0.52,365
37451,Hanine,3,Private room,50,85,1.37,135
37452,Susan,1,Entire home/apt,160,302,3.28,462
37453,Cynthia,4,Private room,75,311,0.13,386
37454,Hazel,1,Entire home/apt,399,234,3.83,633
37455,Nneka,2,Entire home/apt,115,278,11.03,393
37456,Scott,1,Entire home/apt,150,319,0.67,469
37458,Darry,3,Private room,59,365,0.33,424
37459,Akeema,2,Private room,38,238,0.27,276
37460,Olivia,2,Private room,45,50,3.61,95
37461,Maya,2,Entire home/apt,100,2,0.4,102
37462,Rachel,2,Entire home/apt,100,35,0.48,135
37463,Max And Kathy,4,Private room,60,304,3.54,364
37464,McKenzie,2,Entire home/apt,155,0,1.06,155
37465,Bree,2,Entire home/apt,120,7,0.47,127
37467,Chamber Hotel,1,Private room,191,217,3.0,408
37469,Nôm,2,Entire home/apt,120,0,0.14,120
37471,Nôm,2,Entire home/apt,120,0,0.38,120
37472,Portia,3,Entire home/apt,485,347,2.99,832
37473,Portia,3,Private room,125,253,1.0,378
37474,Kat,1,Private room,140,0,0.13,140
37475,Portia,3,Private room,125,253,0.32,378
37476,Niko,2,Private room,63,321,1.72,384
37477,Niko,2,Private room,70,293,2.95,363
37479,Antonieta,2,Private room,50,40,0.42,90
37482,Kevin,2,Private room,60,0,1.38,60
37483,Mengxiao,3,Private room,69,0,0.53,69
37484,Denis,1,Private room,40,51,0.83,91
37485,Carla,2,Entire home/apt,120,334,4.62,454
37486,Aileen,2,Private room,50,0,1.1,50
37487,Alex,1,Private room,92,51,5.57,143
37488,Shared Stay-JFK The Hugh Suite,3,Private room,50,342,7.28,392
37489,Lola,1,Entire home/apt,155,29,1.74,184
37491,Ife,3,Entire home/apt,80,87,0.94,167
37492,Aileen,2,Entire home/apt,138,0,0.37,138
37494,Norma,3,Entire home/apt,151,309,4.21,460
37495,Vanessa,2,Private room,85,42,1.0,127
37496,John & Dee,2,Entire home/apt,170,0,2.79,170
37497,Nicholas,2,Entire home/apt,81,0,0.73,81
37498,Matt,2,Entire home/apt,150,69,0.5,219
37499,Oriana,2,Private room,85,12,0.16,97
37500,Ali,1,Private room,62,9,0.87,71
37501,Stella,1,Private room,75,10,4.72,85
37502,Linda,2,Private room,40,0,0.61,40
37503,Johann,1,Entire home/apt,100,0,1.34,100
37504,Luis,2,Entire home/apt,275,0,0.13,275
37505,Jenny,1,Private room,139,28,1.75,167
37506,Mark,1,Private room,98,179,0.98,277
37507,Jennyfer,3,Private room,100,0,0.12,100
37508,Goodyoga,2,Private room,100,353,1.38,453
37510,Anna,2,Entire home/apt,149,4,0.96,153
37512,Emily,1,Entire home/apt,260,257,1.58,517
37513,Nino,2,Private room,60,31,1.16,91
37515,Obed,2,Entire home/apt,135,206,2.7,341
37516,Evan,2,Private room,60,58,1.59,118
37517,Alan,2,Entire home/apt,119,4,0.79,123
37518,Vander,1,Entire home/apt,130,280,0.16,410
37519,Alex,1,Private room,75,0,1.55,75
37520,Christine,1,Entire home/apt,150,66,0.13,216
37521,Leigh,2,Entire home/apt,150,0,0.74,150
37522,Adrian,2,Entire home/apt,250,43,1.99,293
37523,Joel,1,Entire home/apt,200,17,0.41,217
37524,Alex,1,Private room,79,43,5.47,122
37525,Vivek,1,Private room,250,180,0.24,430
37526,Johnny,1,Private room,89,0,2.84,89
37527,Eli,1,Entire home/apt,179,268,2.65,447
37528,Pettrina,2,Private room,38,365,1.51,403
37529,Jordan,3,Private room,25,66,0.29,91
37530,Fabio,1,Private room,150,0,1.43,150
37531,Louis,2,Private room,43,2,1.33,45
37532,Bruce,1,Entire home/apt,295,147,0.51,442
37534,Sevilay,2,Private room,75,311,0.51,386
37535,Tevin,2,Private room,80,162,2.76,242
37536,Esther,1,Private room,180,158,0.31,338
37537,Ben,1,Private room,99,0,0.93,99
37538,Maruf,2,Entire home/apt,200,290,3.27,490
37539,Michelle,1,Entire home/apt,95,88,4.0,183
37542,Charles,3,Private room,57,347,3.28,404
37543,Hollis,2,Entire home/apt,75,4,2.47,79
37544,Funda,3,Private room,45,29,2.5,74
37546,Germaine,1,Entire home/apt,179,10,0.49,189
37547,Michael,2,Entire home/apt,160,0,2.38,160
37548,Esther,2,Private room,60,0,0.12,60
37549,Heidi,2,Private room,55,126,1.08,181
37550,Mariela,2,Entire home/apt,85,263,1.6,348
37551,Alejandro,2,Entire home/apt,185,3,4.0,188
37552,Martha,3,Private room,50,137,0.56,187
37553,Walkiris,3,Private room,110,357,0.16,467
37554,Chris,1,Private room,125,238,0.32,363
37555,Maria Fernanda,2,Entire home/apt,300,273,2.06,573
37556,Carlton,3,Entire home/apt,160,359,0.41,519
37557,Miller,1,Private room,68,12,2.02,80
37561,Rachel,2,Entire home/apt,150,50,2.89,200
37562,Tylor,4,Private room,60,296,6.96,356
37564,Jose,4,Entire home/apt,55,349,3.36,404
37566,Jimmy,3,Private room,65,349,4.26,414
37567,Richard,4,Private room,65,295,4.32,360
37568,David,2,Private room,48,0,0.25,48
37569,Jimmy,3,Private room,38,207,5.12,245
37570,Joshua,1,Entire home/apt,1115,0,0.38,1115
37571,Andrew,1,Private room,80,8,7.83,88
37572,Dr.,1,Entire home/apt,175,232,3.15,407
37573,Zachary,2,Entire home/apt,175,142,1.65,317
37575,Maksum,1,Entire home/apt,265,95,4.16,360
37577,Jon,3,Shared room,58,267,0.64,325
37579,Shola,2,Entire home/apt,135,17,0.71,152
37580,Julia,2,Entire home/apt,74,0,0.57,74
37581,William,2,Entire home/apt,81,94,2.44,175
37582,美德,3,Shared room,35,236,3.13,271
37583,Miki,1,Private room,90,82,0.41,172
37584,Olivia,2,Entire home/apt,285,74,3.57,359
37585,Eden,3,Private room,95,0,0.44,95
37586,Lilly,2,Private room,48,0,0.87,48
37587,Alyssa,1,Entire home/apt,275,0,0.29,275
37588,Andy,1,Entire home/apt,650,0,0.16,650
37590,Vincent,2,Private room,80,0,0.4,80
37591,Keilon,2,Entire home/apt,100,75,1.09,175
37592,Faridath,2,Private room,120,63,3.24,183
37593,Victor,1,Entire home/apt,150,14,0.91,164
37594,Mark,2,Private room,90,32,0.13,122
37595,Marceline,2,Entire home/apt,175,326,0.54,501
37597,Nôm,2,Entire home/apt,120,0,0.75,120
37598,Taz,1,Private room,135,316,6.2,451
37599,Andrew,2,Entire home/apt,160,2,0.66,162
37600,Yvette,1,Private room,40,188,0.27,228
37601,Anna & Frank,1,Private room,95,141,5.0,236
37602,Hajah,1,Private room,68,95,0.64,163
37603,Marshall,2,Entire home/apt,49,164,2.64,213
37605,Stephanie,1,Entire home/apt,202,88,1.1,290
37607,Pariis,5,Private room,90,262,0.95,352
37608,Guangnan,3,Entire home/apt,133,21,1.27,154
37610,Olga,3,Private room,60,249,0.32,309
37611,Melissa,2,Entire home/apt,99,0,0.13,99
37612,Ric,2,Entire home/apt,165,34,5.19,199
37613,Anna & Frank,1,Private room,95,172,4.15,267
37614,Emmanuel,1,Entire home/apt,59,143,3.25,202
37615,Taz,1,Private room,145,283,7.5,428
37616,Anna & Frank,1,Private room,95,163,4.0,258
37617,Rena,2,Private room,60,142,8.97,202
37618,Jean,1,Private room,90,112,1.78,202
37619,Vanessa,2,Private room,60,365,0.14,425
37620,Stella,1,Private room,80,9,4.78,89
37621,Gloria,2,Private room,60,0,0.25,60
37623,Soeun & Rolando,2,Private room,50,57,5.38,107
37624,Michael And Brooke,2,Private room,93,73,2.7,166
37625,Samuel,2,Entire home/apt,75,179,1.87,254
37626,Alex,1,Entire home/apt,150,0,0.53,150
37627,Gabriel,1,Private room,107,141,2.81,248
37628,Jennifer,2,Entire home/apt,149,0,1.0,149
37629,Jc,1,Entire home/apt,220,14,1.0,234
37630,Dee Daisy And Peter,2,Private room,65,361,3.25,426
37631,Digna,2,Private room,65,333,1.77,398
37632,Birce,1,Entire home/apt,220,0,0.32,220
37633,Rah,3,Private room,50,311,0.27,361
37634,Tristan,2,Entire home/apt,700,174,0.32,874
37635,Sol,1,Entire home/apt,99,332,0.28,431
37636,Ian,2,Entire home/apt,175,176,2.37,351
37638,Luca,1,Entire home/apt,219,6,0.8,225
37640,Miss Carolyn,2,Entire home/apt,70,281,0.42,351
37642,Di,3,Private room,69,35,0.13,104
37643,Gaia,2,Private room,30,250,0.26,280
37644,John,2,Shared room,42,0,0.67,42
37646,Maria,3,Entire home/apt,98,131,4.02,229
37648,Wei,3,Entire home/apt,120,4,0.32,124
37649,Cady,1,Entire home/apt,225,207,1.26,432
37650,Ryan,1,Entire home/apt,158,323,1.58,481
37651,Sarah,1,Entire home/apt,130,0,1.08,130
37652,Melitza,3,Entire home/apt,70,0,10.29,70
37653,Barbara,2,Private room,70,342,0.13,412
37654,Jon,3,Private room,50,365,1.38,415
37655,Kay,1,Private room,90,17,3.0,107
37656,Chantelle,1,Entire home/apt,250,280,3.17,530
37657,Tyler,1,Entire home/apt,200,0,0.45,200
37658,Annick,4,Private room,49,363,3.21,412
37659,Esperanza,1,Entire home/apt,160,0,1.49,160
37660,Mike,2,Entire home/apt,150,0,1.36,150
37661,Annick,4,Entire home/apt,130,363,1.45,493
37662,Pablo,1,Private room,170,19,0.16,189
37663,Liz,1,Entire home/apt,120,0,0.27,120
37664,Sabrina,2,Private room,100,6,2.75,106
37665,Sydney,2,Private room,45,69,1.06,114
37666,Dan,1,Entire home/apt,175,13,1.29,188
37667,Any,3,Private room,70,34,4.25,104
37668,Amhalise,2,Entire home/apt,200,95,0.41,295
37669,Jessy & Christian,3,Shared room,30,365,0.76,395
37670,Tiffany,1,Entire home/apt,195,0,0.56,195
37671,Morian,2,Private room,55,0,0.53,55
37673,Vladimir,2,Private room,60,173,0.13,233
37674,Emily,1,Entire home/apt,129,15,1.18,144
37676,Miki,1,Private room,55,0,0.39,55
37677,Alex,1,Entire home/apt,399,75,0.47,474
37678,Jake,1,Entire home/apt,700,126,5.7,826
37680,Ines,3,Entire home/apt,180,122,0.67,302
37681,Karel,4,Private room,60,326,1.11,386
37682,Paula,2,Entire home/apt,110,284,2.56,394
37684,Izi,1,Entire home/apt,195,138,0.56,333
37686,Jessica,2,Entire home/apt,150,11,0.9,161
37687,Mario,1,Entire home/apt,190,61,1.6,251
37688,Laurie,2,Private room,64,250,0.25,314
37689,Fozia,2,Entire home/apt,110,276,2.45,386
37691,Lili,2,Entire home/apt,105,46,0.12,151
37692,Simi,1,Entire home/apt,212,272,0.69,484
37693,Fritz,2,Entire home/apt,110,90,5.21,200
37694,Maria,1,Entire home/apt,140,0,0.37,140
37696,Genevieve,1,Private room,74,195,3.98,269
37697,James,1,Private room,35,0,1.0,35
37698,Dev,2,Entire home/apt,110,19,7.7,129
37699,Carly,2,Private room,65,0,1.15,65
37700,Thomas,1,Private room,110,0,1.06,110
37701,Andrew,1,Private room,129,177,1.37,306
37702,Shared Stay-JFK The Hugh Suite,3,Private room,59,340,9.09,399
37703,Lidor,3,Entire home/apt,150,121,0.64,271
37704,Andrew,1,Private room,129,177,1.58,306
37705,Kelcie,4,Private room,24,0,0.52,24
37706,Diana,3,Shared room,40,178,0.13,218
37707,Billye And Joe,2,Private room,349,89,0.56,438
37708,Bonnie,2,Entire home/apt,250,179,0.85,429
37710,Anna & Frank,1,Private room,90,147,4.02,237
37711,Sara,2,Private room,125,0,4.34,125
37712,Amna,1,Private room,175,362,0.43,537
37713,Vin,1,Entire home/apt,165,0,1.27,165
37714,Thaw Dar,1,Entire home/apt,99,0,1.46,99
37715,Jordan,1,Private room,55,169,2.07,224
37716,Linwood,2,Entire home/apt,125,170,0.61,295
37717,Pietro,1,Entire home/apt,300,217,3.82,517
37719,Dana,1,Entire home/apt,225,357,1.11,582
37720,Hudson River Hotel,1,Private room,249,87,1.06,336
37721,Andy,2,Private room,37,341,0.33,378
37722,Daniel,2,Entire home/apt,295,0,0.58,295
37724,Daniel,2,Private room,43,0,0.79,43
37725,Dee,1,Entire home/apt,100,0,0.64,100
37726,Valentyn,1,Entire home/apt,520,38,1.19,558
37727,Anting,2,Private room,119,365,0.16,484
37728,Nichole,1,Private room,45,10,2.54,55
37730,John,1,Private room,75,365,0.59,440
37731,Anting,2,Private room,119,1,0.32,120
37732,Eric,2,Entire home/apt,137,63,2.78,200
37733,Patryk,2,Entire home/apt,148,34,5.0,182
37735,Hd,2,Entire home/apt,40,57,2.0,97
37736,Roman,2,Private room,59,147,1.86,206
37737,Maxi,1,Private room,84,6,0.37,90
37738,Stella,2,Private room,50,227,6.32,277
37739,Stella,2,Private room,46,246,3.6,292
37740,Stella,2,Private room,35,316,3.94,351
37741,Alex And Zeena,1,Private room,85,362,3.18,447
37743,Paul And Gia,2,Entire home/apt,130,9,4.55,139
37744,İlyas,2,Entire home/apt,101,323,0.26,424
37745,Rachel,3,Entire home/apt,114,3,1.53,117
37747,Kathryn,1,Entire home/apt,175,0,1.22,175
37748,Dawa & Phurpa,3,Entire home/apt,105,113,3.85,218
37749,Liam,3,Private room,63,365,1.15,428
37750,Jorge,3,Private room,45,0,0.88,45
37751,Elizabeth,2,Private room,39,236,1.64,275
37752,Cate,1,Entire home/apt,165,215,0.76,380
37753,Thomas,2,Entire home/apt,125,361,1.6,486
37754,Ms. Debra,3,Private room,83,322,0.27,405
37755,Jose,2,Private room,110,176,0.38,286
37756,Mj,1,Entire home/apt,250,8,0.62,258
37757,Jeremy,3,Private room,55,362,3.87,417
37761,Tyler & Lacey,1,Entire home/apt,399,248,3.91,647
37763,Laura,3,Entire home/apt,100,40,0.32,140
37764,Christine,1,Entire home/apt,175,66,1.21,241
37765,C-S,1,Private room,68,0,0.64,68
37766,Lisa And Jorge,2,Entire home/apt,300,128,0.85,428
37769,Travis,1,Entire home/apt,250,0,0.13,250
37771,Haruhisa,3,Private room,30,1,0.3,31
37777,Daisy,1,Entire home/apt,550,199,6.67,749
37779,Chamber Hotel,1,Entire home/apt,276,192,1.0,468
37781,Andrew,2,Entire home/apt,162,5,0.51,167
37784,Gabriela,2,Shared room,39,89,0.77,128
37785,Ben,2,Entire home/apt,70,0,0.93,70
37786,Juan C,1,Entire home/apt,140,272,4.13,412
37788,Lia,1,Private room,115,0,7.47,115
37790,Rachael,2,Entire home/apt,200,188,0.14,388
37791,Sophia,2,Entire home/apt,62,284,0.75,346
37793,Jas,3,Private room,60,363,2.43,423
37794,Mamadou,3,Entire home/apt,100,161,1.69,261
37795,Taz,1,Shared room,70,314,7.47,384
37796,Dwain,2,Entire home/apt,140,201,3.68,341
37797,Kayla,2,Private room,44,172,4.25,216
37799,Gabriel,1,Private room,199,359,2.49,558
37800,Matt,2,Entire home/apt,475,354,0.47,829
37801,Berk,2,Entire home/apt,94,11,0.57,105
37802,Max And Kathy,4,Private room,55,301,4.75,356
37803,Heidi,2,Private room,50,281,0.77,331
37804,Margaux,2,Entire home/apt,300,28,0.32,328
37805,Keanna,1,Private room,215,91,0.42,306
37806,Derek,1,Entire home/apt,165,1,0.28,166
37809,Careen,2,Entire home/apt,99,253,0.94,352
37810,Liam,1,Entire home/apt,200,0,0.29,200
37811,Luis,3,Private room,69,280,0.53,349
37812,Christian,2,Entire home/apt,150,264,0.21,414
37813,Ernesto,3,Entire home/apt,170,346,1.55,516
37814,Karl,2,Entire home/apt,120,31,0.61,151
37815,Marina,1,Entire home/apt,380,156,0.51,536
37816,Matt & Crutch,2,Entire home/apt,120,71,1.47,191
37817,Sara,2,Private room,34,204,3.16,238
37818,Shogo,3,Private room,32,0,0.47,32
37819,Ed,2,Private room,135,355,1.98,490
37820,Carly,2,Entire home/apt,150,66,2.26,216
37821,Thomas,3,Entire home/apt,200,273,1.19,473
37822,Daria,1,Private room,145,37,1.59,182
37823,Sharon,1,Entire home/apt,132,123,2.32,255
37824,Tracy,1,Entire home/apt,250,78,0.9,328
37826,Rachel,1,Entire home/apt,125,67,0.32,192
37827,Hugo,3,Private room,75,52,0.32,127
37828,Vee,1,Entire home/apt,692,256,4.36,948
37829,Luis,3,Private room,79,315,0.16,394
37830,Jean Charles,2,Entire home/apt,95,8,0.15,103
37831,Victor,1,Entire home/apt,300,5,1.92,305
37833,Daphne,2,Entire home/apt,147,14,1.84,161
37834,Jose,1,Private room,35,4,4.25,39
37836,Josephine,1,Private room,40,0,0.26,40
37837,Kevin,2,Private room,80,35,8.99,115
37838,Dorah,1,Private room,105,191,1.28,296
37839,Anthony,1,Entire home/apt,350,5,0.16,355
37841,Francois,2,Entire home/apt,270,20,0.32,290
37842,Ondine,2,Private room,80,22,0.16,102
37843,Caroline,2,Private room,50,0,0.15,50
37844,Jaime,2,Entire home/apt,300,0,0.16,300
37845,Douglas,2,Entire home/apt,195,112,1.71,307
37846,Alon,1,Entire home/apt,200,0,0.49,200
37847,Edouard,1,Entire home/apt,400,3,0.49,403
37848,Erica,1,Private room,200,0,1.13,200
37849,Adriana,3,Entire home/apt,80,0,0.61,80
37851,Brad,2,Entire home/apt,150,1,0.25,151
37852,Megan,1,Entire home/apt,90,108,0.46,198
37853,Sunny,1,Private room,100,248,9.62,348
37854,Brian,1,Private room,50,6,4.81,56
37855,Brian,1,Private room,50,112,4.84,162
37856,Jenny,4,Private room,39,86,4.36,125
37857,Nicholas,1,Entire home/apt,200,283,2.83,483
37859,Mitch,2,Private room,85,0,0.27,85
37860,Valentine,3,Private room,65,277,6.75,342
37861,Claudio,1,Private room,120,357,6.0,477
37862,Hypatia,2,Entire home/apt,64,6,0.92,70
37863,Reid,2,Entire home/apt,200,11,0.68,211
37865,Chavisa,2,Entire home/apt,100,0,0.16,100
37866,Caitlin,2,Entire home/apt,100,0,0.16,100
37867,Daniela,2,Private room,105,148,0.28,253
37868,Suket,3,Private room,89,24,1.73,113
37869,Rémi,1,Private room,100,6,1.09,106
37870,Konah,2,Private room,80,189,1.86,269
37871,Jonathan,3,Entire home/apt,220,144,7.53,364
37872,Siyi,2,Entire home/apt,139,238,2.97,377
37873,Alissa,1,Private room,75,2,3.73,77
37875,Sunny,1,Private room,90,261,7.24,351
37876,Youssef,3,Entire home/apt,299,354,1.6,653
37877,Carlos & Vielca,4,Entire home/apt,99,360,1.05,459
37878,Cris,3,Private room,45,47,1.5,92
37880,Ashley,4,Entire home/apt,98,327,4.46,425
37881,Luis,1,Private room,50,170,1.45,220
37882,Nikki,1,Entire home/apt,75,361,1.42,436
37883,Amanda,1,Entire home/apt,250,0,0.55,250
37884,Patricia,2,Entire home/apt,150,7,0.4,157
37885,Vera,1,Entire home/apt,199,358,1.59,557
37886,Gabriel,3,Entire home/apt,175,168,0.93,343
37887,Fede,2,Private room,42,0,0.32,42
37888,Endy,1,Entire home/apt,201,227,4.21,428
37889,Wesley,2,Entire home/apt,150,0,0.16,150
37890,Carissa,1,Entire home/apt,89,11,2.83,100
37891,Marcus,2,Private room,50,0,0.37,50
37892,Bridget,2,Entire home/apt,170,0,0.39,170
37893,Manuel,2,Entire home/apt,210,4,0.44,214
37894,Khalid,3,Entire home/apt,110,137,4.38,247
37895,Kerri-Ann,2,Entire home/apt,200,76,3.85,276
37896,John,2,Private room,65,89,0.59,154
37897,Anting,1,Entire home/apt,179,348,0.57,527
37898,Paula,2,Entire home/apt,82,26,0.42,108
37899,Christina,1,Entire home/apt,180,334,2.38,514
37900,Rana,2,Entire home/apt,105,0,0.16,105
37901,Vera,2,Entire home/apt,174,126,3.6,300
37903,Sam,2,Entire home/apt,125,4,2.21,129
37904,Judit,3,Private room,100,161,0.42,261
37906,Alana,1,Entire home/apt,400,0,1.92,400
37907,Kelly,2,Private room,45,276,0.56,321
37908,Julia,2,Entire home/apt,270,125,0.14,395
37909,Jun Jun,3,Private room,75,75,0.39,150
37910,Michael,1,Entire home/apt,241,23,1.06,264
37912,Sally,1,Entire home/apt,95,1,6.95,96
37913,Daniela,1,Entire home/apt,225,0,0.16,225
37914,Brian,1,Private room,70,114,4.88,184
37915,Justine,1,Entire home/apt,115,0,1.06,115
37917,Askhat,2,Private room,80,257,2.94,337
37918,Tosin,3,Private room,85,362,0.38,447
37919,Dorsey,1,Entire home/apt,160,0,2.7,160
37920,Anthony,2,Entire home/apt,85,313,0.44,398
37921,Michael,2,Private room,75,9,5.74,84
37922,Elizabeth,4,Private room,60,310,1.19,370
37923,Dan,2,Private room,50,129,1.21,179
37924,Jean,2,Entire home/apt,75,200,1.0,275
37925,Jeanny,3,Private room,70,90,0.38,160
37926,Jack,1,Entire home/apt,400,89,0.31,489
37928,Ikwo,2,Private room,40,363,1.67,403
37929,Grace,2,Entire home/apt,93,5,0.46,98
37930,Damian,3,Private room,70,105,0.4,175
37931,Jessica,1,Private room,85,0,0.14,85
37932,Molly & Justin,3,Entire home/apt,100,310,5.55,410
37933,Cazzie,2,Private room,60,0,0.79,60
37934,Richard,2,Private room,50,66,0.13,116
37935,Gabriel,1,Private room,107,156,2.5,263
37936,Ji Han,1,Private room,43,5,0.39,48
37937,Tresanna,2,Private room,75,21,3.66,96
37938,Tresanna,2,Private room,65,21,2.48,86
37939,Anchor,2,Shared room,24,85,1.49,109
37940,Yaacov,1,Entire home/apt,150,338,0.27,488
37942,Dana,2,Entire home/apt,135,45,0.68,180
37943,Blueground,1,Entire home/apt,267,189,0.27,456
37945,Chiara,2,Entire home/apt,120,196,5.27,316
37946,Andrew,1,Entire home/apt,130,1,1.13,131
37948,Christian,1,Entire home/apt,100,0,0.27,100
37950,Ashraf,3,Private room,80,57,2.5,137
37951,Ciara,2,Private room,75,35,0.53,110
37952,Criselis,2,Private room,50,0,1.0,50
37953,Nicolas,2,Entire home/apt,129,81,3.96,210
37954,Yaacov,1,Entire home/apt,150,338,0.96,488
37957,Yaacov,1,Entire home/apt,150,338,0.67,488
37958,Kieu&Jimmy,2,Entire home/apt,160,246,4.65,406
37959,Jack,2,Entire home/apt,450,11,0.66,461
37960,Hernan,2,Private room,75,0,0.26,75
37963,S Xander,1,Private room,50,0,0.16,50
37964,Ray,2,Entire home/apt,200,8,0.25,208
37965,Alexia,1,Entire home/apt,350,5,0.48,355
37966,Lauren,1,Entire home/apt,200,7,0.95,207
37967,Alberto,3,Private room,85,363,2.5,448
37968,Harvey,2,Entire home/apt,200,0,0.66,200
37969,Nora,1,Private room,75,7,3.14,82
37970,Dina,1,Entire home/apt,249,0,1.82,249
37972,Shep,2,Private room,55,142,2.31,197
37973,Chanhee,3,Private room,43,0,0.8,43
37974,Brian,1,Private room,90,43,0.59,133
37976,XaXa,2,Private room,60,0,0.48,60
37979,Jess,1,Private room,159,209,4.39,368
37980,Silver,1,Private room,220,365,0.6,585
37981,Mike,1,Entire home/apt,199,171,2.56,370
37984,Rose,1,Entire home/apt,150,49,1.56,199
37985,Barthelemy,1,Private room,100,45,0.85,145
37986,Bethlehem,1,Entire home/apt,150,11,3.97,161
37987,David,2,Entire home/apt,150,24,0.46,174
37988,Sadio,4,Entire home/apt,87,7,3.42,94
37989,Eb,1,Private room,85,0,0.28,85
37990,Matthew,2,Entire home/apt,110,0,0.89,110
37991,Damian,3,Private room,70,186,0.4,256
37993,Blueground,1,Entire home/apt,269,234,0.16,503
37997,Co,1,Private room,59,0,0.36,59
37998,Studioplus,1,Entire home/apt,220,315,1.48,535
37999,Theo,2,Entire home/apt,170,191,5.24,361
38000,Rasmus,1,Entire home/apt,5000,150,0.38,5150
38001,Kat,3,Entire home/apt,62,6,0.76,68
38002,Maria Fernanda,2,Private room,99,46,1.16,145
38003,Maria,2,Entire home/apt,180,156,0.63,336
38005,Adero,2,Entire home/apt,57,0,0.8,57
38006,Maria,2,Entire home/apt,250,360,0.62,610
38007,Lorenzo,1,Private room,190,0,0.53,190
38008,Leslie,5,Entire home/apt,120,166,1.92,286
38009,Mike,1,Entire home/apt,300,7,1.06,307
38011,Mikki & Doni,2,Entire home/apt,135,80,4.01,215
38012,Johanna,1,Private room,60,161,1.53,221
38013,Marie,1,Entire home/apt,175,110,0.9,285
38014,Jackie,1,Entire home/apt,345,21,1.92,366
38016,Michael,2,Entire home/apt,130,11,1.0,141
38017,Lina,1,Entire home/apt,182,64,3.85,246
38020,Leonardo,2,Private room,90,78,5.37,168
38021,Emmanuel,1,Entire home/apt,175,46,0.16,221
38022,Vena,2,Private room,35,83,1.32,118
38023,Fuchsia,2,Entire home/apt,103,11,0.46,114
38024,Tosin,3,Private room,70,361,1.69,431
38025,Belen,1,Private room,100,0,0.16,100
38026,Tosin,3,Private room,50,363,1.55,413
38027,Elle,2,Entire home/apt,125,339,2.58,464
38028,Guy,2,Private room,60,14,1.89,74
38029,Caitlyn,1,Private room,70,27,2.44,97
38030,Nôm,1,Entire home/apt,110,0,0.2,110
38032,Nôm,1,Entire home/apt,120,0,0.77,120
38033,Annette,1,Private room,115,177,0.55,292
38034,Gal,2,Entire home/apt,219,332,2.5,551
38035,Susanna And Ricki,1,Entire home/apt,250,51,3.44,301
38036,Latasha,3,Entire home/apt,135,158,10.67,293
38037,Amy,2,Entire home/apt,90,0,0.16,90
38038,Iryna,2,Private room,55,83,5.74,138
38039,Angely,1,Private room,75,0,0.66,75
38041,Sky,3,Entire home/apt,155,287,7.6,442
38042,Jonathan,2,Private room,70,0,0.14,70
38043,Ines,3,Private room,85,278,0.29,363
38044,Jay,1,Private room,60,89,2.01,149
38045,Afrah,2,Private room,59,148,0.75,207
38046,Farah,2,Entire home/apt,115,0,0.15,115
38047,Fiona,3,Private room,73,87,1.17,160
38049,Melissa,1,Entire home/apt,275,0,0.61,275
38050,Caroline,2,Private room,100,311,0.26,411
38052,Catalina,2,Private room,40,66,0.96,106
38053,Raoul&Nats,2,Private room,75,84,0.86,159
38054,Adeola,3,Entire home/apt,250,348,0.63,598
38055,Mamadou,2,Private room,28,0,0.16,28
38056,Wira,2,Entire home/apt,150,42,0.48,192
38057,Abby,2,Shared room,30,0,0.66,30
38058,Kristie,1,Entire home/apt,170,170,0.84,340
38059,Betty,3,Private room,90,90,0.16,180
38060,Nina,3,Private room,66,312,2.73,378
38062,Matthew,2,Entire home/apt,300,161,0.32,461
38063,Stacie,1,Entire home/apt,120,0,0.16,120
38064,Jennifer,3,Entire home/apt,103,0,0.16,103
38065,Marcela,3,Private room,43,0,0.55,43
38067,Charles,3,Entire home/apt,55,40,1.42,95
38068,Alberto,1,Entire home/apt,240,24,4.19,264
38070,Sasha,2,Private room,50,0,3.98,50
38071,Julia,2,Entire home/apt,85,0,0.53,85
38072,Zainab,1,Private room,68,19,4.25,87
38073,Camila,1,Entire home/apt,150,0,0.13,150
38074,Alisa,2,Entire home/apt,150,179,1.27,329
38075,Joe,1,Private room,150,272,0.66,422
38076,Dora,3,Private room,60,89,0.16,149
38077,Nbeki,1,Entire home/apt,499,236,1.98,735
38078,Simona,2,Private room,60,64,0.14,124
38079,Shareef,1,Private room,47,270,4.04,317
38080,Joe,1,Private room,150,267,0.79,417
38081,Joe,1,Private room,150,293,0.96,443
38082,Gabriel,1,Private room,179,327,3.45,506
38083,Gabriel,1,Private room,199,324,3.21,523
38085,Colleen,3,Private room,150,0,0.55,150
38086,Sean,1,Entire home/apt,200,71,0.68,271
38088,Carrie,2,Private room,50,0,0.43,50
38089,Jocelyn,2,Entire home/apt,100,25,1.32,125
38090,Maximilian,2,Entire home/apt,99,31,0.41,130
38091,Bozhena,1,Entire home/apt,269,1,3.88,270
38092,Elisa,2,Private room,60,0,0.32,60
38093,Graham,3,Entire home/apt,300,154,0.66,454
38095,Kfir,1,Private room,109,270,0.29,379
38096,Denise,2,Entire home/apt,250,274,5.29,524
38097,Michael,5,Entire home/apt,70,51,1.81,121
38098,Judith,1,Entire home/apt,225,0,0.31,225
38099,Marta,2,Private room,85,27,0.99,112
38100,Leah,2,Private room,50,358,4.47,408
38101,Stephen,1,Private room,99,36,0.32,135
38102,Fiona,3,Private room,65,85,0.42,150
38103,Jeff,2,Private room,120,89,1.57,209
38104,Alyssa,2,Entire home/apt,175,0,0.16,175
38106,Elise,1,Private room,27,124,0.13,151
38108,Shep,2,Private room,95,180,0.4,275
38109,Perry,1,Entire home/apt,340,100,0.46,440
38110,Kiran,1,Private room,100,0,1.06,100
38111,Carlos,2,Private room,75,0,1.9,75
38112,Leslie,1,Private room,80,0,0.42,80
38113,Nadia,1,Entire home/apt,195,158,1.93,353
38114,Ruth,1,Entire home/apt,100,1,3.09,101
38116,Jafor,3,Entire home/apt,136,348,2.25,484
38117,Nyesha,2,Entire home/apt,250,78,2.18,328
38118,Talia,4,Entire home/apt,175,0,0.77,175
38119,Allegra,1,Private room,307,363,0.13,670
38120,Jesse,1,Entire home/apt,600,0,0.15,600
38121,Julie,2,Entire home/apt,99,23,0.77,122
38122,Mahesh,1,Entire home/apt,2000,0,0.16,2000
38123,Fiona,3,Private room,55,85,0.95,140
38126,Gabriel,1,Private room,129,140,2.4,269
38127,Nicolas,2,Private room,99,78,0.29,177
38128,Fiona,3,Private room,82,85,0.31,167
38129,John,3,Entire home/apt,125,42,2.05,167
38130,Crú,3,Private room,150,89,1.89,239
38131,Oswin,2,Entire home/apt,151,179,0.13,330
38132,Nicolas,2,Private room,99,84,0.6,183
38133,Ellen,2,Entire home/apt,98,257,4.1,355
38135,Georgia,2,Private room,70,0,0.27,70
38136,Joshua,2,Entire home/apt,200,0,0.15,200
38137,Laura,2,Entire home/apt,380,14,0.48,394
38138,Lucas,1,Entire home/apt,500,63,0.46,563
38139,Toni,2,Private room,50,5,2.52,55
38140,John,2,Entire home/apt,149,263,2.8,412
38141,Vanessa,2,Entire home/apt,73,345,0.23,418
38142,Allyson,2,Private room,50,0,0.93,50
38143,John,1,Private room,80,151,0.77,231
38144,Ali,1,Entire home/apt,170,19,1.37,189
38145,Georgie,1,Entire home/apt,120,191,0.65,311
38146,Abrm,3,Entire home/apt,70,2,0.16,72
38147,Kristen,1,Private room,70,0,0.26,70
38148,J.C.,1,Entire home/apt,400,0,0.31,400
38149,Hudson River Hotel,1,Private room,209,73,1.63,282
38150,Fiona,3,Private room,72,74,1.12,146
38151,Robbin,1,Entire home/apt,125,7,3.05,132
38152,Josh,1,Private room,114,0,0.16,114
38153,Jean,2,Entire home/apt,88,7,5.92,95
38155,Yun,1,Private room,209,358,0.16,567
38156,Matei,1,Entire home/apt,114,11,0.79,125
38157,Kirsten,2,Entire home/apt,118,67,0.89,185
38158,Brian,1,Entire home/apt,130,261,0.34,391
38160,Greg,4,Entire home/apt,75,1,0.93,76
38161,Shawn,2,Entire home/apt,130,139,2.63,269
38162,Julia,2,Private room,90,77,4.55,167
38163,Askhat,2,Private room,80,3,2.17,83
38164,Tom,1,Entire home/apt,206,161,0.41,367
38165,Natalia,1,Entire home/apt,120,0,0.53,120
38168,Mona,2,Entire home/apt,149,0,1.88,149
38169,K,4,Shared room,50,241,1.26,291
38170,Sharon,3,Entire home/apt,165,0,0.27,165
38171,David,1,Entire home/apt,375,0,0.16,375
38172,Paul,1,Private room,75,0,4.52,75
38173,Ana,1,Entire home/apt,259,0,1.92,259
38174,Christopher,2,Entire home/apt,210,0,0.16,210
38175,Ann,2,Private room,55,323,3.59,378
38176,Raquel,2,Entire home/apt,460,0,0.27,460
38177,Harmony,2,Private room,85,137,1.92,222
38178,Stanley,1,Entire home/apt,111,332,1.0,443
38181,Allan C.,1,Private room,109,41,0.16,150
38182,Victoria,1,Entire home/apt,99,0,0.31,99
38183,John,1,Entire home/apt,300,97,0.48,397
38184,Aponte & Tat,2,Private room,70,67,1.06,137
38185,Ahmad,1,Entire home/apt,250,49,0.63,299
38186,Tania,2,Entire home/apt,80,107,0.32,187
38187,Eve,1,Entire home/apt,240,305,1.98,545
38188,Ayana,3,Entire home/apt,35,8,8.44,43
38190,Jacob,1,Private room,100,0,0.32,100
38191,Joe,1,Entire home/apt,160,0,1.98,160
38192,Paul,3,Entire home/apt,178,143,1.94,321
38193,Annie Veronique,1,Entire home/apt,269,43,0.92,312
38194,Eric,4,Private room,75,109,2.59,184
38196,Nina,2,Private room,42,353,0.47,395
38197,Ninosca,1,Private room,40,129,3.0,169
38198,Nina,2,Private room,42,339,1.0,381
38199,Anastasia,1,Entire home/apt,160,25,7.5,185
38200,Erica,1,Private room,130,78,0.71,208
38201,John,3,Entire home/apt,90,19,0.16,109
38202,Fernanda,1,Private room,99,0,0.13,99
38203,Kevin,2,Private room,50,34,6.03,84
38204,Jamie,2,Entire home/apt,150,60,5.42,210
38205,Greg,3,Private room,80,8,0.15,88
38206,Amanda,2,Entire home/apt,120,16,3.07,136
38208,Iryna,2,Private room,60,48,7.24,108
38210,Cricket,1,Entire home/apt,350,33,2.49,383
38212,Missy,1,Entire home/apt,150,0,0.95,150
38213,Kay,1,Private room,85,1,2.13,86
38214,Sergii,1,Private room,50,304,0.17,354
38215,Jackie,1,Entire home/apt,550,72,3.96,622
38216,Laura,1,Entire home/apt,225,1,0.54,226
38217,Johanna,1,Private room,70,102,1.26,172
38218,Johnathan,2,Private room,75,365,0.15,440
38219,Jasper,2,Entire home/apt,195,7,1.61,202
38221,Sergii,1,Private room,63,335,0.32,398
38222,Ariadna,2,Private room,40,250,0.13,290
38223,Luxury Property,1,Entire home/apt,3000,365,0.15,3365
38224,Sergii,1,Private room,63,1,0.37,64
38225,Alexandra,2,Entire home/apt,150,77,2.13,227
38227,Jenny,1,Entire home/apt,165,0,0.74,165
38228,Caspar,2,Private room,50,0,0.15,50
38230,Cristian,2,Private room,85,1,0.61,86
38231,Diana,2,Private room,150,364,0.27,514
38232,Daisuke,1,Private room,62,58,0.93,120
38233,Reina,2,Private room,50,264,1.74,314
38234,Daniela,2,Private room,60,250,0.42,310
38236,Ian & Wendy,2,Entire home/apt,345,0,1.38,345
38237,Nicholas,1,Entire home/apt,92,0,0.29,92
38238,Eli,2,Private room,241,139,0.47,380
38239,Celeste,4,Private room,45,0,0.57,45
38240,Vera,2,Entire home/apt,125,1,0.4,126
38241,Zakiyyah,4,Private room,145,360,1.12,505
38242,Courtney,1,Private room,275,85,2.28,360
38243,Hampton,1,Entire home/apt,495,230,0.82,725
38244,Hana,1,Private room,50,71,1.02,121
38245,Venera,3,Private room,40,0,0.79,40
38247,Hana,1,Private room,50,180,0.39,230
38248,Saireth,2,Private room,69,175,2.48,244
38249,Danielle,1,Entire home/apt,120,231,0.16,351
38250,Gaia&Pietro,1,Entire home/apt,300,308,5.25,608
38251,Gaia&Pietro,1,Entire home/apt,285,313,1.76,598
38252,Maksim,2,Entire home/apt,90,36,7.07,126
38253,Sophia,1,Entire home/apt,140,48,3.35,188
38254,Robert,1,Private room,46,179,0.13,225
38257,Tali,2,Private room,37,0,0.34,37
38258,Sean,1,Entire home/apt,134,0,0.27,134
38259,Aiesha & Stacy,2,Entire home/apt,150,0,3.0,150
38260,Andrea,1,Entire home/apt,195,305,4.29,500
38262,Natascha,1,Entire home/apt,450,345,0.71,795
38263,Anna,1,Private room,100,270,1.78,370
38264,Kane,3,Private room,49,48,2.5,97
38265,Sabrina,1,Entire home/apt,189,29,2.43,218
38266,Gabriel,1,Private room,199,133,2.96,332
38267,Fiach,3,Private room,300,54,0.32,354
38268,Gabriel,1,Private room,199,155,3.27,354
38269,Gabriel,1,Private room,179,175,1.36,354
38270,Gabriel,1,Private room,179,165,3.23,344
38271,Kazuya,3,Private room,49,195,0.5,244
38272,Andrea,2,Private room,75,84,4.6,159
38273,Ignacio,1,Private room,95,165,0.71,260
38275,Samuel,3,Entire home/apt,72,317,3.8,389
38276,Chi,1,Private room,75,217,2.09,292
38277,Diana,2,Private room,65,208,2.05,273
38278,Steven,2,Private room,112,12,0.37,124
38280,Makeba,2,Entire home/apt,175,9,3.97,184
38281,Kira,2,Private room,44,0,0.47,44
38283,Jenny,2,Private room,95,0,0.34,95
38285,Coco,1,Entire home/apt,188,0,1.93,188
38288,Yves,1,Entire home/apt,400,265,5.18,665
38289,G,1,Entire home/apt,125,365,0.75,490
38290,G,1,Entire home/apt,139,365,0.32,504
38291,Charles,1,Private room,70,0,0.42,70
38292,Miguel,1,Private room,90,0,0.16,90
38294,Sonder (NYC),1,Entire home/apt,229,219,0.73,448
38296,Corporate Housing,1,Entire home/apt,133,341,0.69,474
38297,C,1,Entire home/apt,150,0,0.58,150
38298,Sabrina,1,Entire home/apt,135,1,0.32,136
38299,Ali,2,Entire home/apt,175,84,0.16,259
38300,Jane,2,Private room,100,0,0.14,100
38302,Sam,2,Entire home/apt,120,56,5.94,176
38303,Paige,2,Entire home/apt,70,0,0.13,70
38304,Ceren,2,Private room,110,6,1.85,116
38305,Jess,3,Private room,100,0,0.27,100
38306,Lucía,1,Private room,120,0,0.18,120
38307,Luke,1,Private room,130,84,2.34,214
38308,Jon,3,Shared room,35,310,0.16,345
38309,Tae,1,Entire home/apt,185,230,3.05,415
38310,Red Awning,1,Entire home/apt,714,257,0.19,971
38311,Red Awning,1,Entire home/apt,675,253,0.81,928
38312,Red Awning,1,Entire home/apt,675,243,0.32,918
38313,Red Awning,1,Entire home/apt,675,253,0.95,928
38314,Red Awning,1,Entire home/apt,675,224,0.31,899
38316,Red Awning,1,Entire home/apt,956,80,0.29,1036
38317,Red Awning,1,Entire home/apt,675,251,0.23,926
38319,Red Awning,1,Entire home/apt,675,253,0.63,928
38320,Red Awning,1,Entire home/apt,675,234,0.6,909
38322,Red Awning,1,Entire home/apt,714,257,0.19,971
38323,Red Awning,1,Entire home/apt,714,257,0.16,971
38329,Red Awning,1,Entire home/apt,675,234,0.6,909
38330,Red Awning,1,Entire home/apt,675,225,0.16,900
38338,Mike,3,Entire home/apt,59,24,4.62,83
38339,Victor,1,Private room,115,0,2.81,115
38340,Stephanie,1,Private room,150,1,0.55,151
38341,Tamara,1,Private room,90,45,5.68,135
38343,Emily,2,Entire home/apt,130,179,0.28,309
38344,Kara,2,Entire home/apt,110,0,0.65,110
38345,Laura,1,Entire home/apt,266,86,0.78,352
38346,Aralis,3,Private room,100,0,0.68,100
38349,Emily,2,Entire home/apt,200,5,0.16,205
38350,Fidencio,2,Entire home/apt,90,52,2.75,142
38351,Blueground,1,Entire home/apt,303,331,0.2,634
38352,Oksana,3,Entire home/apt,250,365,0.18,615
38353,Ann Marie,5,Entire home/apt,86,43,0.16,129
38354,Karen,1,Private room,80,329,5.04,409
38355,Brianna,1,Entire home/apt,100,102,1.47,202
38356,David,2,Entire home/apt,179,365,0.7,544
38357,Georgia,2,Entire home/apt,220,16,0.84,236
38359,David,1,Entire home/apt,230,0,1.78,230
38360,Ikrame,3,Private room,89,208,0.71,297
38361,Utah,2,Private room,40,335,0.14,375
38362,Haider,1,Private room,105,8,0.47,113
38363,Shalev,1,Entire home/apt,175,188,0.79,363
38364,Ianthe,2,Private room,50,0,0.92,50
38366,Gabriel,1,Private room,107,169,3.52,276
38367,Gabriel,1,Private room,199,166,0.95,365
38368,Stacy,2,Entire home/apt,125,18,3.82,143
38369,Hiroki,3,Private room,43,1,0.43,44
38370,Momoyo,3,Private room,35,1,0.38,36
38371,Momoyo,3,Private room,33,1,0.71,34
38372,Sidney,1,Entire home/apt,165,0,0.32,165
38373,Bruno,1,Entire home/apt,182,301,2.31,483
38374,Maria,1,Entire home/apt,227,321,2.44,548
38375,Kazuya,3,Private room,41,268,0.76,309
38377,Prangchat,1,Private room,115,23,0.87,138
38378,Every,4,Private room,60,363,0.16,423
38379,Alexia,1,Entire home/apt,135,314,1.46,449
38380,Karina,4,Private room,65,89,0.27,154
38381,Tina,1,Private room,100,40,3.8,140
38382,Bella,1,Private room,99,176,1.64,275
38383,Kavya,1,Entire home/apt,375,0,1.1,375
38384,Ele,1,Entire home/apt,250,64,0.13,314
38385,Ronni,1,Entire home/apt,175,365,3.17,540
38386,Renu,3,Entire home/apt,90,21,5.05,111
38387,Esteban,1,Shared room,49,39,2.31,88
38388,Mia,2,Private room,65,343,2.48,408
38389,Alexander,1,Private room,44,45,2.38,89
38390,Mia,2,Private room,65,311,1.29,376
38391,Mia,2,Private room,65,321,2.15,386
38392,Raphael,1,Entire home/apt,246,365,0.16,611
38394,Abraham,1,Entire home/apt,300,0,0.8,300
38396,Mustak And Farzana,3,Entire home/apt,99,231,5.73,330
38397,Gino,1,Private room,355,75,2.34,430
38398,Vincent,2,Entire home/apt,120,0,0.32,120
38401,Eugene,1,Private room,69,167,1.45,236
38402,LeAnne And Keith,2,Entire home/apt,175,12,2.84,187
38403,Shareef,1,Private room,50,11,4.73,61
38404,Pettrina,2,Private room,38,357,1.58,395
38405,Gabriel,2,Entire home/apt,64,0,1.22,64
38406,David And Annette,2,Private room,40,363,1.67,403
38407,David And Annette,2,Private room,40,317,3.17,357
38408,David And Annette,2,Private room,55,326,1.7,381
38409,David And Annette,2,Private room,40,353,2.69,393
38410,David And Annette,2,Private room,45,362,1.36,407
38411,David And Annette,2,Private room,50,333,0.73,383
38412,Gordon,2,Entire home/apt,99,46,1.71,145
38413,Oto,2,Entire home/apt,250,0,0.55,250
38414,Aldo,1,Entire home/apt,200,363,1.1,563
38415,Hitalo,2,Private room,70,199,2.57,269
38416,Kay,1,Private room,200,224,1.82,424
38417,Hitalo,2,Private room,74,125,2.83,199
38419,Joshua,2,Private room,88,0,0.15,88
38421,Hitalo,2,Private room,70,119,1.86,189
38422,Hitalo,2,Private room,70,158,0.96,228
38423,Elba,1,Entire home/apt,150,49,0.59,199
38424,Bronwyn,1,Entire home/apt,150,0,0.42,150
38425,Sophie,2,Private room,60,0,0.14,60
38426,Yun,5,Entire home/apt,138,291,7.18,429
38427,Makedonka,1,Entire home/apt,150,146,0.14,296
38428,Habibi,1,Private room,82,180,1.94,262
38429,Ester,1,Private room,90,27,6.3,117
38430,Glory,2,Private room,56,47,0.15,103
38431,Emily,2,Private room,249,39,2.82,288
38432,Sandra,1,Private room,120,0,0.85,120
38433,Angelie,4,Entire home/apt,670,178,0.34,848
38434,Maxim,2,Private room,55,0,3.65,55
38435,Christina,2,Entire home/apt,149,224,4.63,373
38437,Alejandro,3,Private room,100,134,2.55,234
38438,Joe,1,Entire home/apt,210,9,1.58,219
38439,Nicole,2,Entire home/apt,100,220,0.77,320
38440,Johanna,2,Private room,45,250,0.16,295
38441,Jessica,2,Private room,45,0,0.97,45
38442,Mo,3,Entire home/apt,207,346,1.84,553
38443,Jeba/Ashraf,3,Entire home/apt,99,138,7.12,237
38444,Kane,3,Private room,45,80,4.48,125
38445,Jesal,2,Private room,80,28,2.5,108
38448,Anchor,2,Shared room,35,89,1.51,124
38449,Tonisha,2,Private room,50,62,2.82,112
38450,Tonisha,2,Private room,40,64,2.11,104
38451,Asia,1,Entire home/apt,315,365,2.09,680
38453,Maha,2,Private room,50,0,0.32,50
38455,Eric,2,Private room,89,48,0.45,137
38457,Adam & Kath,1,Entire home/apt,258,10,0.61,268
38458,Lauren,2,Private room,150,143,0.27,293
38459,Mujibun,3,Entire home/apt,120,0,0.16,120
38460,Jamie,1,Entire home/apt,250,87,0.4,337
38461,Madeline,1,Entire home/apt,75,0,0.59,75
38462,Anne,1,Private room,65,13,0.16,78
38464,Mandy & Jerry,2,Private room,40,20,3.46,60
38465,Audrey,2,Private room,50,62,1.78,112
38466,Jack,1,Entire home/apt,139,355,2.74,494
38467,Jane,1,Entire home/apt,232,0,0.16,232
38468,Iryna,2,Private room,32,83,6.67,115
38469,Fon,2,Private room,85,189,0.14,274
38470,Sizhu,1,Entire home/apt,135,0,2.0,135
38471,Adeola,1,Private room,65,365,0.32,430
38472,Stephanie,2,Private room,34,0,0.43,34
38473,Maurice,2,Entire home/apt,91,305,2.52,396
38474,Agathe,2,Entire home/apt,100,35,0.31,135
38475,Alla,1,Private room,109,10,0.94,119
38476,Alexander,2,Private room,50,10,0.86,60
38477,Livia,1,Entire home/apt,250,0,0.16,250
38478,Min,1,Shared room,55,309,9.12,364
38480,Yang,1,Entire home/apt,137,0,1.21,137
38481,Leigh,3,Private room,45,2,1.08,47
38482,Jillian,2,Entire home/apt,139,0,0.31,139
38485,Heavenly,1,Entire home/apt,97,0,0.27,97
38486,Simon,1,Entire home/apt,70,6,1.0,76
38487,Eric,1,Private room,80,26,1.43,106
38488,SamariSankofa,1,Private room,100,253,1.26,353
38489,Shehrezad,1,Entire home/apt,220,0,0.28,220
38490,Alex,1,Entire home/apt,299,156,0.32,455
38491,Eden,1,Entire home/apt,160,41,0.55,201
38492,Meir,5,Entire home/apt,119,175,3.13,294
38493,Megan,2,Entire home/apt,70,0,0.33,70
38494,Sou,2,Private room,41,52,0.45,93
38495,Lumila,2,Private room,70,280,1.85,350
38496,Andrew,2,Private room,48,231,8.51,279
38497,Andrew,2,Private room,48,199,7.57,247
38499,Linnette,1,Entire home/apt,75,5,2.13,80
38500,Andrew,2,Private room,48,252,3.04,300
38501,Kristina,2,Private room,100,0,1.21,100
38502,Kayleigh,1,Entire home/apt,225,153,0.16,378
38503,Catherine,2,Private room,80,0,0.16,80
38505,Keith,1,Private room,100,88,0.13,188
38507,Deena,1,Private room,47,0,0.42,47
38508,Wesley,2,Private room,35,112,4.95,147
38509,Ryan,2,Entire home/apt,300,168,1.11,468
38511,Shannon,2,Private room,60,0,3.38,60
38513,Max,2,Entire home/apt,125,0,0.27,125
38514,Suzy,1,Entire home/apt,280,328,0.55,608
38516,Victoria,1,Private room,195,85,1.61,280
38517,Robert,1,Entire home/apt,225,25,2.39,250
38519,Morgan,1,Private room,112,0,0.67,112
38520,Char,3,Private room,29,168,7.14,197
38521,Christienne,1,Private room,399,47,2.14,446
38522,Cassandra,2,Entire home/apt,125,192,1.36,317
38524,Holly,1,Entire home/apt,200,158,0.99,358
38525,Stephen,1,Entire home/apt,265,46,2.55,311
38526,Carson,1,Entire home/apt,150,258,0.16,408
38528,Zahi,3,Private room,60,43,0.84,103
38531,Christina,2,Entire home/apt,125,0,0.63,125
38532,Catherine,2,Private room,150,89,1.18,239
38536,Sofiya,2,Private room,54,64,0.48,118
38540,Sarah Beyahte,2,Entire home/apt,95,219,0.14,314
38541,Justin,2,Entire home/apt,149,0,0.32,149
38542,Jenny,2,Private room,119,3,3.94,122
38543,Ivan,1,Private room,90,278,4.29,368
38544,Nir,1,Entire home/apt,264,296,6.87,560
38545,Xiao,2,Private room,28,0,0.16,28
38546,Jean Pierre,2,Private room,80,151,4.97,231
38547,Isabel,1,Private room,145,29,7.39,174
38548,Samanta,3,Private room,89,13,2.07,102
38549,Nôm,2,Entire home/apt,120,0,0.77,120
38550,Sara,3,Entire home/apt,190,0,0.16,190
38551,Shula,1,Entire home/apt,275,77,0.7,352
38552,Yibin,1,Entire home/apt,168,0,0.44,168
38553,Luke,1,Entire home/apt,200,0,0.27,200
38554,Joshua,1,Entire home/apt,180,79,2.87,259
38555,Yoav,2,Entire home/apt,100,5,0.16,105
38556,Roosbelinda,1,Entire home/apt,149,3,0.16,152
38558,Nick,2,Entire home/apt,55,0,1.83,55
38559,Olga,1,Entire home/apt,115,255,2.6,370
38560,Sherry,1,Private room,79,0,0.61,79
38561,Sarah,2,Private room,120,117,1.76,237
38562,Ramy,3,Shared room,32,88,0.14,120
38564,Yeelen,2,Entire home/apt,100,324,0.32,424
38565,Aleszea,1,Entire home/apt,333,80,1.41,413
38566,Chien-Ni,1,Private room,70,0,1.02,70
38568,Sergii,1,Private room,63,364,0.3,427
38569,Drew,2,Entire home/apt,125,47,1.09,172
38570,Ev,2,Entire home/apt,225,0,0.62,225
38572,Ashley,1,Entire home/apt,210,359,0.28,569
38573,Anuja,3,Private room,50,0,0.7,50
38574,Shareef,1,Private room,40,54,4.05,94
38575,Jed & Leah,1,Entire home/apt,399,319,1.49,718
38576,Jenna,4,Entire home/apt,120,97,1.83,217
38577,Harry & Morgan,1,Entire home/apt,418,328,2.81,746
38578,Elle,1,Entire home/apt,350,60,0.76,410
38579,Soraya,3,Private room,56,35,2.2,91
38581,David,1,Private room,110,256,3.18,366
38582,Ben,2,Entire home/apt,155,5,1.38,160
38583,Kiryl,3,Entire home/apt,120,60,2.32,180
38584,Gus,1,Entire home/apt,125,20,2.77,145
38585,Adriana,2,Entire home/apt,134,13,1.13,147
38587,Wesley,1,Entire home/apt,350,7,0.26,357
38588,Sonder (NYC),1,Entire home/apt,232,159,0.6,391
38589,Ruth,2,Private room,50,11,1.83,61
38590,Alina,1,Private room,95,5,1.63,100
38592,Better Home,3,Entire home/apt,89,253,12.05,342
38593,Gregory,4,Private room,35,252,3.35,287
38594,Inna,1,Entire home/apt,180,90,0.73,270
38596,Jessie,1,Entire home/apt,200,0,0.98,200
38597,Ally,1,Entire home/apt,200,0,2.66,200
38599,Bo,2,Entire home/apt,300,364,0.16,664
38600,Nutrice,2,Entire home/apt,150,241,3.53,391
38601,Fola,2,Private room,55,0,0.27,55
38602,Robert,1,Private room,88,7,0.78,95
38603,Rebecca,2,Entire home/apt,79,8,1.28,87
38604,Juliette,1,Private room,70,13,0.16,83
38605,Brooke,2,Entire home/apt,140,3,1.42,143
38608,Wei,3,Private room,40,5,2.83,45
38609,Gladys,3,Shared room,16,0,1.36,16
38610,Kazuya,3,Private room,34,273,1.0,307
38611,Sean,1,Private room,90,0,0.14,90
38612,Nicole,2,Private room,50,0,0.71,50
38613,Max,1,Shared room,35,320,0.16,355
38614,Max,1,Shared room,32,341,0.18,373
38616,Kazuya,1,Entire home/apt,70,219,0.36,289
38617,Max,1,Shared room,35,322,1.31,357
38618,Andre,2,Private room,45,296,0.15,341
38620,Kazuya,3,Private room,37,0,0.43,37
38621,Kazuya,3,Private room,42,235,0.79,277
38622,Owen,2,Entire home/apt,110,83,0.81,193
38624,Hayley,2,Private room,65,0,0.74,65
38625,Dylan,2,Private room,50,38,0.82,88
38626,Daron,2,Entire home/apt,125,0,0.48,125
38627,Tiphaine,1,Private room,150,36,1.41,186
38630,Hugo,2,Private room,69,0,1.0,69
38631,Abe,1,Entire home/apt,175,27,2.64,202
38632,Marjolein,1,Private room,95,0,0.16,95
38634,Anting,2,Private room,119,365,0.68,484
38636,Emily,1,Entire home/apt,260,274,0.45,534
38637,Mario & Maria,3,Private room,59,0,0.38,59
38639,Jared & Rachel,1,Entire home/apt,189,338,3.07,527
38641,Jacqueline,2,Entire home/apt,105,16,0.56,121
38642,Wei,3,Private room,45,6,1.73,51
38643,Brandon,2,Entire home/apt,140,25,0.31,165
38644,Andrew,1,Private room,180,172,1.68,352
38645,Manuel,1,Private room,80,0,0.42,80
38646,Samantha,1,Entire home/apt,214,279,3.3,493
38647,Diana And Peter,2,Private room,65,330,3.48,395
38648,André,2,Private room,60,0,1.99,60
38649,Barbara,2,Entire home/apt,195,28,2.04,223
38650,Sara,2,Private room,36,189,2.51,225
38652,Nina,2,Private room,42,346,0.58,388
38653,Lauria,3,Private room,60,90,0.16,150
38654,Pam,1,Entire home/apt,75,232,0.94,307
38655,Lukia,3,Private room,40,0,2.96,40
38656,Emily,1,Entire home/apt,119,12,2.38,131
38657,Nate,1,Private room,95,2,0.8,97
38659,Abby,2,Shared room,25,290,1.15,315
38660,Nina,2,Private room,42,346,0.65,388
38661,Ariana,2,Entire home/apt,100,6,0.78,106
38662,Nina,2,Private room,42,345,0.33,387
38663,Nina,2,Private room,42,332,0.24,374
38665,Shane,3,Entire home/apt,250,341,0.32,591
38666,James,1,Entire home/apt,150,9,2.12,159
38667,Nina,2,Private room,42,311,0.86,353
38668,Jenni,2,Entire home/apt,250,266,3.94,516
38669,Wesley,3,Private room,100,364,0.16,464
38670,Javier,2,Entire home/apt,90,2,7.91,92
38674,Blueground,1,Entire home/apt,452,337,0.17,789
38682,Blueground,1,Entire home/apt,343,323,0.17,666
38683,Blueground,1,Entire home/apt,334,310,0.35,644
38689,Blueground,1,Entire home/apt,238,322,0.16,560
38692,Blueground,1,Entire home/apt,303,280,0.19,583
38700,Blueground,1,Entire home/apt,312,359,0.23,671
38702,Blueground,1,Entire home/apt,321,310,0.39,631
38708,Blueground,1,Entire home/apt,289,235,0.3,524
38730,Kazuya,3,Private room,62,269,0.32,331
38741,Jennifer,2,Private room,88,0,1.35,88
38742,Marie,3,Entire home/apt,150,162,0.7,312
38746,Blueground,1,Entire home/apt,255,330,0.19,585
38747,Blueground,1,Entire home/apt,282,323,0.23,605
38756,Blueground,1,Entire home/apt,332,1,0.19,333
38760,Blueground,1,Entire home/apt,305,274,0.26,579
38764,Blueground,1,Entire home/apt,314,345,0.19,659
38771,Arosha,3,Private room,45,179,0.41,224
38772,Richard,1,Entire home/apt,453,113,3.72,566
38786,Blueground,1,Entire home/apt,278,235,0.22,513
38787,Zahid,2,Entire home/apt,75,10,0.64,85
38798,Blueground,1,Entire home/apt,237,283,0.34,520
38812,Blueground,1,Entire home/apt,189,142,0.21,331
38815,Matt,3,Entire home/apt,150,0,0.14,150
38816,Taylor,2,Entire home/apt,90,5,2.26,95
38817,Roberta,1,Private room,90,24,1.88,114
38820,Nina,2,Private room,47,347,0.59,394
38821,Mary,2,Entire home/apt,250,121,4.08,371
38822,Bill,1,Shared room,69,62,1.44,131
38824,Shampa,3,Private room,120,0,0.62,120
38825,Svetlana,1,Entire home/apt,200,85,0.97,285
38827,Studioplus,1,Entire home/apt,240,258,1.89,498
38828,475,1,Private room,160,180,0.32,340
38829,Ashley,1,Entire home/apt,70,4,2.24,74
38830,Ev,1,Entire home/apt,313,28,4.52,341
38831,Michele,1,Entire home/apt,750,0,0.14,750
38833,Motlaq,2,Private room,65,351,1.0,416
38834,Ollie,1,Entire home/apt,308,269,6.46,577
38835,Isabella,2,Entire home/apt,100,81,1.55,181
38836,Mia,2,Private room,60,311,1.83,371
38838,Roberto,1,Private room,90,0,1.02,90
38839,Jacob,2,Entire home/apt,120,0,0.39,120
38840,Julie,2,Private room,51,19,5.24,70
38841,Eric,2,Private room,25,0,0.3,25
38842,Ethan,1,Entire home/apt,150,5,1.0,155
38844,David And Annette,2,Private room,55,360,0.72,415
38845,Betsy,2,Entire home/apt,115,44,3.49,159
38846,Erik,2,Private room,44,0,4.07,44
38847,Jessica,1,Entire home/apt,243,93,1.89,336
38848,Blake,1,Entire home/apt,290,52,0.83,342
38849,Rob,2,Private room,65,363,0.68,428
38850,Rob,2,Private room,55,365,1.36,420
38851,Imade,1,Private room,115,67,2.83,182
38853,Dystini,1,Private room,30,8,1.41,38
38854,Daniel,3,Entire home/apt,250,105,1.56,355
38856,Dan,2,Entire home/apt,120,8,2.98,128
38857,Joe,1,Entire home/apt,140,334,3.1,474
38858,Carlos,2,Private room,50,235,1.59,285
38859,Eric,1,Private room,70,0,0.22,70
38860,Aziza,1,Private room,65,0,0.16,65
38861,Afrah,2,Private room,50,333,1.0,383
38862,Lionel,2,Private room,35,0,1.23,35
38863,Bryan,2,Private room,60,0,0.16,60
38864,Blueground,1,Entire home/apt,245,326,0.17,571
38866,Leonardo,2,Private room,90,56,3.84,146
38868,Olivia,1,Entire home/apt,200,0,0.16,200
38869,Nancy,2,Entire home/apt,95,0,0.17,95
38870,Louann,3,Private room,45,134,20.94,179
38871,Obinna,2,Private room,25,0,0.59,25
38872,Jonathan,2,Private room,35,35,1.07,70
38873,Melissa,2,Private room,50,12,0.56,62
38874,Shannon,1,Entire home/apt,150,1,0.59,151
38875,Askhat,2,Shared room,30,224,1.92,254
38876,-TheQueensCornerLot,3,Entire home/apt,150,248,7.43,398
38877,Paul,1,Private room,65,4,6.7,69
38880,Fryske,1,Entire home/apt,110,4,0.41,114
38881,Lana,2,Private room,40,0,0.46,40
38882,Nikki,1,Entire home/apt,175,0,0.46,175
38883,Mr,2,Entire home/apt,125,82,3.25,207
38884,Camellia,1,Entire home/apt,215,0,0.42,215
38886,Gabriel,1,Private room,199,334,2.37,533
38887,Ruben And Will,2,Private room,45,14,2.52,59
38889,Gabriel,1,Private room,199,356,1.36,555
38890,Ahmed,2,Private room,90,79,0.16,169
38891,Gabriel,1,Private room,199,354,2.34,553
38892,Gabriel,1,Private room,199,347,2.32,546
38893,Gabriel,1,Private room,179,364,2.76,543
38894,Masashi,2,Private room,60,0,0.14,60
38895,Gabriel,1,Private room,179,364,2.49,543
38896,Gabriel,1,Private room,179,363,2.22,542
38897,Gabriel,1,Private room,179,361,1.82,540
38899,Dorit,2,Private room,27,333,0.42,360
38901,Mya,1,Entire home/apt,200,0,1.4,200
38902,Jose,3,Private room,55,87,5.78,142
38903,Dragomir,1,Private room,55,342,0.24,397
38904,Lucy,2,Entire home/apt,190,0,0.16,190
38905,Jodi,1,Entire home/apt,300,270,1.33,570
38906,Miriam,2,Entire home/apt,125,342,1.11,467
38907,Jonny,2,Entire home/apt,295,46,0.49,341
38908,Miriam,2,Entire home/apt,125,347,0.3,472
38909,Victoria,1,Private room,47,0,0.31,47
38910,Chris,1,Private room,95,0,0.17,95
38911,Kazuya,3,Private room,63,251,0.43,314
38912,Miriam,2,Entire home/apt,125,347,0.37,472
38913,Anna,3,Entire home/apt,225,314,1.0,539
38914,CASA Heidi,2,Entire home/apt,300,311,2.22,611
38915,Noelle,2,Private room,40,0,0.43,40
38916,Maria,1,Entire home/apt,149,0,0.16,149
38917,Helen,2,Private room,90,0,0.31,90
38918,Abella,2,Entire home/apt,160,269,4.79,429
38919,Xiangjun,1,Private room,207,82,0.74,289
38920,Michael,1,Entire home/apt,805,168,2.63,973
38921,Nina,2,Private room,42,311,0.18,353
38924,Nina,2,Private room,42,282,0.6,324
38925,Lancelot,1,Private room,115,33,3.22,148
38927,Susan,1,Entire home/apt,275,253,5.0,528
38928,Olivia,2,Entire home/apt,195,1,0.32,196
38930,James,1,Private room,100,0,1.02,100
38931,Nina,2,Private room,35,312,0.73,347
38932,Olivia,2,Entire home/apt,180,0,0.47,180
38933,Nina,2,Private room,42,346,0.48,388
38934,Clarabel,3,Entire home/apt,150,336,0.95,486
38937,Jennifer,2,Private room,65,0,3.28,65
38941,Nina,2,Private room,42,342,0.33,384
38946,Chi,1,Private room,60,253,1.9,313
38949,Steph,2,Entire home/apt,75,24,0.3,99
38950,Carolina,1,Entire home/apt,120,0,0.61,120
38951,Ramon,2,Entire home/apt,75,0,1.73,75
38952,Miriam,1,Private room,110,12,0.84,122
38953,Atma,1,Entire home/apt,189,200,0.16,389
38955,Daniela,2,Private room,55,160,0.79,215
38957,Edna,2,Private room,35,8,6.43,43
38958,Luis,3,Entire home/apt,149,305,0.91,454
38959,Celeste,2,Private room,55,15,0.14,70
38960,Brett,1,Private room,50,0,0.16,50
38961,Askhat,2,Shared room,30,192,2.57,222
38962,Linda,5,Private room,65,362,0.16,427
38963,Carl,4,Private room,99,90,0.32,189
38964,Mina,3,Private room,29,0,3.84,29
38965,Gloria,2,Private room,30,0,0.3,30
38966,Anna,1,Shared room,90,5,1.11,95
38967,Ella,1,Private room,50,0,1.69,50
38968,Samantha,1,Entire home/apt,175,38,1.1,213
38969,David,1,Private room,79,3,6.38,82
38970,Andre,3,Entire home/apt,190,0,0.16,190
38971,Melissa,1,Shared room,34,4,2.33,38
38972,Amy & Brian,1,Entire home/apt,443,293,4.75,736
38973,Rachel,2,Entire home/apt,150,1,1.27,151
38974,Lucy,3,Entire home/apt,75,0,0.18,75
38975,Frankie,1,Entire home/apt,299,271,1.46,570
38976,Mohan,1,Entire home/apt,112,16,3.31,128
38977,Mora,2,Entire home/apt,125,122,3.22,247
38979,David,2,Entire home/apt,392,337,3.73,729
38980,Kersaint,2,Entire home/apt,150,175,2.54,325
38982,Christine,1,Entire home/apt,145,0,0.46,145
38983,Aponte & Tat,2,Private room,55,79,1.74,134
38985,Max,1,Private room,50,149,6.25,199
38986,Laurence,1,Entire home/apt,195,0,0.16,195
38987,Kay,1,Entire home/apt,115,315,1.34,430
38988,JenJoy,2,Private room,72,0,3.0,72
38990,Alexa,1,Entire home/apt,264,2,1.28,266
38991,Xavier,2,Entire home/apt,150,0,1.44,150
38993,Melissa,1,Entire home/apt,101,0,1.24,101
38994,Amber,2,Private room,70,5,1.22,75
38995,Rebecca,2,Entire home/apt,185,281,4.59,466
38996,DaNeilia,2,Entire home/apt,125,0,2.48,125
39000,Shelley,2,Entire home/apt,150,0,0.59,150
39001,Freddy,3,Private room,50,189,0.45,239
39002,Rebecca,2,Entire home/apt,250,5,1.06,255
39003,Oliver,1,Entire home/apt,261,143,2.57,404
39006,Ariel,1,Private room,52,54,1.83,106
39007,Paola,1,Private room,100,56,0.99,156
39008,Rebecca,2,Private room,50,7,0.71,57
39009,Nana & Karim,2,Entire home/apt,90,0,0.33,90
39010,Luis,3,Entire home/apt,129,280,1.11,409
39011,Laura,2,Private room,75,170,1.0,245
39014,Samanta,3,Private room,109,0,6.88,109
39015,Shayan,2,Private room,45,0,0.28,45
39016,Jae,1,Private room,100,43,0.32,143
39017,Jenae,1,Entire home/apt,275,252,0.95,527
39019,Hanine,3,Private room,29,35,0.86,64
39020,Hezla,2,Entire home/apt,125,360,3.61,485
39026,Anuj,2,Entire home/apt,72,0,1.26,72
39027,Imoy,2,Shared room,19,339,0.17,358
39028,Paget,2,Entire home/apt,125,60,4.51,185
39030,Louie,2,Entire home/apt,243,107,4.63,350
39032,JeanRobert,2,Private room,65,0,0.62,65
39034,Alessandro,2,Private room,70,15,0.19,85
39035,Aliona,1,Entire home/apt,200,0,0.16,200
39036,Jimmy,2,Entire home/apt,65,281,0.15,346
39040,Nadjah,1,Entire home/apt,100,80,1.9,180
39041,Jason,1,Private room,97,0,0.63,97
39043,Nissa,1,Entire home/apt,275,36,1.78,311
39044,Urszula,2,Entire home/apt,95,85,0.16,180
39045,Olivia,1,Entire home/apt,595,55,0.47,650
39046,Gina,2,Private room,55,0,0.32,55
39047,Manuela,1,Entire home/apt,101,0,0.45,101
39048,Meredith,1,Entire home/apt,180,0,1.28,180
39049,Gina,3,Private room,99,5,1.59,104
39050,Tj,1,Private room,65,0,0.45,65
39053,Candace,2,Private room,95,350,0.87,445
39055,Aura Xenia,1,Entire home/apt,300,0,0.16,300
39057,Lauren,2,Entire home/apt,200,0,1.01,200
39058,Yuli,2,Entire home/apt,100,286,3.32,386
39059,Manuela,2,Entire home/apt,165,213,3.77,378
39060,Sarah,2,Entire home/apt,120,62,1.68,182
39061,Melissa,1,Entire home/apt,125,0,0.16,125
39062,Daisy,2,Entire home/apt,200,0,0.41,200
39063,Daehan,1,Private room,45,90,0.57,135
39064,Daniella,1,Entire home/apt,260,28,0.32,288
39065,Sujeiry,3,Private room,40,20,0.47,60
39067,Tyrany,2,Private room,70,0,0.14,70
39068,Andrew,1,Entire home/apt,295,129,1.12,424
39069,Shogo,3,Private room,32,38,0.32,70
39071,Lilian,2,Entire home/apt,119,0,0.47,119
39072,Ashley,2,Private room,55,89,0.86,144
39073,Clara,1,Private room,40,245,0.15,285
39075,Karen,2,Private room,40,349,2.83,389
39077,Omer,2,Entire home/apt,180,0,0.48,180
39078,Jacqueline,3,Private room,75,36,0.63,111
39079,Piyawan,1,Entire home/apt,130,0,0.52,130
39080,Victor,1,Entire home/apt,200,188,0.46,388
39081,Mark,1,Entire home/apt,150,286,1.27,436
39082,Irene,2,Entire home/apt,70,17,2.07,87
39083,Khy,1,Entire home/apt,359,175,5.09,534
39085,Bijan,1,Entire home/apt,95,0,3.79,95
39086,Batka,1,Private room,40,19,0.42,59
39088,Jonathan,2,Private room,38,95,0.32,133
39089,Fidel,1,Private room,40,49,4.01,89
39092,Kazuya,3,Private room,51,246,0.54,297
39093,Steven,2,Entire home/apt,90,141,5.44,231
39095,Michael,4,Private room,85,341,0.38,426
39096,Jonathan E,2,Private room,150,0,0.43,150
39097,Ian & Shayne,1,Entire home/apt,284,328,1.11,612
39098,Nick,1,Entire home/apt,185,14,1.0,199
39099,Damaris,2,Entire home/apt,166,365,0.24,531
39100,Ari,1,Private room,31,111,4.57,142
39101,Adam,1,Entire home/apt,150,163,1.18,313
39102,David & Maddy,1,Entire home/apt,398,328,2.5,726
39103,R.,2,Entire home/apt,185,0,1.33,185
39104,Fareez,2,Entire home/apt,200,0,0.16,200
39105,Farhad,1,Entire home/apt,300,0,0.63,300
39106,Helen,1,Entire home/apt,189,74,0.61,263
39107,Reggae In,4,Private room,25,0,0.14,25
39108,Jimmy,2,Private room,55,7,4.66,62
39109,Andrea,1,Entire home/apt,200,338,0.72,538
39110,Ish,2,Entire home/apt,52,88,1.8,140
39112,Maria,2,Entire home/apt,400,363,0.32,763
39113,Dannie,1,Entire home/apt,102,0,0.31,102
39115,Sl,1,Entire home/apt,390,15,0.91,405
39116,Bryson,2,Entire home/apt,450,352,1.84,802
39119,Vanessa,2,Entire home/apt,90,314,0.45,404
39121,Michael,2,Entire home/apt,111,0,0.14,111
39122,Michelle,3,Private room,60,0,0.29,60
39123,Novo,2,Private room,295,90,0.6,385
39126,Margarita,1,Entire home/apt,55,0,0.33,55
39129,Miriam,2,Entire home/apt,325,342,2.38,667
39130,Ley,1,Private room,135,330,1.75,465
39132,Gabriel,1,Private room,179,175,1.69,354
39133,Reuben,2,Private room,80,2,1.57,82
39134,Vicky,3,Private room,80,169,1.41,249
39135,Oleg,1,Entire home/apt,175,0,0.16,175
39136,Michele,2,Entire home/apt,211,90,1.2,301
39137,Carolina,1,Entire home/apt,133,0,0.28,133
39140,Stephen,2,Entire home/apt,70,0,0.14,70
39141,Tussan,3,Private room,75,81,4.63,156
39143,Paul,2,Entire home/apt,150,93,3.79,243
39145,Justin,1,Entire home/apt,240,0,0.16,240
39146,Tisya,1,Private room,43,0,0.15,43
39147,Perrine,2,Private room,99,0,0.16,99
39150,Kazuya,2,Private room,41,186,0.41,227
39151,Heather,2,Entire home/apt,125,243,4.59,368
39152,Abby,2,Shared room,29,221,0.21,250
39153,Erik,2,Entire home/apt,250,0,0.16,250
39154,Alexandra,2,Entire home/apt,115,11,0.48,126
39156,Todd,2,Entire home/apt,392,318,3.12,710
39157,Kat,1,Private room,125,52,3.56,177
39158,Karim,1,Entire home/apt,950,90,0.37,1040
39159,Jona,2,Entire home/apt,360,21,3.94,381
39161,Kimberly,1,Entire home/apt,175,2,0.32,177
39163,Iryna,1,Entire home/apt,90,0,0.16,90
39164,Fatima,1,Private room,95,33,3.91,128
39165,Melly,2,Private room,50,189,0.85,239
39166,Jose,1,Entire home/apt,150,5,0.57,155
39167,Leo,2,Private room,100,0,0.16,100
39168,Melly,2,Private room,59,343,0.94,402
39169,Melly,2,Private room,60,330,1.12,390
39170,Melly,2,Private room,48,189,0.31,237
39173,Melly,2,Private room,48,364,0.7,412
39174,Luke,2,Private room,65,95,0.15,160
39175,Olga,2,Entire home/apt,69,57,6.09,126
39176,Matthew,2,Private room,70,0,0.16,70
39177,Neil,2,Private room,120,89,0.3,209
39178,Dania,2,Private room,90,1,2.0,91
39179,Melly,2,Private room,40,354,0.47,394
39180,Olly,3,Private room,60,356,2.27,416
39181,明凤,2,Private room,45,324,2.07,369
39182,Mikael,2,Entire home/apt,150,8,0.32,158
39184,Melly,2,Private room,48,341,0.56,389
39187,Martha Nicole,1,Entire home/apt,99,0,0.49,99
39188,Richard,1,Private room,94,76,4.58,170
39189,Jessica,3,Private room,55,44,3.39,99
39191,Anne,2,Entire home/apt,520,24,0.16,544
39192,Toma,2,Entire home/apt,70,0,3.27,70
39195,Bárbara,2,Private room,55,0,0.32,55
39196,Jeniffer,3,Shared room,49,90,0.94,139
39197,Fran,3,Entire home/apt,135,36,0.76,171
39199,Kim,1,Entire home/apt,110,280,0.7,390
39200,Melly,2,Private room,40,325,0.56,365
39201,Qiuyang,1,Entire home/apt,500,0,0.71,500
39202,Jessica,3,Private room,65,0,0.47,65
39204,George,2,Entire home/apt,150,177,0.64,327
39205,Jeniffer,3,Private room,60,365,0.87,425
39206,Nicole,2,Entire home/apt,400,219,0.14,619
39207,Linda,1,Entire home/apt,195,13,1.71,208
39208,Melly,2,Private room,45,199,0.47,244
39210,Melly,2,Private room,45,331,0.42,376
39211,Andrew,1,Entire home/apt,240,156,1.98,396
39212,Yukee,1,Entire home/apt,199,320,0.68,519
39213,Kazuya,2,Private room,35,269,0.66,304
39214,John,2,Private room,57,90,0.44,147
39215,Kazuya,1,Private room,31,0,1.0,31
39216,Tj,2,Private room,65,222,2.5,287
39217,Christina,2,Private room,36,213,0.23,249
39218,Nicole,1,Private room,150,0,2.07,150
39219,Ian,2,Entire home/apt,120,0,0.47,120
39220,Alexandra-Katherine,1,Private room,150,20,2.25,170
39222,Daniyal,1,Entire home/apt,250,0,0.16,250
39223,Jimmy,2,Private room,55,45,3.38,100
39224,Kate,2,Private room,56,0,0.88,56
39226,Sunny,2,Private room,43,58,0.43,101
39227,Mario,2,Entire home/apt,80,3,0.47,83
39229,Tasha,2,Private room,90,63,0.59,153
39230,Yolanda,2,Private room,100,89,0.16,189
39231,Manny,1,Private room,52,5,1.6,57
39232,Liam,1,Entire home/apt,182,41,0.8,223
39234,Pettrina,2,Private room,35,69,0.44,104
39236,Burhan,2,Entire home/apt,349,349,2.11,698
39237,Faith,3,Entire home/apt,125,21,3.79,146
39238,Dahilil,1,Private room,100,89,1.04,189
39239,Carrie & Mick,2,Entire home/apt,231,335,3.71,566
39240,Gia,1,Private room,69,98,4.93,167
39241,Avihay,2,Entire home/apt,200,219,0.16,419
39242,Fatima,1,Entire home/apt,135,2,1.67,137
39244,Michael,2,Entire home/apt,120,157,0.45,277
39245,Olivia,2,Private room,40,15,0.16,55
39246,Rose,2,Entire home/apt,125,96,2.61,221
39247,Antoine,1,Entire home/apt,199,228,3.0,427
39248,Bedly Bushwick,2,Private room,37,45,0.75,82
39249,Vicky,3,Private room,80,138,1.97,218
39250,Smidty,2,Private room,25,211,3.61,236
39251,Alisa,2,Private room,55,4,0.75,59
39252,Eve,1,Entire home/apt,250,315,2.04,565
39253,Jimmy,2,Private room,55,42,3.52,97
39255,475,1,Private room,95,178,0.79,273
39256,Marcelina,4,Entire home/apt,40,107,2.7,147
39257,Jimmy,2,Private room,55,53,2.82,108
39259,Luciana,2,Entire home/apt,190,128,0.32,318
39260,Vicky,3,Private room,80,163,1.59,243
39261,Jimmy,2,Private room,55,53,2.7,108
39262,Vicky,3,Private room,80,137,2.28,217
39263,Nicolas,1,Private room,160,64,0.48,224
39264,David,1,Private room,75,2,5.97,77
39265,Samet,1,Private room,80,0,0.42,80
39266,Jamal,1,Entire home/apt,250,60,3.8,310
39267,Javier,1,Private room,85,344,3.35,429
39268,Max,1,Private room,120,0,1.15,120
39271,Kazuya,3,Private room,36,234,0.23,270
39272,Tosin,3,Entire home/apt,145,311,0.45,456
39273,Andre,1,Private room,55,359,1.98,414
39278,Kelsang,3,Private room,49,0,0.18,49
39280,Olivia,2,Private room,90,11,0.6,101
39281,Darlene,2,Private room,50,48,0.68,98
39282,Kellie,1,Private room,100,0,0.16,100
39285,Irina,1,Entire home/apt,190,331,0.2,521
39286,Glenna,2,Entire home/apt,150,15,0.32,165
39287,Matthew,2,Private room,50,0,0.15,50
39288,Rae,1,Entire home/apt,500,18,0.8,518
39290,Emily,2,Entire home/apt,150,4,0.95,154
39291,Mariana,2,Entire home/apt,200,31,0.32,231
39292,Joy,2,Private room,59,0,0.29,59
39293,Margaret/Matthew,2,Entire home/apt,100,219,3.79,319
39294,Rose,1,Private room,125,38,0.73,163
39295,James,2,Entire home/apt,150,48,0.16,198
39296,Jimmy,2,Private room,55,58,1.76,113
39297,Daniel,1,Entire home/apt,240,0,1.01,240
39298,Annette,2,Entire home/apt,140,5,0.16,145
39299,Brian,1,Entire home/apt,250,0,3.98,250
39300,Anting,2,Entire home/apt,199,365,0.79,564
39301,Jamis,2,Entire home/apt,150,0,0.63,150
39304,Michel And Antoine,1,Entire home/apt,299,207,3.5,506
39305,Lily,2,Entire home/apt,85,19,0.32,104
39306,Ned,1,Entire home/apt,152,0,0.38,152
39307,Hudson River Hotel,1,Private room,209,84,3.49,293
39308,Micah,2,Entire home/apt,100,0,2.17,100
39309,Gianluca,1,Shared room,45,96,2.28,141
39310,Samantha,1,Private room,96,31,6.83,127
39311,Jocelyn,2,Entire home/apt,100,0,0.42,100
39312,Tussan,3,Private room,51,83,9.15,134
39313,Danielle,1,Entire home/apt,300,17,0.3,317
39314,Matthew,1,Entire home/apt,120,0,0.91,120
39315,Claudia And Luis,3,Private room,85,60,2.62,145
39316,Henry,3,Entire home/apt,65,78,7.69,143
39317,Tanya,1,Entire home/apt,165,31,1.47,196
39318,Nathan,2,Entire home/apt,200,321,0.43,521
39319,Sara,2,Private room,60,220,3.67,280
39321,Linda,1,Private room,175,250,2.84,425
39322,Sifan,3,Shared room,34,51,1.86,85
39324,Adrien,1,Private room,79,0,4.63,79
39325,Orlando,3,Entire home/apt,95,101,4.11,196
39326,Nelmir,2,Entire home/apt,80,8,0.81,88
39327,Marnie,2,Shared room,70,135,0.59,205
39328,Jasmine,1,Entire home/apt,240,338,1.73,578
39329,Max,2,Entire home/apt,100,7,0.48,107
39330,Allie,2,Entire home/apt,100,0,1.03,100
39331,Ali,1,Entire home/apt,120,0,0.22,120
39332,Franklyn,2,Entire home/apt,200,30,4.22,230
39334,Nick,1,Entire home/apt,172,0,0.42,172
39335,Drew,3,Private room,68,0,1.04,68
39336,Azu,2,Private room,75,101,4.0,176
39337,Aimar,3,Private room,55,188,1.08,243
39338,Aurélie,2,Private room,50,0,0.16,50
39339,Cameron,2,Entire home/apt,125,95,0.16,220
39340,Max,2,Entire home/apt,160,6,1.39,166
39341,Huma,3,Private room,60,0,1.49,60
39342,Walkiria,1,Private room,65,86,3.89,151
39343,Bree,2,Private room,75,0,0.28,75
39344,Kazuya,3,Private room,61,230,0.75,291
39345,Juan Carlos,2,Entire home/apt,150,12,0.59,162
39346,Danielle,1,Private room,125,23,0.32,148
39347,Sanny,3,Entire home/apt,99,289,5.12,388
39349,Erik,2,Private room,75,0,2.0,75
39350,Chris,3,Private room,70,89,0.64,159
39351,David,1,Private room,55,2,7.64,57
39353,Maxime C/Armande C,1,Private room,90,0,3.09,90
39354,Kayla,2,Private room,65,146,3.13,211
39355,Maxime C/Armande C,1,Private room,90,173,3.66,263
39357,Todd,2,Entire home/apt,180,90,0.14,270
39358,Celia,2,Entire home/apt,99,50,5.0,149
39359,Alaz,3,Entire home/apt,100,294,3.55,394
39360,Steve,2,Entire home/apt,140,35,3.33,175
39361,Zach,1,Private room,49,0,0.35,49
39362,Juanita,1,Entire home/apt,150,0,0.17,150
39363,Delia,1,Entire home/apt,285,241,3.48,526
39364,Rebecca,3,Entire home/apt,150,0,0.32,150
39365,Dave,1,Private room,89,285,3.37,374
39366,Dina,1,Private room,75,0,1.76,75
39367,Tatiana,2,Entire home/apt,75,0,0.25,75
39368,Courtney,2,Entire home/apt,99,0,0.81,99
39370,Annette,1,Private room,65,363,0.48,428
39371,Warren,1,Private room,133,87,4.32,220
39372,Warren,1,Private room,130,81,2.88,211
39373,Ed,1,Private room,172,85,4.74,257
39374,Shane & Shreshth,2,Private room,40,18,7.11,58
39375,Nicole,1,Entire home/apt,100,52,1.04,152
39376,Grant,2,Private room,80,219,0.16,299
39377,Zohar,1,Entire home/apt,180,0,0.15,180
39378,Liz,2,Entire home/apt,93,0,0.78,93
39379,Daniel,2,Entire home/apt,100,0,1.9,100
39380,Corey,3,Entire home/apt,299,78,1.47,377
39381,Chantel,4,Entire home/apt,69,92,3.66,161
39382,Anastasia,2,Entire home/apt,110,294,5.43,404
39383,Susy,2,Entire home/apt,120,8,4.2,128
39384,Sini,2,Entire home/apt,120,1,0.16,121
39385,Matheus,1,Entire home/apt,250,364,2.19,614
39386,Nana,2,Entire home/apt,130,6,0.63,136
39387,Shenqi,1,Private room,43,50,0.16,93
39388,Samanta,3,Entire home/apt,179,116,5.15,295
39389,Peter,2,Entire home/apt,90,50,2.59,140
39390,Kelly,2,Private room,500,0,4.62,500
39391,Keith,3,Private room,60,2,2.55,62
39393,Claudia,2,Entire home/apt,110,90,0.65,200
39397,Laura,1,Private room,70,146,0.61,216
39398,Patrick,1,Entire home/apt,228,78,4.42,306
39399,Andrea,1,Entire home/apt,150,71,0.28,221
39400,Sara,1,Entire home/apt,154,12,0.59,166
39401,Thibaut,2,Entire home/apt,179,0,2.54,179
39402,Eli,3,Entire home/apt,283,303,1.75,586
39403,Robert,2,Private room,45,150,1.89,195
39405,Xie,2,Private room,69,329,2.2,398
39408,Kazuya,3,Private room,39,0,1.0,39
39412,Lisa,1,Entire home/apt,150,332,0.61,482
39414,Ana Luiza,2,Private room,54,0,0.15,54
39415,Julio,3,Private room,62,365,0.32,427
39416,Michael,1,Private room,180,0,0.17,180
39417,Mansi,2,Entire home/apt,145,12,1.0,157
39418,Elena,1,Entire home/apt,200,88,0.16,288
39419,Jessica,2,Entire home/apt,110,243,2.51,353
39421,Oleg,1,Entire home/apt,225,108,0.37,333
39422,Yuliya,1,Entire home/apt,200,24,0.2,224
39423,Tina,2,Private room,70,41,0.85,111
39424,Jennifer,1,Entire home/apt,150,3,3.22,153
39425,475,1,Private room,95,180,0.93,275
39426,Madison,1,Private room,80,0,0.6,80
39430,Diego,2,Entire home/apt,250,251,0.16,501
39431,Jay,2,Private room,55,173,1.38,228
39432,Muneeba,2,Entire home/apt,150,244,2.67,394
39434,Jay,2,Private room,55,163,1.5,218
39435,Jay,2,Private room,55,173,1.13,228
39437,Sunny,2,Private room,35,89,0.79,124
39438,Luisa,1,Entire home/apt,350,286,1.32,636
39439,Zel,1,Entire home/apt,195,239,2.08,434
39440,Alex,2,Private room,89,16,0.43,105
39441,Crystal,1,Private room,59,0,1.43,59
39444,David,2,Private room,48,34,2.05,82
39446,Shu,1,Entire home/apt,149,0,0.46,149
39447,Diana And Peter,2,Private room,49,294,2.22,343
39448,Freddy,2,Private room,77,364,1.84,441
39451,Mark,2,Entire home/apt,225,88,0.16,313
39452,Diana And Peter,2,Private room,49,360,3.22,409
39454,Lisa,3,Entire home/apt,120,66,6.51,186
39456,Yukako,2,Private room,200,351,0.37,551
39457,Matilda,1,Private room,115,0,0.52,115
39459,Fitzene,2,Entire home/apt,190,2,0.15,192
39462,Sam,1,Entire home/apt,175,364,0.25,539
39463,Jieyu,2,Private room,30,0,0.16,30
39464,Marianne,2,Private room,35,5,0.48,40
39465,Layla,2,Private room,37,10,4.58,47
39466,Clarissa,1,Private room,79,7,3.59,86
39467,Malca,3,Private room,40,0,0.32,40
39469,Mary,2,Private room,100,240,3.69,340
39470,Tatiana,1,Private room,199,0,0.16,199
39471,Pirin,1,Entire home/apt,550,126,1.72,676
39472,Yemi,3,Private room,55,30,1.34,85
39473,Kazuya,3,Private room,40,247,0.28,287
39476,Anthony,1,Private room,150,19,3.87,169
39480,Cristiano,2,Entire home/apt,140,66,2.25,206
39481,Shogo,3,Private room,35,7,0.9,42
39482,Georgette'S,2,Entire home/apt,89,132,1.86,221
39483,Zach,2,Private room,48,342,1.0,390
39484,Aiden & Cassy,1,Entire home/apt,239,345,2.1,584
39485,Felicia,1,Entire home/apt,90,17,3.4,107
39486,Sara,1,Entire home/apt,350,127,1.15,477
39487,Zach,2,Private room,48,322,1.0,370
39489,Mariia,1,Entire home/apt,350,81,0.63,431
39490,Jimmy,2,Entire home/apt,599,110,0.35,709
39491,Vanessa,2,Entire home/apt,89,295,0.39,384
39494,Crystal,1,Entire home/apt,129,22,0.93,151
39495,Zach,2,Private room,48,220,0.21,268
39497,Wei,3,Private room,40,8,2.07,48
39499,Studioplus,1,Entire home/apt,220,286,2.47,506
39500,Indre,2,Entire home/apt,120,0,0.35,120
39501,Zach,2,Private room,48,311,0.22,359
39502,Yao & Rain,1,Entire home/apt,150,281,0.47,431
39503,Maria,1,Private room,99,358,0.44,457
39505,Sam,2,Entire home/apt,100,0,0.75,100
39506,Camilla,2,Entire home/apt,100,173,3.3,273
39508,Clara,3,Private room,80,365,0.48,445
39510,Karen Jennifer & Jan,2,Private room,50,311,2.71,361
39511,Jessica,2,Entire home/apt,100,326,1.12,426
39513,Norman,2,Entire home/apt,150,299,3.94,449
39514,Maira,1,Private room,75,120,2.49,195
39515,Kenneth,1,Entire home/apt,116,0,2.5,116
39516,Lauren,2,Private room,60,0,0.34,60
39517,Stephanie,2,Private room,70,81,0.78,151
39518,Bill,1,Entire home/apt,125,24,1.12,149
39519,Allan C.,1,Private room,90,40,0.25,130
39521,Tyler,1,Entire home/apt,200,78,0.32,278
39522,Dany,1,Private room,90,23,0.31,113
39523,Emmanuel,1,Entire home/apt,350,95,4.09,445
39524,Nekhena,2,Shared room,75,123,3.72,198
39525,Edward,1,Private room,65,0,1.99,65
39526,Baptiste,2,Private room,72,0,0.31,72
39527,Jim,1,Private room,120,31,3.17,151
39528,Mila,1,Entire home/apt,180,5,1.14,185
39530,Nikita,1,Entire home/apt,250,0,6.32,250
39531,Goenuel,2,Entire home/apt,160,110,3.28,270
39533,Elizabeth,2,Entire home/apt,300,7,1.44,307
39534,Vanessa,3,Private room,66,131,4.52,197
39535,Syed,1,Private room,65,0,0.15,65
39536,Lionel,1,Entire home/apt,160,80,3.04,240
39537,Kafayat,3,Private room,38,6,2.71,44
39538,Laura,1,Entire home/apt,185,0,1.11,185
39540,Charlie,1,Entire home/apt,199,50,0.42,249
39541,Gillian,2,Entire home/apt,175,34,0.62,209
39542,Miriam,3,Private room,60,331,0.48,391
39543,Liza,1,Private room,159,189,0.16,348
39546,Mark,1,Entire home/apt,432,325,3.35,757
39547,Ta56,3,Entire home/apt,66,186,1.36,252
39548,Marisa,1,Private room,80,29,0.71,109
39549,Nuriia,2,Entire home/apt,150,6,1.27,156
39550,Jermaine,2,Entire home/apt,185,48,2.48,233
39551,Darlena,2,Private room,29,66,0.94,95
39553,Alexis,1,Private room,190,89,0.16,279
39554,Monica,3,Private room,42,326,0.5,368
39556,Carlos & Lina,3,Private room,45,54,2.14,99
39557,Arjay,1,Private room,131,0,0.32,131
39559,Jordana,1,Private room,89,0,0.16,89
39562,Mihika,3,Shared room,40,0,0.16,40
39563,William,2,Private room,45,0,1.16,45
39566,Kevin,1,Private room,129,49,4.69,178
39567,Kazuya,3,Private room,33,236,0.7,269
39568,Dustin,3,Entire home/apt,122,73,2.71,195
39569,Kevin,1,Private room,129,59,5.39,188
39570,Miriam,3,Private room,50,341,0.45,391
39571,Avner,1,Entire home/apt,140,354,0.59,494
39573,Avner,1,Entire home/apt,130,365,0.29,495
39574,Cristian,1,Private room,180,126,4.58,306
39575,Cristian,1,Private room,160,73,4.71,233
39576,Cristian,1,Private room,130,114,4.35,244
39577,Alex,1,Entire home/apt,150,345,1.13,495
39579,Patricia,1,Entire home/apt,90,209,0.67,299
39581,Gabriel,1,Private room,199,363,0.61,562
39583,Alessandra,1,Private room,90,0,0.32,90
39584,Yoanna,2,Entire home/apt,444,326,2.49,770
39586,Brent & Kaley,1,Entire home/apt,349,352,1.88,701
39587,Kyle,2,Entire home/apt,195,44,0.31,239
39589,Richard,1,Private room,70,172,0.16,242
39591,Elsie,2,Entire home/apt,150,34,0.47,184
39593,Gabriel,1,Private room,199,365,0.15,564
39594,Brandon,2,Entire home/apt,199,0,0.32,199
39595,Dotan,2,Entire home/apt,120,189,0.16,309
39596,Katie,3,Private room,40,0,0.48,40
39597,Abella,2,Private room,120,269,0.47,389
39598,Carlos,1,Entire home/apt,350,198,5.25,548
39599,Lucky,3,Entire home/apt,94,329,1.32,423
39600,Mario,1,Entire home/apt,185,128,0.99,313
39601,Angeles,1,Entire home/apt,150,0,0.32,150
39602,Joey,1,Entire home/apt,225,68,3.17,293
39603,Noah,1,Private room,120,0,0.32,120
39604,Lucia And Rob,2,Entire home/apt,100,5,0.27,105
39605,Peter,2,Entire home/apt,130,0,0.16,130
39607,Tommy,1,Entire home/apt,140,5,0.65,145
39608,Carolle,1,Private room,89,26,0.16,115
39609,David,3,Private room,40,156,1.0,196
39610,Jill S,1,Entire home/apt,145,163,2.63,308
39611,Luping,1,Entire home/apt,185,295,3.37,480
39612,Emilie,2,Entire home/apt,250,10,0.31,260
39614,Annette,4,Private room,99,318,0.16,417
39615,Maria,1,Private room,120,321,4.67,441
39616,Haru,1,Private room,75,11,2.8,86
39617,Scott,2,Entire home/apt,180,158,0.24,338
39618,Giancarlo,2,Entire home/apt,250,271,2.35,521
39619,Matt,2,Private room,30,220,0.32,250
39620,Ace,2,Entire home/apt,114,68,4.38,182
39621,呈刚,3,Private room,45,0,0.68,45
39622,Julio,3,Private room,100,179,0.46,279
39624,Cesar,4,Private room,34,0,0.29,34
39625,Gina,2,Private room,85,25,0.32,110
39626,Jane,1,Entire home/apt,150,0,0.55,150
39627,Hortense,2,Private room,50,0,0.18,50
39628,Better Home,3,Entire home/apt,75,300,6.19,375
39629,Isaac,3,Private room,70,69,2.43,139
39630,Diana,2,Private room,60,0,0.16,60
39631,Angelina,3,Private room,37,249,0.16,286
39632,Carmen,5,Entire home/apt,135,232,1.76,367
39634,Mike,1,Entire home/apt,300,193,0.78,493
39635,Sonia,1,Private room,65,0,1.7,65
39636,Sedef,2,Entire home/apt,300,0,0.3,300
39637,Melissa,1,Entire home/apt,180,0,0.32,180
39638,Chassity,2,Private room,40,90,2.37,130
39640,A. Nicholas,1,Private room,80,27,5.33,107
39641,Krysia,1,Entire home/apt,160,0,0.16,160
39644,A. Nicholas,1,Private room,80,18,4.26,98
39645,Eric,2,Entire home/apt,110,189,0.16,299
39646,Douglas,1,Entire home/apt,285,44,1.4,329
39647,Malca,3,Private room,49,111,0.95,160
39648,Jessenia,2,Private room,60,20,1.43,80
39649,Silvio,1,Entire home/apt,300,0,0.65,300
39651,Kin,2,Private room,55,174,2.2,229
39652,Martin,1,Entire home/apt,190,115,2.36,305
39654,Jannette,3,Private room,30,0,1.76,30
39655,Jenuine,1,Entire home/apt,195,239,0.62,434
39656,Veronica,5,Entire home/apt,100,296,2.81,396
39657,Amy,2,Entire home/apt,160,49,0.59,209
39658,Dylan,2,Private room,100,325,2.81,425
39659,Tong,1,Entire home/apt,60,0,0.59,60
39661,Alex,2,Private room,65,44,6.67,109
39662,Nicole,2,Private room,50,0,0.46,50
39664,Kevin,1,Entire home/apt,450,158,0.32,608
39665,Ashli,2,Entire home/apt,115,0,0.32,115
39666,Zach,2,Private room,48,59,1.0,107
39667,Marissa,1,Entire home/apt,499,297,2.27,796
39669,Studioplus,1,Entire home/apt,240,304,2.0,544
39670,David,2,Private room,500,89,0.16,589
39671,Zach,2,Private room,48,58,0.48,106
39672,Lennon,1,Private room,80,0,0.48,80
39673,Gopal,2,Private room,109,66,2.53,175
39674,Eliana,1,Private room,52,0,0.79,52
39675,Siyi,2,Entire home/apt,139,134,1.36,273
39677,Siyi,2,Entire home/apt,145,118,2.13,263
39678,JuVita,2,Private room,80,32,1.51,112
39679,Jason,1,Entire home/apt,220,0,0.15,220
39680,Goran,1,Private room,180,341,0.16,521
39682,Sonia,3,Entire home/apt,99,329,9.5,428
39684,Carl,3,Entire home/apt,61,75,4.71,136
39685,Angelica,1,Entire home/apt,180,4,0.56,184
39686,Shared Stay-JFK The Hugh Suite,3,Private room,45,0,2.6,45
39687,Max,1,Entire home/apt,140,122,1.89,262
39688,Vikas,1,Private room,99,24,0.32,123
39689,Terrioma,2,Private room,70,73,0.3,143
39690,Mike,2,Private room,60,133,1.16,193
39692,James,1,Private room,85,357,2.27,442
39693,Chris,1,Entire home/apt,350,275,1.91,625
39694,Jared,2,Private room,31,0,0.34,31
39695,Janna,3,Entire home/apt,190,55,0.16,245
39696,Abdiaziz,1,Entire home/apt,180,85,3.79,265
39697,Dana,2,Entire home/apt,60,234,5.66,294
39698,Silvio,2,Private room,38,0,0.16,38
39699,Eduard,3,Entire home/apt,210,0,0.16,210
39701,Gwen,1,Entire home/apt,350,23,2.59,373
39703,Tk,2,Private room,60,0,0.38,60
39704,Madison,2,Entire home/apt,125,285,0.16,410
39706,Yocasta,1,Entire home/apt,155,123,2.73,278
39707,Leah,2,Private room,45,21,0.32,66
39710,Sahla,3,Entire home/apt,85,14,2.63,99
39711,Mic,1,Entire home/apt,109,9,0.84,118
39712,Eriola,2,Entire home/apt,98,23,0.16,121
39713,Arnaud,1,Entire home/apt,400,0,0.3,400
39714,Joe,1,Entire home/apt,125,230,3.55,355
39715,Kai,1,Entire home/apt,750,249,0.78,999
39716,Samantha,1,Entire home/apt,160,11,0.95,171
39717,Alex,2,Entire home/apt,125,81,0.5,206
39718,Shiniqua,3,Entire home/apt,93,19,3.64,112
39719,Demi,2,Entire home/apt,275,0,0.85,275
39720,Nina,1,Entire home/apt,375,0,0.16,375
39723,Rémy,2,Private room,80,0,0.31,80
39724,Kris,1,Entire home/apt,299,155,1.0,454
39725,Ayzhan,1,Private room,100,82,5.59,182
39726,Litri,1,Private room,90,1,0.77,91
39727,Hanna,2,Private room,55,0,0.65,55
39728,Sophie,1,Entire home/apt,180,166,2.68,346
39729,Andrada And Alex,2,Private room,45,37,4.59,82
39730,A. Nicholas,1,Private room,80,2,0.74,82
39731,Stephane & Mike,1,Entire home/apt,153,274,0.81,427
39733,Tanya,1,Private room,350,0,1.07,350
39734,Alexandra,2,Entire home/apt,125,0,0.16,125
39735,Stephanie,2,Entire home/apt,600,66,0.16,666
39737,Janet,1,Private room,425,180,0.16,605
39738,Maura,2,Entire home/apt,88,34,0.3,122
39739,Saly,3,Private room,65,341,0.59,406
39740,Nan,1,Entire home/apt,420,76,3.02,496
39741,Gabi,1,Entire home/apt,220,9,0.45,229
39746,Colleen,2,Entire home/apt,175,0,0.16,175
39748,Robert,1,Entire home/apt,380,0,1.89,380
39749,Alena,3,Private room,45,5,0.38,50
39750,Li,3,Private room,300,133,0.47,433
39751,Jackson,1,Entire home/apt,443,165,4.92,608
39752,Nicole,1,Private room,50,0,0.47,50
39753,Dor,1,Entire home/apt,116,99,4.57,215
39754,Emily,1,Private room,119,239,5.22,358
39756,Grace,1,Entire home/apt,225,11,2.08,236
39757,Michael,4,Entire home/apt,150,109,4.7,259
39758,Matthew,1,Entire home/apt,179,229,4.77,408
39759,Vincent,3,Entire home/apt,200,0,1.0,200
39760,Christine,2,Private room,60,0,0.48,60
39764,Lorenzo,1,Private room,83,0,0.15,83
39765,Marc,1,Entire home/apt,300,21,1.28,321
39767,Reem,1,Private room,55,3,0.59,58
39768,Charles,2,Private room,30,0,0.15,30
39769,Sonder (NYC),1,Entire home/apt,262,91,1.86,353
39770,Sonder (NYC),1,Entire home/apt,255,81,2.59,336
39771,Sonder (NYC),1,Entire home/apt,245,137,0.94,382
39772,Sonder (NYC),1,Entire home/apt,185,281,1.0,466
39773,Sonder (NYC),1,Entire home/apt,185,332,1.0,517
39774,Sonder (NYC),1,Entire home/apt,252,117,1.19,369
39775,Sonder (NYC),1,Entire home/apt,189,325,0.94,514
39776,Sonder (NYC),1,Entire home/apt,228,111,0.91,339
39777,Sonder (NYC),1,Entire home/apt,240,99,1.06,339
39778,Sonder (NYC),1,Entire home/apt,241,130,1.3,371
39779,Sonder (NYC),1,Entire home/apt,265,83,1.21,348
39780,Sonder (NYC),1,Entire home/apt,263,62,0.99,325
39781,Sonder (NYC),1,Entire home/apt,243,153,1.09,396
39782,Sonder (NYC),1,Entire home/apt,254,159,0.34,413
39783,Irma,3,Private room,35,310,0.76,345
39784,Hadley,2,Private room,45,0,0.49,45
39788,Alessandro,2,Private room,80,280,0.63,360
39789,Megan,1,Entire home/apt,80,0,0.15,80
39790,Yasha,3,Private room,60,51,0.16,111
39791,Šara,2,Entire home/apt,115,16,1.0,131
39792,Sarah,1,Entire home/apt,235,0,1.14,235
39793,Launa,1,Private room,150,0,0.16,150
39794,Nicole,2,Private room,100,6,0.15,106
39796,Oliver,1,Entire home/apt,199,0,1.43,199
39797,Ben,1,Private room,150,7,2.25,157
39798,Rafe,2,Private room,100,0,0.16,100
39799,Sehwan,1,Private room,89,0,0.32,89
39800,Trevor,4,Private room,70,342,0.16,412
39801,Kel,2,Entire home/apt,113,118,2.07,231
39803,Chase,1,Shared room,80,48,2.67,128
39804,Jose,1,Entire home/apt,150,0,0.16,150
39805,Monica,4,Shared room,20,139,0.48,159
39806,Dan,2,Shared room,40,50,0.55,90
39807,Julie,1,Entire home/apt,499,356,2.83,855
39808,Andy,4,Entire home/apt,200,347,5.13,547
39809,Megan,1,Private room,75,0,2.88,75
39810,Andy,4,Entire home/apt,299,322,1.52,621
39814,Alyssa,1,Entire home/apt,1075,365,0.61,1440
39815,Joseph,2,Private room,55,0,0.16,55
39818,LaTasha,2,Entire home/apt,50,26,1.69,76
39824,Alexander,1,Entire home/apt,175,0,0.16,175
39825,Austin,1,Entire home/apt,200,0,0.26,200
39826,Ellen Fannie,1,Entire home/apt,102,0,0.3,102
39827,Jacob,1,Shared room,99,33,1.04,132
39828,Erica,3,Entire home/apt,200,265,3.5,465
39829,Sofia,3,Private room,55,0,0.33,55
39830,Zahava,2,Private room,65,0,0.15,65
39831,Clinton,3,Entire home/apt,140,101,0.48,241
39832,Melysa,2,Entire home/apt,100,1,0.31,101
39833,Lida,1,Entire home/apt,550,14,1.38,564
39834,Marisa,1,Entire home/apt,134,20,5.08,154
39835,Joseph,1,Private room,150,184,4.04,334
39836,Josh,2,Entire home/apt,105,144,3.96,249
39837,Tim,2,Private room,75,47,0.53,122
39838,Candy,1,Entire home/apt,250,244,3.53,494
39839,Ashley,1,Entire home/apt,295,140,0.8,435
39840,Fnu,2,Private room,32,0,0.16,32
39841,Joshua,2,Private room,35,0,0.77,35
39842,Kal,1,Entire home/apt,180,57,3.06,237
39843,Brittney,2,Private room,70,0,0.16,70
39844,Sierra,1,Entire home/apt,130,0,0.63,130
39845,Emmanuel,1,Private room,60,66,5.34,126
39847,Farah,5,Private room,85,305,3.92,390
39848,Chase,1,Shared room,80,52,2.82,132
39849,Chase,1,Shared room,80,22,5.82,102
39850,Ilia,1,Entire home/apt,220,22,1.53,242
39851,Chase,1,Shared room,80,46,3.58,126
39852,Rob,1,Private room,120,66,1.11,186
39853,Alexandra,2,Entire home/apt,200,0,2.3,200
39854,Sharyn,2,Private room,40,93,2.39,133
39855,Evan,2,Private room,60,210,1.0,270
39856,Rosario,4,Private room,80,155,0.6,235
39865,Tiba,1,Entire home/apt,230,282,4.21,512
39867,Phil,1,Private room,99,43,2.54,142
39868,Jose,2,Private room,70,137,2.32,207
39869,Brian,1,Entire home/apt,139,10,0.79,149
39870,Anna,1,Entire home/apt,135,0,0.15,135
39872,Albert,1,Entire home/apt,350,342,0.38,692
39873,Joe,2,Entire home/apt,99,0,0.18,99
39875,Cyn,1,Private room,65,0,0.57,65
39877,Beny & Maria,2,Entire home/apt,450,334,2.79,784
39879,Tee,2,Entire home/apt,120,3,0.6,123
39880,Susan,2,Private room,60,189,0.31,249
39881,Lira,2,Private room,130,0,0.16,130
39882,Diego,2,Entire home/apt,100,0,4.67,100
39883,Katherine,3,Private room,75,256,5.38,331
39884,Jack,2,Entire home/apt,199,129,2.57,328
39885,Chris,1,Entire home/apt,183,294,5.36,477
39886,Kevin,2,Private room,35,100,3.33,135
39887,Satish,2,Shared room,22,0,0.81,22
39888,Massimo,2,Entire home/apt,104,43,4.95,147
39889,Nick,1,Entire home/apt,100,0,0.18,100
39891,KImberly,3,Entire home/apt,150,107,0.78,257
39892,Alyssa,1,Entire home/apt,820,365,1.0,1185
39893,Andrew,1,Private room,69,8,9.29,77
39894,Viktoria,4,Private room,49,0,0.45,49
39895,Sherry,1,Entire home/apt,205,44,3.4,249
39896,Allie,1,Entire home/apt,91,1,0.33,92
39897,MyHomes,3,Private room,90,29,4.09,119
39900,Omri,2,Private room,45,3,0.97,48
39901,Molly,1,Entire home/apt,520,80,1.14,600
39902,Jing,3,Entire home/apt,58,57,2.95,115
39905,Adelle,1,Entire home/apt,130,4,1.76,134
39906,Christina,3,Private room,70,0,0.27,70
39907,Kate,2,Private room,40,0,1.3,40
39908,Ana,1,Private room,399,246,1.57,645
39909,Alex,2,Private room,118,112,0.67,230
39911,Sebastian,2,Private room,37,1,1.25,38
39913,Alex,1,Entire home/apt,370,155,3.02,525
39914,Roberto,4,Entire home/apt,165,310,0.63,475
39915,Alexandra-Katherine,1,Private room,125,165,0.79,290
39917,Max,1,Private room,99,5,1.02,104
39918,Grace,3,Private room,35,0,5.84,35
39919,Anna,2,Entire home/apt,100,0,0.82,100
39920,Andrea,1,Private room,150,72,1.89,222
39921,Jaclyn,2,Entire home/apt,175,9,0.63,184
39922,Mother & Daughter,2,Entire home/apt,75,185,4.26,260
39923,Konni,3,Entire home/apt,85,12,0.56,97
39924,James,1,Private room,100,0,1.69,100
39925,Chafiq,2,Entire home/apt,200,285,2.94,485
39926,Monica,4,Shared room,20,114,0.32,134
39927,Marcela,2,Entire home/apt,155,10,1.0,165
39928,Milan,1,Entire home/apt,400,0,2.73,400
39929,Mainul,3,Entire home/apt,60,50,3.0,110
39930,Scott,1,Entire home/apt,135,141,4.24,276
39934,Javier,3,Entire home/apt,200,0,0.15,200
39935,Dj,2,Private room,140,365,0.63,505
39936,Alan,3,Entire home/apt,120,303,0.43,423
39937,Irwin,1,Entire home/apt,250,233,0.34,483
39938,Tom,2,Private room,90,91,2.34,181
39941,Danica,3,Entire home/apt,200,11,0.5,211
39942,Christina,1,Entire home/apt,200,11,1.43,211
39943,Yao & Rain,1,Private room,55,1,1.76,56
39945,Yao & Rain,1,Private room,55,154,1.09,209
39946,Jerry And Kate,1,Entire home/apt,250,0,1.54,250
39947,Yao & Rain,1,Private room,50,237,1.11,287
39948,Yao & Rain,1,Private room,58,314,0.33,372
39949,Molly,3,Private room,56,12,0.15,68
39950,Yao & Rain,1,Private room,55,299,2.29,354
39951,Nourdine,1,Entire home/apt,160,0,0.16,160
39952,Helene,1,Entire home/apt,149,35,2.43,184
39953,Kafayat,3,Private room,35,3,1.72,38
39954,Oleg,2,Entire home/apt,250,84,1.0,334
39955,Gad,2,Private room,175,89,0.2,264
39956,Andressa,3,Private room,55,3,2.42,58
39957,Nusrat,2,Private room,55,0,0.16,55
39958,David,2,Entire home/apt,100,273,3.16,373
39959,Alex,2,Private room,89,260,1.98,349
39960,Tom,1,Private room,140,39,0.33,179
39961,Pirin,1,Entire home/apt,649,281,2.59,930
39962,Monica,4,Shared room,20,25,0.68,45
39963,Alex,2,Entire home/apt,189,242,0.45,431
39964,Eleanor And Alex,2,Private room,55,28,3.77,83
39966,Trisha,3,Private room,65,0,0.41,65
39967,Souha,1,Private room,89,170,0.95,259
39969,Souha,1,Private room,89,127,2.01,216
39970,Zack,1,Entire home/apt,165,12,0.46,177
39971,Jacob,1,Entire home/apt,142,0,0.45,142
39973,Clara,3,Private room,46,0,0.63,46
39974,Samuel,1,Private room,75,0,0.16,75
39975,Jason,2,Private room,63,47,9.64,110
39976,Jason,2,Private room,75,16,0.32,91
39978,Hudson River Hotel,1,Private room,249,81,2.13,330
39979,Robert,2,Entire home/apt,250,0,0.16,250
39980,Aaron,2,Private room,60,0,0.16,60
39982,Dan,2,Shared room,35,87,0.16,122
39984,Mike,2,Entire home/apt,100,12,1.93,112
39986,Flyn,3,Entire home/apt,65,182,4.4,247
39987,David And Natalia,1,Entire home/apt,399,118,3.44,517
39990,Shari,2,Entire home/apt,120,68,1.0,188
39992,Ara,3,Private room,60,0,1.27,60
39993,Dj,2,Private room,100,365,0.16,465
39994,Armel,1,Private room,125,0,0.3,125
39995,Bobby,1,Private room,90,88,0.94,178
39996,Will,4,Entire home/apt,100,20,2.98,120
39997,Mili,3,Private room,35,85,10.05,120
39998,Paul,2,Private room,75,0,1.42,75
40002,Naftali,1,Private room,28,0,1.05,28
40003,Carolina,1,Private room,85,42,1.67,127
40005,Yamid,3,Private room,50,16,4.73,66
40006,Decidel,3,Entire home/apt,80,313,2.31,393
40007,Yaacov,1,Entire home/apt,350,342,0.34,692
40008,Alexis,1,Private room,295,89,0.76,384
40009,Cathy,2,Entire home/apt,130,261,3.99,391
40010,Laura,2,Private room,80,0,1.48,80
40012,Qing,3,Entire home/apt,79,36,9.03,115
40013,Eugene,3,Entire home/apt,70,4,0.32,74
40014,Anish,1,Entire home/apt,225,90,0.37,315
40015,Robyn,1,Entire home/apt,300,16,2.57,316
40016,Margareth,2,Entire home/apt,83,349,0.81,432
40019,James,1,Entire home/apt,310,7,2.87,317
40020,Hudson River Hotel,1,Private room,209,53,3.28,262
40021,Shama,1,Entire home/apt,247,263,4.26,510
40022,Festus Atu,1,Entire home/apt,300,357,2.98,657
40023,Olabimpe,2,Private room,80,160,1.95,240
40024,Jonathan,1,Private room,99,44,3.09,143
40025,Lakshmee,3,Private room,100,335,13.3,435
40026,Ismail,2,Private room,60,327,1.5,387
40028,Abby,2,Shared room,40,281,0.26,321
40029,Steven,1,Entire home/apt,189,35,1.59,224
40030,Chemme,1,Entire home/apt,300,173,1.06,473
40034,Beverline,4,Entire home/apt,200,80,4.06,280
40035,Jane,3,Private room,44,119,1.55,163
40036,Lakshmee,3,Private room,30,189,15.23,219
40038,John,2,Private room,60,78,3.35,138
40039,Ling,2,Private room,48,169,0.91,217
40040,Gabriel,2,Entire home/apt,350,283,2.0,633
40041,Tega,2,Entire home/apt,90,1,0.18,91
40042,Yemi,3,Private room,35,46,0.47,81
40043,Ale And Tom,2,Entire home/apt,85,237,1.76,322
40044,Kusum&Kannan,1,Entire home/apt,250,0,0.16,250
40045,Shelby,1,Private room,70,0,0.95,70
40046,Mili,3,Private room,35,89,9.08,124
40047,Yana,1,Entire home/apt,160,0,0.39,160
40048,Alona,3,Entire home/apt,93,181,2.45,274
40049,Mili,3,Private room,45,89,11.38,134
40050,Teddy,2,Entire home/apt,249,0,0.98,249
40051,Alyona,1,Private room,150,157,0.67,307
40052,Kelsang,3,Private room,49,0,0.16,49
40053,Andressa,3,Private room,48,0,3.25,48
40055,Anchor,2,Shared room,27,89,0.63,116
40057,Anchor,2,Shared room,35,88,1.97,123
40059,Siji,2,Private room,59,13,4.49,72
40060,Avi,2,Entire home/apt,120,126,0.35,246
40061,Sait,1,Shared room,50,98,5.51,148
40062,Linda,5,Private room,65,362,1.37,427
40064,Mili,3,Entire home/apt,80,150,5.71,230
40065,Olabimpe,2,Private room,65,161,0.95,226
40068,Janna,3,Entire home/apt,85,85,0.42,170
40069,Juliet,1,Entire home/apt,288,87,0.7,375
40070,David,5,Private room,55,363,7.14,418
40071,Hasan,3,Entire home/apt,200,0,0.16,200
40072,Melissa,2,Private room,60,0,0.32,60
40073,April,2,Private room,112,84,5.09,196
40076,Zach Williams,2,Private room,35,20,1.17,55
40077,Victoria,2,Entire home/apt,150,89,7.36,239
40078,Rachel,2,Private room,61,307,0.16,368
40081,Maira,1,Entire home/apt,130,120,1.46,250
40082,Mike,2,Private room,70,63,0.32,133
40083,Serena,2,Private room,55,2,2.57,57
40084,Xi,3,Entire home/apt,200,148,4.86,348
40085,Chad,1,Private room,100,73,3.21,173
40086,Ilsa,2,Entire home/apt,1750,358,1.65,2108
40087,Nick & D.,2,Private room,48,0,0.38,48
40089,Brandi,2,Private room,55,0,0.38,55
40090,Emilie,2,Private room,35,97,5.75,132
40091,Leah,2,Private room,50,318,3.57,368
40092,Olga,1,Entire home/apt,115,116,3.21,231
40093,Joey,1,Entire home/apt,250,10,6.17,260
40094,Maria,2,Private room,60,9,2.46,69
40095,E. Adam,1,Entire home/apt,155,70,3.1,225
40096,Victor,3,Entire home/apt,188,344,0.99,532
40097,Baha,1,Entire home/apt,205,1,0.16,206
40098,Stivan,2,Private room,185,37,2.22,222
40099,Michael,1,Private room,200,365,0.76,565
40100,Kyle,1,Private room,200,0,0.32,200
40101,Laura,2,Entire home/apt,150,0,0.63,150
40103,Matt,1,Entire home/apt,279,0,3.27,279
40104,Lakshmee,3,Shared room,40,346,10.0,386
40105,Phi,2,Entire home/apt,125,57,5.16,182
40106,Reza,1,Private room,100,0,0.22,100
40107,Hugo,2,Entire home/apt,195,136,2.47,331
40108,Kim,1,Private room,120,0,1.43,120
40109,Olabimpe,2,Private room,65,164,2.73,229
40110,Beverline,4,Private room,125,80,1.46,205
40111,Vicky,2,Shared room,45,22,0.6,67
40112,Nichole,1,Private room,89,0,1.42,89
40113,Maor,3,Entire home/apt,45,0,1.33,45
40114,Francis,2,Entire home/apt,250,0,0.4,250
40115,Olabimpe,2,Private room,65,126,1.79,191
40116,Josh,1,Entire home/apt,450,89,0.32,539
40117,Todd,1,Entire home/apt,299,212,2.32,511
40120,Tom,2,Entire home/apt,99,273,4.97,372
40121,Kafayat,3,Private room,30,6,1.1,36
40122,Kafayat,3,Private room,38,6,2.06,44
40123,Sean,1,Entire home/apt,150,56,0.48,206
40125,Eric,2,Private room,80,78,2.68,158
40126,Brandon,3,Private room,70,134,0.65,204
40127,Winston,2,Entire home/apt,300,352,1.95,652
40128,Emily,2,Private room,39,89,2.15,128
40129,Mayra,1,Private room,70,39,3.0,109
40130,Mina,1,Entire home/apt,300,363,0.76,663
40131,Emma,1,Entire home/apt,250,0,1.12,250
40132,Katie,1,Entire home/apt,199,16,2.92,215
40133,Jaime,2,Private room,25,175,1.23,200
40134,Tanya,1,Entire home/apt,350,207,1.86,557
40135,Tylor,4,Private room,60,333,6.38,393
40136,Tim,2,Entire home/apt,125,227,4.25,352
40137,Mo,2,Private room,81,36,0.97,117
40138,David,1,Entire home/apt,219,39,0.16,258
40139,Max,1,Shared room,35,320,0.21,355
40143,Yasha,3,Private room,75,0,0.33,75
40144,Ewa,2,Entire home/apt,52,0,0.3,52
40145,Yemi,3,Private room,40,56,0.93,96
40146,Milena,1,Entire home/apt,215,265,0.26,480
40148,Chris,1,Entire home/apt,110,0,0.8,110
40149,Eddy,3,Entire home/apt,75,132,1.4,207
40151,Mikosya,2,Shared room,30,364,1.0,394
40152,Jon,1,Entire home/apt,1000,38,0.4,1038
40153,Logan,2,Private room,125,0,0.16,125
40154,Lugao,1,Private room,99,49,0.93,148
40157,Monica,2,Private room,30,0,0.33,30
40158,Matthew,1,Entire home/apt,190,0,0.32,190
40159,Maria,1,Private room,110,0,0.19,110
40160,Ana,1,Private room,250,1,3.17,251
40162,Nick & D.,2,Private room,48,0,0.36,48
40164,Ita,2,Private room,48,0,3.71,48
40165,Daniela,2,Private room,90,0,0.46,90
40168,Niccolo,2,Private room,60,220,0.63,280
40169,Kamaran,2,Entire home/apt,97,340,3.0,437
40170,John,1,Private room,99,321,1.7,420
40171,Nick & D.,2,Private room,48,0,0.49,48
40172,Nick & D.,2,Private room,48,0,0.8,48
40174,Nick & D.,2,Entire home/apt,156,21,4.69,177
40176,Daniel,3,Private room,98,0,0.21,98
40177,Ursula,2,Entire home/apt,99,32,5.0,131
40178,Julie,4,Entire home/apt,175,79,2.66,254
40179,Jannices,2,Private room,38,6,0.95,44
40180,Mohammed,1,Shared room,35,22,2.37,57
40182,D,2,Entire home/apt,180,24,0.41,204
40183,Jules,1,Entire home/apt,200,80,1.8,280
40184,Déon,2,Entire home/apt,195,301,1.28,496
40185,A. Nicholas,1,Private room,50,22,6.42,72
40186,Kazuya,3,Private room,60,209,0.27,269
40187,Roxanna,3,Private room,45,97,0.96,142
40188,Roxanna,3,Private room,55,286,2.22,341
40189,Ferris,2,Entire home/apt,90,91,4.15,181
40190,Kazuya,1,Private room,47,228,0.41,275
40191,KImberly,3,Shared room,65,365,0.16,430
40192,Rachel,1,Entire home/apt,250,0,1.7,250
40194,Modupe,3,Private room,42,365,2.4,407
40195,Millind,2,Private room,36,0,0.51,36
40196,Modupe,3,Private room,42,189,1.56,231
40197,Carlos,1,Private room,100,365,1.42,465
40198,Viviana,3,Private room,89,358,0.96,447
40199,Roxanna,3,Private room,45,217,0.32,262
40200,Alan,2,Private room,20,17,0.57,37
40201,Marcia,1,Private room,70,347,0.29,417
40202,Jenny,1,Entire home/apt,478,148,3.97,626
40204,Jason,3,Entire home/apt,400,34,2.65,434
40205,Hudson River Hotel,1,Private room,209,88,1.01,297
40206,Mohammed,1,Shared room,30,13,3.67,43
40208,Thatcher,2,Entire home/apt,205,203,1.3,408
40209,Lynda,2,Private room,85,168,3.16,253
40210,Zhaoxi,1,Entire home/apt,365,28,3.37,393
40211,D,2,Private room,65,26,3.11,91
40212,Tyler,2,Private room,60,151,2.0,211
40213,Melanie,2,Entire home/apt,120,20,2.53,140
40214,Marcia,1,Private room,80,70,1.89,150
40215,Farah,5,Private room,69,280,3.95,349
40216,Alan,2,Private room,20,38,1.4,58
40218,Chloe,2,Entire home/apt,60,153,0.47,213
40220,Richard,2,Private room,200,0,0.18,200
40221,Dana,1,Private room,115,33,2.07,148
40222,Tatiana,2,Private room,45,0,0.63,45
40223,Soft,4,Private room,100,150,1.05,250
40224,Samuel,3,Entire home/apt,72,293,4.55,365
40225,Mitchell,2,Entire home/apt,75,115,0.69,190
40226,Pamela,2,Private room,40,79,2.11,119
40227,Annie,2,Private room,79,69,1.11,148
40228,Reuven,2,Entire home/apt,130,96,1.95,226
40229,Lisa,2,Private room,40,54,2.28,94
40230,Xavier,2,Private room,45,40,2.55,85
40231,Rebeca,4,Entire home/apt,42,6,3.02,48
40232,Eva,1,Entire home/apt,100,0,3.41,100
40233,Heather,2,Entire home/apt,99,4,2.0,103
40234,Grace,3,Private room,33,0,1.11,33
40235,Hayon,2,Private room,90,3,2.67,93
40236,Anchor,2,Shared room,35,86,1.89,121
40237,Tzivya,2,Entire home/apt,150,34,0.69,184
40238,Mariel,2,Entire home/apt,70,29,1.28,99
40240,Myrka,5,Entire home/apt,130,174,1.41,304
40243,Eleanor And Alex,2,Private room,45,25,5.35,70
40244,Felix,3,Entire home/apt,150,0,0.48,150
40245,Randy,4,Entire home/apt,75,359,8.11,434
40246,Janet,3,Entire home/apt,70,105,4.72,175
40248,Lucas,1,Private room,110,175,1.28,285
40249,Poma,1,Entire home/apt,216,89,1.0,305
40251,Jeannie,5,Private room,40,307,9.33,347
40252,Craig,2,Private room,60,189,0.22,249
40253,Sara,1,Private room,60,67,5.56,127
40255,Sally,3,Entire home/apt,75,325,2.14,400
40256,Brian,2,Entire home/apt,187,0,1.3,187
40257,Rachel,3,Private room,39,0,0.55,39
40258,Sergio,1,Private room,60,0,0.16,60
40259,Lilly,2,Entire home/apt,75,0,1.3,75
40261,Jason,2,Entire home/apt,33,19,4.75,52
40262,Brian,2,Private room,75,0,1.7,75
40263,Raphael,2,Private room,39,0,1.45,39
40264,Andrew,1,Entire home/apt,187,0,0.17,187
40266,Willie,1,Private room,85,224,2.42,309
40268,Vie,4,Private room,75,365,0.37,440
40269,Ameet,3,Private room,50,89,0.58,139
40270,Mordechai,1,Entire home/apt,150,7,2.9,157
40271,Thanh,1,Private room,72,15,7.13,87
40272,Khan,3,Private room,50,36,0.2,86
40273,Khan,3,Private room,59,37,0.57,96
40274,Lilian,1,Entire home/apt,125,270,1.3,395
40275,Sunshine,2,Entire home/apt,100,17,2.55,117
40276,Line,1,Entire home/apt,100,0,5.16,100
40277,Mark,1,Entire home/apt,160,205,3.04,365
40279,Andres,2,Private room,45,34,1.46,79
40280,Ethan,1,Private room,90,76,1.41,166
40281,Raphael,2,Private room,39,0,0.48,39
40283,Weston & Gabby,2,Entire home/apt,251,340,2.91,591
40284,Sandra,4,Entire home/apt,67,172,0.38,239
40286,Tina,3,Private room,147,85,1.01,232
40287,Lillian,1,Entire home/apt,115,19,1.6,134
40288,Raynita,2,Entire home/apt,130,189,1.65,319
40292,Christina,3,Private room,65,119,4.93,184
40293,Christina,3,Private room,55,100,4.63,155
40296,Yvonne,2,Private room,55,0,0.48,55
40297,Lakshmee,3,Private room,67,145,15.32,212
40298,Shearyl,3,Private room,50,24,5.14,74
40299,Lissette,5,Private room,35,299,2.02,334
40300,Dawn,1,Entire home/apt,104,0,0.42,104
40302,Inna,1,Entire home/apt,99,201,0.52,300
40303,Ali & SweetPea,2,Shared room,125,156,2.31,281
40305,Jennifer,2,Private room,110,98,3.26,208
40306,Raymond,2,Private room,30,0,0.17,30
40307,Oda,1,Private room,89,1,3.03,90
40308,Kemal,2,Private room,105,0,0.18,105
40310,Rodrigo,3,Entire home/apt,175,365,0.4,540
40312,Emmett,1,Entire home/apt,175,0,0.71,175
40313,Tanner,1,Entire home/apt,299,274,1.59,573
40314,Rojé,3,Private room,65,4,4.82,69
40315,Rem,4,Shared room,28,319,2.77,347
40316,Lakshmee,3,Shared room,39,34,9.13,73
40317,Carla,1,Entire home/apt,300,0,5.0,300
40318,Jany,3,Private room,80,125,1.54,205
40319,Eric,2,Private room,34,58,1.33,92
40320,Kendra,2,Private room,53,191,0.91,244
40321,Monique,3,Entire home/apt,80,87,2.36,167
40323,Olga,1,Private room,110,6,0.6,116
40325,Daniel,1,Private room,150,88,1.29,238
40326,Jannices,2,Private room,38,7,0.82,45
40327,Sharif,2,Entire home/apt,180,0,0.26,180
40328,Lee And Teri,2,Entire home/apt,125,84,2.78,209
40329,Kaylan,1,Entire home/apt,300,188,0.22,488
40330,John,2,Private room,75,0,0.2,75
40331,Andy & Kiera,1,Entire home/apt,450,312,2.21,762
40332,Rooshabh,1,Entire home/apt,110,238,4.0,348
40333,Esaú,1,Private room,33,0,0.17,33
40334,Jason & Becca,1,Entire home/apt,399,332,1.67,731
40335,Isidora,1,Private room,90,0,0.16,90
40336,Rikki,2,Entire home/apt,175,0,0.58,175
40337,Trevor,2,Entire home/apt,140,281,1.23,421
40338,Ines,2,Entire home/apt,190,59,0.88,249
40339,Maria,1,Entire home/apt,111,37,0.8,148
40340,Ofek,2,Private room,45,0,0.4,45
40341,Yao Yi,1,Private room,65,19,4.18,84
40342,Margaret,3,Private room,70,0,0.18,70
40344,Layla,3,Entire home/apt,69,212,3.93,281
40345,Elizabeth,2,Private room,70,0,0.17,70
40346,Kai,1,Private room,399,230,0.2,629
40348,Shay,1,Private room,90,168,0.53,258
40349,Karen,2,Entire home/apt,500,365,0.88,865
40350,Kaan,3,Entire home/apt,160,310,0.43,470
40352,Hudson River Hotel,1,Private room,209,81,3.13,290
40353,Elien,1,Entire home/apt,120,36,0.67,156
40354,Alana,1,Private room,99,0,0.19,99
40355,Nikol,2,Private room,80,168,0.21,248
40356,Hudson River Hotel,1,Private room,249,89,1.06,338
40357,Folami,1,Entire home/apt,120,84,1.69,204
40358,Alfredo,2,Entire home/apt,140,284,2.02,424
40359,Marko,1,Entire home/apt,110,5,0.51,115
40361,Mike,2,Entire home/apt,145,218,1.46,363
40362,Beverline,4,Private room,70,81,0.19,151
40364,Chad,1,Private room,60,1,2.35,61
40366,Christina,1,Entire home/apt,190,293,2.54,483
40367,Alimah,2,Private room,70,111,0.85,181
40369,David,1,Entire home/apt,115,5,1.55,120
40373,Michelle,2,Entire home/apt,135,26,1.8,161
40375,Gabriel,1,Private room,199,362,0.36,561
40377,Anna,2,Private room,80,86,1.0,166
40378,Arkadiy,1,Private room,140,0,1.7,140
40380,Marina,1,Entire home/apt,225,280,2.21,505
40381,Vanessa,2,Private room,45,0,0.18,45
40383,Sonya,3,Entire home/apt,175,147,4.45,322
40384,Mary,1,Private room,53,0,0.17,53
40385,Ioannis,3,Private room,44,47,2.98,91
40386,Nicholas,2,Private room,59,118,3.16,177
40387,Hana,1,Private room,65,0,1.79,65
40389,Maria,1,Private room,59,106,6.5,165
40391,Rena,2,Private room,70,26,2.82,96
40392,Lissette,2,Private room,59,109,4.4,168
40393,Jully,1,Entire home/apt,199,72,4.48,271
40394,Larissa,1,Private room,300,365,0.33,665
40395,Julian,1,Private room,61,0,0.37,61
40396,Michael,1,Private room,90,324,2.55,414
40397,Jasmine,2,Private room,60,0,0.3,60
40398,Taisiya,1,Entire home/apt,179,3,0.18,182
40399,Alexa,1,Entire home/apt,199,110,2.83,309
40400,Letisha,1,Private room,150,20,1.9,170
40401,Peter,2,Private room,85,314,2.39,399
40402,Donna,4,Entire home/apt,80,91,2.26,171
40404,Deva,2,Private room,100,0,1.05,100
40405,Kazuya,3,Private room,35,252,0.58,287
40406,Earl,4,Entire home/apt,74,183,3.85,257
40408,Michael,1,Private room,100,184,5.45,284
40409,Despina,3,Entire home/apt,114,359,3.23,473
40410,Arkadiy,1,Private room,140,0,0.74,140
40411,Makis,1,Private room,77,106,5.14,183
40412,Pirin,1,Entire home/apt,1299,273,2.62,1572
40413,Lisa,2,Entire home/apt,170,304,2.54,474
40414,Jean,1,Private room,175,105,0.81,280
40415,Erica,1,Entire home/apt,156,46,3.71,202
40418,Jay,2,Private room,45,170,2.31,215
40420,Milton,1,Entire home/apt,110,197,2.6,307
40421,Kai,1,Private room,114,50,2.23,164
40423,DuChess,3,Private room,35,354,2.79,389
40424,Lakshmee,3,Shared room,39,320,10.6,359
40425,Bridgette,2,Private room,65,178,1.5,243
40427,Kai,1,Private room,116,42,2.9,158
40428,Kai,1,Private room,101,62,1.89,163
40429,Renee,3,Entire home/apt,200,139,4.5,339
40430,Gordon,1,Private room,85,0,1.48,85
40431,Abdes,2,Private room,70,0,0.5,70
40432,Dolores,2,Entire home/apt,172,281,1.61,453
40435,Tamara,1,Private room,65,0,0.64,65
40436,Nir,1,Entire home/apt,115,50,0.21,165
40439,LKL Rental,3,Private room,25,231,2.79,256
40441,LKL Rental,3,Shared room,19,236,2.78,255
40443,Agustina,1,Entire home/apt,495,52,0.33,547
40444,Agustina,1,Entire home/apt,525,63,1.76,588
40445,Mike,1,Entire home/apt,395,363,0.37,758
40446,Anna,2,Entire home/apt,82,75,3.21,157
40447,Rob,2,Private room,100,100,0.53,200
40448,Caleb,1,Entire home/apt,70,0,1.84,70
40449,Misael,2,Entire home/apt,100,342,1.43,442
40450,Wei,3,Private room,35,11,1.99,46
40454,Kelly,2,Entire home/apt,175,0,1.45,175
40455,Irena,3,Entire home/apt,130,162,4.22,292
40456,Courtney,2,Private room,55,0,3.6,55
40458,Anthony,2,Entire home/apt,100,66,2.46,166
40460,Natti,1,Entire home/apt,105,83,1.14,188
40461,Celeste,2,Private room,90,0,2.77,90
40462,Isaac & Irene,2,Private room,60,29,3.46,89
40463,Evelyn,2,Entire home/apt,300,92,3.75,392
40465,Takuya,1,Private room,70,0,0.54,70
40466,Sam,1,Entire home/apt,229,362,0.53,591
40470,Ronnie,2,Private room,60,86,0.49,146
40471,Ravita,2,Private room,125,180,0.42,305
40473,Eddie,1,Private room,109,35,3.89,144
40474,Sagar,1,Entire home/apt,400,0,0.21,400
40475,Michael,2,Private room,45,0,1.35,45
40476,Sonder (NYC),1,Entire home/apt,197,334,0.51,531
40477,Kristina,2,Entire home/apt,85,6,0.85,91
40478,Talia,2,Entire home/apt,120,0,0.66,120
40479,Luz,3,Entire home/apt,170,97,2.07,267
40481,Luis,3,Private room,55,81,2.05,136
40482,Sherra,3,Entire home/apt,125,344,1.65,469
40483,Elen,3,Entire home/apt,100,121,7.12,221
40484,Pamela,1,Entire home/apt,180,173,2.0,353
40487,April & Tom,3,Entire home/apt,99,0,3.75,99
40488,Julianna,1,Entire home/apt,145,169,5.28,314
40489,Andy,4,Entire home/apt,247,322,3.17,569
40490,Janette,2,Private room,120,80,2.79,200
40491,Christopher,1,Private room,70,65,1.0,135
40492,Alan,2,Entire home/apt,80,154,3.71,234
40493,Maria Bonde,1,Entire home/apt,200,0,0.18,200
40494,Joe,1,Private room,150,280,1.73,430
40495,Inbal,1,Entire home/apt,599,140,2.23,739
40496,Titus,1,Entire home/apt,188,253,1.18,441
40497,Kav,1,Private room,110,13,2.23,123
40498,Jillian,2,Private room,99,149,2.63,248
40500,New York Italians,2,Private room,70,8,1.57,78
40501,Munyaradzi,1,Private room,75,0,2.95,75
40502,Yerriz,4,Private room,30,176,3.28,206
40504,Anne,1,Entire home/apt,225,268,3.63,493
40506,Hana,1,Entire home/apt,130,0,0.64,130
40508,LKL Rental,3,Private room,28,236,3.03,264
40510,Jessy & Christian,3,Private room,40,306,1.15,346
40513,Cecily,1,Entire home/apt,88,5,3.88,93
40514,Douglas,1,Private room,86,310,0.42,396
40515,Lucy,3,Private room,55,7,2.92,62
40517,Dennis,2,Entire home/apt,125,188,1.37,313
40518,Peter,2,Entire home/apt,200,49,2.0,249
40519,Evan,1,Entire home/apt,80,189,0.37,269
40521,Charles,1,Private room,80,6,3.45,86
40522,Liv,1,Entire home/apt,99,81,4.23,180
40524,Max,1,Private room,100,254,0.75,354
40525,Walter,2,Entire home/apt,85,210,6.1,295
40526,Kin,2,Private room,49,177,1.59,226
40527,Dave,1,Private room,69,60,0.78,129
40528,Armin,2,Private room,40,0,0.28,40
40529,Susan,1,Entire home/apt,175,274,0.63,449
40530,Dave,1,Private room,65,69,0.7,134
40531,Farah,5,Private room,85,296,5.0,381
40532,Amit & Sofie,1,Entire home/apt,140,0,0.35,140
40533,Yoko,2,Private room,75,113,4.86,188
40534,Scott,1,Entire home/apt,350,0,4.26,350
40535,Christopher,1,Entire home/apt,150,0,1.57,150
40536,Liberty,1,Private room,50,36,5.93,86
40537,Jessica,4,Private room,80,156,0.18,236
40538,Jennie And Dan,2,Entire home/apt,133,41,1.24,174
40540,Bee,1,Private room,50,0,5.0,50
40541,Lyric At 70 Pine,1,Entire home/apt,219,322,3.85,541
40542,Brennan,1,Private room,60,80,1.41,140
40545,Steven,1,Entire home/apt,235,8,4.75,243
40546,Jennyfer,1,Private room,40,81,0.24,121
40547,Cindy,2,Entire home/apt,100,268,0.43,368
40548,Benjamin,2,Entire home/apt,92,95,0.66,187
40549,Manuel,1,Private room,45,78,2.32,123
40550,Henry,2,Private room,50,365,1.76,415
40552,Ella,1,Private room,42,131,1.39,173
40554,Rebecca,1,Entire home/apt,150,19,3.31,169
40555,Chloé,2,Private room,35,7,0.43,42
40558,D,1,Private room,289,72,3.42,361
40560,Khalid,3,Private room,55,34,5.03,89
40561,Gemma,1,Entire home/apt,250,110,1.94,360
40562,Zoe,3,Private room,56,4,2.84,60
40563,Julia,2,Entire home/apt,120,0,3.0,120
40564,Ali,3,Entire home/apt,149,30,3.0,179
40567,Tomi,2,Entire home/apt,80,0,2.12,80
40568,Mo,2,Private room,59,53,0.42,112
40569,Mohammed,2,Entire home/apt,65,293,3.57,358
40570,Kendra,2,Private room,39,67,0.73,106
40571,Steph,1,Entire home/apt,140,0,0.63,140
40574,Carlos & Lina,3,Private room,55,360,1.81,415
40575,Jamie,2,Private room,40,1,0.92,41
40576,Alex,1,Entire home/apt,115,0,2.02,115
40577,Tenlie,1,Entire home/apt,400,148,2.88,548
40578,Ori,1,Private room,35,80,4.36,115
40579,Federico,2,Private room,40,51,2.95,91
40580,Milton,1,Entire home/apt,110,227,4.69,337
40581,Natalie,2,Private room,35,0,0.22,35
40583,Khaled,2,Private room,130,356,1.18,486
40584,Smofie,1,Entire home/apt,299,38,0.56,337
40589,Ann,2,Entire home/apt,130,292,2.09,422
40590,Tussan,3,Entire home/apt,128,80,0.83,208
40591,James,2,Private room,45,0,0.39,45
40592,Phil,2,Entire home/apt,89,237,3.03,326
40593,Joanne,2,Private room,39,0,0.22,39
40595,Kin,2,Private room,49,164,1.67,213
40596,Kin,2,Private room,49,155,1.48,204
40598,Hillary,2,Entire home/apt,61,0,2.76,61
40599,Max,1,Private room,70,97,6.05,167
40601,Lindsey,3,Private room,40,17,2.41,57
40602,Daniel,2,Private room,50,5,2.46,55
40603,Aaron,2,Entire home/apt,175,227,4.06,402
40604,Maku,2,Private room,50,12,0.42,62
40606,Bri,2,Entire home/apt,95,22,3.71,117
40607,Robert,2,Entire home/apt,80,5,3.84,85
40608,Anna,3,Entire home/apt,90,121,6.75,211
40609,Maria,1,Entire home/apt,250,148,3.64,398
40610,Tyler,2,Private room,40,0,1.03,40
40611,Natasha,1,Private room,80,0,1.4,80
40612,Viktor,2,Entire home/apt,80,0,0.17,80
40614,Liz,2,Private room,150,0,0.18,150
40615,Emma,1,Private room,75,21,2.66,96
40617,Michael,1,Private room,89,221,6.65,310
40618,Joy,3,Entire home/apt,99,141,3.16,240
40619,Michael,1,Private room,99,142,6.44,241
40621,Martin,1,Entire home/apt,170,169,1.71,339
40622,Michael,1,Shared room,50,238,6.48,288
40623,Julianna,1,Private room,82,96,3.84,178
40624,Eddie&Vlad,1,Entire home/apt,299,342,1.36,641
40625,Lucy,3,Entire home/apt,121,90,2.28,211
40626,Julianna,1,Private room,75,351,4.09,426
40627,Sam,1,Entire home/apt,199,123,3.7,322
40629,Pacita,2,Entire home/apt,79,94,0.77,173
40630,Hannah,2,Private room,60,153,0.45,213
40631,Lethy,1,Private room,45,87,2.45,132
40632,Toni,2,Private room,125,199,1.02,324
40633,Raquel,1,Entire home/apt,199,124,0.38,323
40634,Polina,2,Private room,48,53,2.0,101
40635,Ky-Tsuyo,1,Private room,40,8,1.97,48
40636,Steve,4,Private room,85,343,0.85,428
40637,Anna,2,Private room,45,160,6.3,205
40639,Emily Wes,2,Private room,68,311,1.0,379
40640,Kazuya,3,Private room,41,186,0.25,227
40642,Eddie&Vlad,1,Private room,77,351,3.36,428
40643,Yogi,3,Entire home/apt,72,52,1.2,124
40644,Eddie&Vlad,1,Private room,79,60,0.26,139
40645,P,1,Private room,120,0,0.52,120
40646,P,1,Private room,100,0,0.34,100
40647,Zahavah Cara,2,Entire home/apt,106,0,0.74,106
40648,Carmel,1,Private room,110,3,1.71,113
40649,Mery,1,Entire home/apt,135,214,0.2,349
40650,Samantha,1,Entire home/apt,90,0,1.98,90
40652,Clara,3,Private room,47,350,3.63,397
40654,Mona,2,Entire home/apt,130,16,1.98,146
40655,Valerie,2,Entire home/apt,100,0,1.74,100
40656,Jeannette,1,Private room,180,0,2.6,180
40657,Pamela,2,Private room,55,156,5.1,211
40658,Yvonne,3,Entire home/apt,60,282,5.45,342
40659,Jérôme,1,Entire home/apt,350,342,7.89,692
40660,Yaron,1,Entire home/apt,130,2,0.29,132
40661,Duaa,2,Private room,65,157,2.87,222
40662,Rose-Camille,2,Private room,90,144,2.84,234
40663,Allan,2,Entire home/apt,120,0,2.13,120
40664,Valerie,1,Private room,70,152,2.13,222
40665,Verna,1,Entire home/apt,135,7,0.88,142
40666,Alex,4,Private room,95,49,0.96,144
40669,Aleks,2,Private room,50,330,0.78,380
40671,Shola,2,Private room,70,21,0.73,91
40672,Mintra,1,Private room,60,35,0.43,95
40675,Briana,3,Entire home/apt,97,52,2.0,149
40676,Sarah,2,Entire home/apt,155,42,2.11,197
40677,Hitalo,2,Private room,58,158,1.56,216
40678,Sy,1,Entire home/apt,70,191,1.78,261
40679,Samuel,5,Private room,57,365,3.56,422
40680,Daniel,2,Entire home/apt,129,93,5.22,222
40681,Kai,1,Private room,109,0,0.44,109
40682,Yan,1,Entire home/apt,128,233,1.88,361
40683,Pamilitta,2,Private room,80,4,1.95,84
40685,Gabriella,1,Entire home/apt,85,16,1.08,101
40686,Khalid,3,Private room,55,1,5.37,56
40687,John,2,Private room,69,95,0.29,164
40690,Brittney,2,Entire home/apt,120,0,1.41,120
40692,Joseph,2,Entire home/apt,120,0,0.23,120
40696,Tina,3,Private room,65,68,2.38,133
40698,Yesenia,2,Entire home/apt,140,48,2.07,188
40699,Matt,1,Entire home/apt,85,8,0.72,93
40700,Janu,1,Entire home/apt,87,49,0.95,136
40701,Only One,1,Entire home/apt,205,124,2.0,329
40702,Mike,2,Entire home/apt,145,224,1.64,369
40704,Bobi,1,Private room,72,365,0.45,437
40705,Ana,2,Entire home/apt,149,194,4.8,343
40706,Lutz,2,Entire home/apt,95,0,1.79,95
40709,Earlene,2,Entire home/apt,80,81,4.67,161
40710,Anna,1,Private room,80,331,0.9,411
40711,Moying,1,Entire home/apt,190,232,8.47,422
40712,Linda,1,Entire home/apt,200,0,1.86,200
40713,Yulia And Amine,4,Private room,50,32,4.35,82
40714,Johanna,4,Entire home/apt,99,107,1.94,206
40715,Gabriel,1,Private room,199,362,0.99,561
40717,Gabriel,1,Private room,129,363,0.41,492
40718,Brigitte,1,Entire home/apt,300,40,0.45,340
40719,Gabriel,1,Private room,199,360,0.89,559
40720,Brigitte,1,Private room,110,72,1.4,182
40721,David & Orli,3,Entire home/apt,175,172,1.96,347
40722,Emily,4,Entire home/apt,200,32,1.0,232
40723,Alix,3,Private room,60,150,1.29,210
40724,Jos,2,Entire home/apt,250,0,0.37,250
40725,Vivi,3,Private room,99,336,0.78,435
40726,Alimah,2,Entire home/apt,130,64,1.39,194
40727,Sebastian,2,Entire home/apt,120,107,3.5,227
40729,Fred,2,Entire home/apt,115,93,2.0,208
40731,Jackie,2,Private room,80,89,0.3,169
40732,Anna,1,Private room,80,219,0.55,299
40733,Kam,2,Entire home/apt,45,248,2.98,293
40734,Ashley,1,Entire home/apt,1295,289,0.48,1584
40736,Jaime,2,Private room,29,244,1.2,273
40737,Luc And Deb,2,Entire home/apt,95,0,0.56,95
40738,Lindsey,3,Private room,40,0,1.61,40
40739,Julianna,1,Private room,75,192,3.8,267
40740,Alice,1,Entire home/apt,200,6,0.85,206
40741,Michelle,1,Private room,105,119,1.15,224
40743,Vika & Josh,2,Entire home/apt,130,110,1.47,240
40744,Vika & Josh,2,Private room,60,110,0.89,170
40745,Vika & Josh,2,Private room,50,125,1.15,175
40746,Anna,1,Entire home/apt,135,217,1.0,352
40747,Syed,2,Entire home/apt,120,209,0.53,329
40748,Cinthya,2,Entire home/apt,136,74,3.46,210
40749,Jitabella,1,Private room,50,0,0.53,50
40751,David,1,Entire home/apt,175,233,3.72,408
40752,Lucy,1,Entire home/apt,85,0,1.24,85
40754,Nicola,3,Private room,80,365,1.05,445
40755,Raphaëlle,2,Private room,85,0,0.43,85
40756,Lena,1,Entire home/apt,255,239,2.32,494
40757,Ryan,1,Entire home/apt,250,0,2.34,250
40759,Mj,1,Entire home/apt,119,302,3.18,421
40763,Jacob,2,Private room,68,59,0.52,127
40764,Michael,1,Entire home/apt,1200,27,0.19,1227
40765,Katya,1,Private room,119,0,0.21,119
40766,Yaacov,1,Entire home/apt,250,365,0.25,615
40767,Andre,2,Private room,49,96,0.31,145
40768,Thomas,1,Private room,99,21,2.11,120
40769,Esteban,1,Entire home/apt,200,88,0.85,288
40771,Daniel,2,Entire home/apt,140,135,5.56,275
40773,J Danny,1,Private room,220,21,2.73,241
40774,Lloyd,2,Entire home/apt,145,244,1.43,389
40775,Aleks,2,Entire home/apt,200,330,3.93,530
40776,Kim,2,Entire home/apt,175,5,0.53,180
40777,Harris,2,Private room,45,0,0.76,45
40778,Rina,1,Entire home/apt,120,0,0.28,120
40779,Eva,3,Entire home/apt,125,0,0.58,125
40780,Cassi,2,Entire home/apt,150,2,0.21,152
40782,Jake,1,Entire home/apt,167,91,2.75,258
40783,Valentin,2,Entire home/apt,220,76,4.0,296
40784,Benjamin,1,Entire home/apt,250,0,1.26,250
40786,Adam,1,Entire home/apt,107,170,0.47,277
40787,Walter,3,Private room,54,56,1.0,110
40789,Neal,2,Private room,35,36,0.41,71
40790,Cho Cheong,2,Entire home/apt,45,28,0.23,73
40791,Jacob,3,Entire home/apt,200,179,1.0,379
40792,Lo,2,Entire home/apt,200,96,3.59,296
40793,Akram,2,Entire home/apt,165,273,3.05,438
40794,Ulysses,1,Private room,85,24,5.0,109
40795,Madison,2,Private room,57,3,1.0,60
40797,Stephen,1,Entire home/apt,150,7,0.71,157
40798,Janet,2,Private room,75,0,0.74,75
40799,I Do Not Live Here,1,Entire home/apt,220,0,1.21,220
40800,Marcela,3,Private room,50,125,2.13,175
40801,Alex,2,Private room,50,0,0.93,50
40802,Tess,1,Entire home/apt,175,18,0.85,193
40803,Maurizio,3,Private room,70,135,1.32,205
40804,Stella,2,Entire home/apt,90,0,1.75,90
40805,Mishka,2,Entire home/apt,56,0,0.36,56
40806,Anne,2,Private room,65,7,4.78,72
40807,Melanie,1,Private room,100,7,4.29,107
40808,Antony,2,Shared room,20,0,1.01,20
40810,Kim,2,Entire home/apt,200,22,1.38,222
40812,Mikala,1,Entire home/apt,97,11,3.38,108
40813,Sadhya,3,Private room,45,53,2.57,98
40814,Joseph & Teresa,2,Entire home/apt,85,161,7.87,246
40815,Se 小瑟,3,Private room,40,205,2.52,245
40816,Erika,1,Private room,50,2,3.6,52
40817,Amy,1,Private room,100,125,1.58,225
40818,Erica And Jose,3,Private room,50,63,3.78,113
40819,Veronica,1,Entire home/apt,299,61,3.22,360
40820,Sandra,2,Entire home/apt,285,2,1.86,287
40821,Gabriela,3,Entire home/apt,170,41,0.58,211
40822,Raizy,2,Entire home/apt,100,35,2.03,135
40823,Tiphanie,2,Entire home/apt,60,30,9.64,90
40824,Shola,2,Private room,70,21,1.13,91
40825,Susan,3,Entire home/apt,140,204,1.64,344
40826,Reggie,1,Entire home/apt,215,5,1.03,220
40827,Sam,3,Entire home/apt,52,0,0.19,52
40828,Sandeep,3,Private room,85,80,4.92,165
40829,Max,1,Entire home/apt,250,112,2.7,362
40830,Kam,3,Entire home/apt,135,0,3.57,135
40831,J Danny,1,Entire home/apt,230,29,0.51,259
40832,Marta,1,Private room,54,38,3.31,92
40833,Leonardo,3,Entire home/apt,70,3,2.29,73
40835,Lilia,5,Private room,75,90,1.78,165
40836,Regina,1,Private room,80,334,2.47,414
40840,Mario & Maria,3,Private room,59,0,0.19,59
40841,Kathiana Joy,1,Entire home/apt,80,0,0.63,80
40842,Maria,1,Entire home/apt,325,217,6.11,542
40843,Jill Laurie,1,Private room,80,188,0.65,268
40844,Dwayne,3,Entire home/apt,69,170,6.46,239
40846,Boomer,2,Entire home/apt,120,0,0.42,120
40847,George,1,Entire home/apt,120,116,2.0,236
40848,Luca,2,Private room,45,0,0.22,45
40849,Gabrielle,2,Entire home/apt,85,28,4.78,113
40850,Selvete,2,Entire home/apt,59,87,0.73,146
40851,Jai,1,Entire home/apt,100,8,1.1,108
40853,Jenni,2,Entire home/apt,375,7,0.41,382
40854,Leticia,2,Private room,45,0,0.19,45
40855,Svetlana And Jimmy,1,Entire home/apt,117,0,1.22,117
40856,Julia,2,Private room,48,189,3.72,237
40857,Julia,2,Private room,48,166,1.98,214
40858,Julia,2,Private room,53,158,2.61,211
40859,Carol,4,Private room,99,0,0.25,99
40860,Julia,2,Private room,48,166,0.73,214
40862,Gasminee,3,Private room,44,32,8.03,76
40863,Sergii,1,Private room,55,353,0.23,408
40864,Karen,1,Private room,85,92,3.62,177
40865,Idelsa,4,Entire home/apt,115,228,3.41,343
40866,Cindy,2,Private room,45,129,1.72,174
40867,DeShawn,3,Entire home/apt,75,0,0.41,75
40868,Mark,3,Entire home/apt,99,319,1.62,418
40869,Patrick,2,Private room,80,0,0.63,80
40870,Bret,1,Entire home/apt,209,107,2.2,316
40872,Charlie And Selena,2,Private room,65,344,2.81,409
40873,Charlie And Selena,2,Private room,65,321,3.84,386
40875,Anna,1,Private room,80,342,0.25,422
40877,Maite,1,Private room,75,0,0.41,75
40879,Sivan,1,Entire home/apt,130,15,3.04,145
40881,Moshe,2,Entire home/apt,160,237,4.49,397
40882,Scott,1,Entire home/apt,115,4,0.24,119
40883,Kel,2,Entire home/apt,123,147,1.06,270
40885,Analia,2,Entire home/apt,280,250,3.21,530
40886,Natalia,1,Entire home/apt,700,127,2.56,827
40887,Analia,2,Private room,70,0,6.92,70
40888,Paul,1,Entire home/apt,129,109,4.16,238
40889,Denise,2,Private room,37,341,9.56,378
40890,Marcel,1,Private room,150,149,0.75,299
40891,Marcel,1,Private room,150,152,0.56,302
40892,Kenya,1,Private room,54,129,2.83,183
40895,Isabella,2,Entire home/apt,79,0,0.86,79
40896,Cem,1,Entire home/apt,200,79,3.05,279
40897,George,2,Entire home/apt,250,295,3.63,545
40898,Ernie,2,Private room,59,0,0.21,59
40899,Evan,1,Entire home/apt,132,0,0.73,132
40901,Brian,2,Private room,70,0,1.97,70
40903,César A.,3,Private room,40,153,0.32,193
40904,Jessica,1,Entire home/apt,250,271,4.34,521
40906,Antony,2,Private room,35,0,0.21,35
40907,Sergii,1,Private room,59,332,0.26,391
40909,Sergii,1,Private room,59,333,0.5,392
40915,Nicole And Joe,2,Private room,225,178,0.48,403
40917,Karina,2,Private room,65,22,8.5,87
40918,Michelle,2,Entire home/apt,126,6,4.51,132
40919,Manon,2,Private room,63,44,0.74,107
40920,Stephany,2,Entire home/apt,165,81,2.67,246
40921,Abdes,2,Private room,65,0,0.55,65
40922,Owen,1,Private room,50,7,0.74,57
40923,Tatiana & Tyson,1,Entire home/apt,110,3,0.59,113
40924,Shogo,3,Private room,40,1,0.26,41
40925,Shmuel Z,1,Entire home/apt,495,156,3.31,651
40926,Linus,1,Entire home/apt,200,34,1.95,234
40927,Sharon,2,Entire home/apt,130,337,10.36,467
40928,Shogo,3,Private room,40,44,0.23,84
40930,Hana,1,Entire home/apt,218,0,1.49,218
40931,Hana,1,Private room,65,0,2.98,65
40934,Hiroki,3,Private room,32,31,0.3,63
40935,Joana,2,Private room,80,179,1.41,259
40937,Abigail,2,Entire home/apt,107,0,0.23,107
40938,Kellie,2,Private room,46,16,3.33,62
40939,Ginger,2,Entire home/apt,175,14,0.99,189
40940,Cherokee,3,Entire home/apt,159,78,1.0,237
40942,Damir&Sanela,3,Entire home/apt,115,85,5.81,200
40943,Anthony,1,Private room,75,199,4.8,274
40944,Jessi,1,Private room,50,5,1.1,55
40945,Steve,1,Private room,149,336,1.7,485
40948,Roy,3,Entire home/apt,175,345,2.88,520
40949,Carolyn,3,Private room,65,5,4.77,70
40950,Sam,1,Private room,90,8,1.06,98
40952,Hamilton,1,Entire home/apt,145,310,3.66,455
40953,Daniel,1,Entire home/apt,150,249,0.43,399
40954,Erica And Jose,3,Private room,50,127,3.6,177
40955,David,1,Private room,87,46,2.02,133
40956,Victor,4,Private room,65,110,1.28,175
40957,Michelle,2,Private room,30,6,0.81,36
40958,Hamilton,1,Entire home/apt,145,265,3.09,410
40959,Bonnie,1,Entire home/apt,225,50,5.64,275
40960,Stephen,1,Shared room,100,90,0.21,190
40961,Jane,3,Private room,42,121,3.36,163
40962,Eva,2,Entire home/apt,75,94,0.21,169
40963,Marla,1,Entire home/apt,90,89,2.31,179
40965,Izi,1,Entire home/apt,140,276,0.37,416
40966,Eyal,1,Private room,60,337,1.46,397
40967,Eyal,1,Private room,60,333,1.0,393
40968,Dustin,1,Private room,73,332,0.43,405
40972,Emily,2,Private room,48,0,0.2,48
40975,Eyal,1,Private room,60,342,1.0,402
40976,Eyal,1,Private room,60,346,1.0,406
40977,Eyal,1,Private room,60,325,0.83,385
40980,Eyal,1,Private room,60,341,1.0,401
40981,Eyal,1,Private room,60,365,1.0,425
40985,Michael,2,Entire home/apt,100,258,0.9,358
40987,Michelle,1,Entire home/apt,120,0,0.77,120
40988,Janet,2,Private room,115,345,5.33,460
40989,Ofrit,2,Entire home/apt,200,269,3.33,469
40990,Claudia,2,Entire home/apt,110,250,9.93,360
40991,Victor,4,Private room,65,77,1.18,142
40992,Gui,2,Private room,57,146,3.31,203
40993,Michael,2,Entire home/apt,175,0,0.2,175
40994,Gui,2,Private room,44,118,4.94,162
40996,Gui,2,Private room,44,162,2.58,206
40998,Timothy,2,Entire home/apt,99,182,3.98,281
40999,Antoaneta,3,Entire home/apt,250,137,2.81,387
41000,Thomas,1,Private room,99,19,0.6,118
41001,Thomas,1,Private room,99,31,0.21,130
41003,Bismillah,2,Entire home/apt,86,284,3.54,370
41004,Satoh,1,Entire home/apt,519,165,1.86,684
41006,Chandtisse,2,Private room,65,156,4.23,221
41007,Shogo,3,Private room,37,0,0.6,37
41008,Aleksei,1,Private room,65,8,2.79,73
41009,Zebin,3,Private room,40,30,3.44,70
41011,Kim,3,Private room,65,319,0.75,384
41013,George,2,Private room,40,6,3.8,46
41014,Charlie And Selena,2,Private room,65,345,2.24,410
41017,Bethany,2,Entire home/apt,120,214,3.75,334
41018,Brent,2,Entire home/apt,110,0,0.53,110
41019,David,1,Entire home/apt,142,214,1.17,356
41021,Walter,2,Entire home/apt,159,259,3.03,418
41022,Stephanie,4,Private room,40,0,2.06,40
41024,Joe,2,Private room,49,0,0.21,49
41025,Colin,2,Private room,49,0,2.8,49
41026,Tyqua,1,Private room,75,364,2.81,439
41027,Alexis,2,Private room,38,0,0.2,38
41028,Edwin’S Place,5,Entire home/apt,75,229,4.38,304
41029,Edwin’S Place,5,Entire home/apt,100,259,2.09,359
41030,Fabrice,2,Private room,70,325,0.64,395
41032,William,2,Private room,50,0,0.54,50
41035,Jules,2,Entire home/apt,190,187,1.05,377
41036,Christine,1,Private room,119,26,1.15,145
41037,Ken,2,Private room,110,82,1.61,192
41039,Diego,2,Entire home/apt,68,0,3.82,68
41040,Lívia,2,Private room,95,200,1.28,295
41041,Esteban,1,Entire home/apt,113,96,3.85,209
41042,Cherry,3,Entire home/apt,45,49,9.39,94
41043,Ashley,1,Entire home/apt,699,333,0.39,1032
41044,Bobby And Ruth,2,Entire home/apt,200,300,3.69,500
41045,Dana,1,Entire home/apt,799,346,1.73,1145
41046,FabioeMarco,1,Private room,42,1,2.0,43
41047,Monica,2,Private room,95,59,0.93,154
41048,Az,3,Entire home/apt,275,280,7.5,555
41049,Saya,2,Private room,85,11,3.27,96
41051,Alicia,1,Private room,60,254,1.32,314
41052,Cassandra,1,Private room,90,0,0.28,90
41053,Vicente,1,Entire home/apt,250,125,7.64,375
41054,A,2,Private room,75,0,2.54,75
41055,Jean-Yves,2,Entire home/apt,450,43,1.06,493
41056,Christian,1,Entire home/apt,225,83,3.22,308
41057,Rebekah,2,Private room,30,0,0.62,30
41059,Jc,1,Private room,80,183,5.73,263
41062,Lee,1,Entire home/apt,175,8,0.27,183
41065,Sammy,2,Entire home/apt,99,20,3.78,119
41066,Antony,2,Shared room,20,0,0.56,20
41067,Ray,2,Entire home/apt,135,9,6.31,144
41068,Drew,1,Private room,120,10,0.7,130
41069,Shully'S,4,Entire home/apt,289,356,2.96,645
41070,Farouk,1,Private room,60,199,2.16,259
41071,Maudry-Beverley,2,Entire home/apt,160,289,4.71,449
41072,Daniel,2,Entire home/apt,149,231,4.52,380
41073,Joy,3,Entire home/apt,99,143,4.01,242
41074,Demi,1,Entire home/apt,100,0,2.13,100
41075,Marcelo,2,Private room,75,52,3.06,127
41077,George,2,Entire home/apt,199,61,3.73,260
41078,Raphael,1,Private room,70,193,6.08,263
41081,Alex,2,Private room,75,25,4.29,100
41082,Jordy,2,Entire home/apt,120,14,0.85,134
41084,Gul,2,Private room,60,77,0.9,137
41085,Ifrat,2,Private room,75,5,1.4,80
41086,Jeff,1,Entire home/apt,276,277,2.42,553
41087,Zoey,1,Entire home/apt,130,20,1.32,150
41088,Lexx,4,Private room,50,206,2.96,256
41091,Vanessa,1,Entire home/apt,260,173,1.31,433
41092,Artur,2,Entire home/apt,128,27,2.5,155
41093,Joshua,1,Private room,75,22,1.0,97
41094,Beverly,1,Private room,60,71,1.0,131
41095,Daniel,2,Private room,70,75,2.53,145
41097,Wendy,5,Entire home/apt,100,151,9.1,251
41098,Meg,2,Private room,36,0,0.46,36
41099,Candia,3,Entire home/apt,99,246,3.41,345
41100,Tonya,1,Private room,355,312,1.13,667
41102,Shiya,2,Private room,35,0,1.4,35
41103,Ferhat,1,Entire home/apt,211,30,4.47,241
41105,Mauricio,1,Private room,55,44,2.29,99
41106,L,2,Entire home/apt,62,351,3.11,413
41107,Rachael Lee,2,Private room,37,0,0.21,37
41109,Asia,2,Private room,60,116,3.78,176
41110,Sonia,2,Private room,75,33,0.42,108
41111,Bibiane,2,Entire home/apt,110,34,5.04,144
41112,Elizabeth,1,Shared room,60,39,3.59,99
41113,Robert,2,Entire home/apt,225,78,2.14,303
41114,Miles And Ruth,2,Entire home/apt,100,0,0.61,100
41115,Samantha,3,Entire home/apt,200,124,1.12,324
41116,Ariel,1,Private room,60,188,0.67,248
41118,Mirjam,2,Private room,61,0,1.48,61
41119,Angela,1,Entire home/apt,375,208,1.24,583
41120,Drew,2,Entire home/apt,200,218,4.23,418
41121,Seble,2,Entire home/apt,120,13,3.28,133
41122,Anna,3,Entire home/apt,144,18,5.33,162
41123,Brett,1,Entire home/apt,175,0,1.33,175
41124,Kate,2,Private room,50,0,1.06,50
41126,Jor,1,Entire home/apt,250,60,1.0,310
41127,Benjamin,1,Entire home/apt,180,22,0.57,202
41128,Rob,1,Entire home/apt,250,0,0.36,250
41130,Eyal,1,Private room,60,317,1.0,377
41132,Lyric At 70 Pine,1,Entire home/apt,309,314,0.59,623
41134,Lisa,2,Private room,55,0,0.58,55
41135,Lisa,2,Private room,45,0,0.39,45
41136,John,3,Entire home/apt,115,6,0.84,121
41138,Jason,1,Entire home/apt,199,179,1.13,378
41139,Diane,3,Entire home/apt,50,0,0.19,50
41140,Dev,2,Entire home/apt,121,0,0.2,121
41141,Xenia,2,Private room,45,34,0.91,79
41144,Amanda,2,Private room,75,201,4.62,276
41145,Sean,2,Entire home/apt,150,86,2.26,236
41147,Herman,2,Entire home/apt,165,61,3.78,226
41151,Dorina,3,Entire home/apt,115,314,0.44,429
41155,Patricia,3,Private room,50,167,4.69,217
41157,Guy,2,Private room,80,363,1.14,443
41159,Matthew,2,Entire home/apt,90,53,3.88,143
41161,George,3,Private room,80,29,7.6,109
41163,George,3,Private room,55,28,7.5,83
41164,Feather Factory Hotel,3,Private room,100,351,1.06,451
41165,Max,1,Entire home/apt,345,154,1.13,499
41166,Evan,1,Private room,169,0,0.67,169
41167,Kimberly,1,Entire home/apt,35,5,6.56,40
41168,Christina,3,Private room,65,149,2.55,214
41169,Jas,3,Private room,80,358,1.29,438
41171,Bret,1,Private room,60,0,0.21,60
41172,Brandon,1,Entire home/apt,120,328,1.89,448
41174,Olivia,2,Entire home/apt,100,149,2.59,249
41175,Daniel & Kenzie,1,Entire home/apt,450,325,2.67,775
41176,Oleg,3,Private room,33,0,0.4,33
41177,Valentina,1,Private room,55,30,3.31,85
41178,Amanda,1,Private room,80,3,0.48,83
41180,R R,2,Entire home/apt,160,252,3.1,412
41182,Modesta,3,Private room,25,41,9.23,66
41184,Garry,1,Entire home/apt,450,154,0.58,604
41185,Dave,2,Entire home/apt,80,0,0.42,80
41187,Chris,2,Private room,40,0,0.2,40
41188,Yesenia,2,Private room,40,0,0.64,40
41189,Estefania,1,Private room,150,0,1.05,150
41190,Chen,1,Private room,53,1,5.03,54
41191,Lisa,2,Private room,90,83,2.92,173
41192,Okhela,3,Entire home/apt,30,230,2.32,260
41193,Terrence & Skye,1,Private room,62,72,0.47,134
41194,Gasminee,3,Private room,45,30,7.79,75
41195,Sapir,1,Private room,125,1,0.42,126
41196,Alejandro,2,Entire home/apt,110,23,0.68,133
41197,Terrence & Skye,1,Private room,99,72,3.8,171
41199,William,3,Entire home/apt,90,64,1.84,154
41200,Gasminee,3,Private room,42,31,6.39,73
41204,Maria,2,Private room,60,0,0.49,60
41205,Laure,1,Entire home/apt,90,0,0.9,90
41206,Annette C,2,Private room,42,280,3.33,322
41207,Tarik,2,Entire home/apt,190,241,3.17,431
41208,Rumiko,1,Private room,300,76,0.7,376
41209,Elisabeth,1,Entire home/apt,189,0,0.46,189
41210,Raphael,1,Private room,120,198,5.8,318
41211,Andrew,2,Entire home/apt,150,35,3.75,185
41212,Ana,1,Private room,85,227,2.21,312
41213,Genesis,1,Private room,35,8,4.45,43
41218,Sally,2,Entire home/apt,85,51,0.58,136
41219,Nick,1,Private room,150,16,3.59,166
41220,Catherine,4,Private room,50,365,2.41,415
41221,Emma,3,Entire home/apt,115,44,3.91,159
41222,Israel,2,Private room,31,5,5.0,36
41223,Melissa,1,Private room,53,0,0.85,53
41224,Jj,1,Entire home/apt,890,301,0.41,1191
41226,Mauricio,1,Private room,50,52,2.76,102
41227,Kossivi,2,Entire home/apt,179,104,2.11,283
41228,Irina,1,Entire home/apt,130,263,0.5,393
41229,Emily,1,Private room,85,5,4.29,90
41230,Alexis,1,Entire home/apt,800,280,0.86,1080
41232,Olga,3,Entire home/apt,135,120,2.0,255
41233,Tiarnan,2,Private room,80,102,3.03,182
41234,Giselle,1,Private room,90,330,1.26,420
41236,Irene,1,Entire home/apt,150,272,4.05,422
41237,Devika,3,Private room,40,297,1.26,337
41238,Peter,3,Private room,59,67,2.98,126
41240,Sainabou,2,Private room,100,365,1.83,465
41242,Jennifer,2,Entire home/apt,119,24,2.43,143
41243,Vicky,3,Private room,42,157,4.26,199
41244,Vicky,3,Private room,49,121,2.76,170
41245,Manny,4,Entire home/apt,76,300,2.98,376
41246,Sam,1,Private room,97,174,5.84,271
41247,Sam,1,Private room,300,166,3.93,466
41248,Sam,1,Private room,93,359,5.53,452
41249,Studioplus,1,Entire home/apt,220,283,1.09,503
41252,Flavia,1,Private room,96,365,0.56,461
41255,Tayler,1,Entire home/apt,299,19,1.8,318
41256,Sylvester,2,Entire home/apt,160,109,2.35,269
41257,Shirin,2,Entire home/apt,110,17,1.5,127
41258,Melissa,1,Entire home/apt,220,29,0.85,249
41259,Irina,1,Entire home/apt,130,332,0.53,462
41260,Lili,2,Private room,70,0,3.02,70
41261,Marsha,3,Entire home/apt,150,236,5.26,386
41262,Ran,1,Entire home/apt,180,53,5.45,233
41263,Timothy,1,Private room,100,48,4.01,148
41264,Ana,2,Entire home/apt,250,194,2.79,444
41265,Ana,2,Entire home/apt,250,215,1.84,465
41267,Lamia,2,Private room,70,319,0.58,389
41269,Valeria,1,Entire home/apt,200,85,0.84,285
41272,Bar,1,Entire home/apt,799,343,0.39,1142
41273,Hawk,3,Private room,48,132,0.48,180
41277,Anne,2,Private room,60,355,4.14,415
41278,Jasmine,2,Private room,65,89,4.49,154
41280,Sophie,3,Entire home/apt,300,298,6.32,598
41281,Angel,4,Private room,45,347,2.86,392
41282,Elena,1,Entire home/apt,175,231,3.91,406
41283,Gina & Alex,1,Entire home/apt,1000,273,1.59,1273
41284,Antonio,1,Entire home/apt,150,0,3.83,150
41285,Albina,1,Entire home/apt,200,2,6.0,202
41286,Tessa,2,Private room,55,95,0.92,150
41287,Marko,1,Entire home/apt,160,63,6.0,223
41288,Alexey,2,Entire home/apt,110,1,2.56,111
41289,Harrie,1,Private room,180,296,3.05,476
41290,Richard-Anthony,3,Entire home/apt,90,251,2.96,341
41291,Ellie,1,Private room,125,132,4.15,257
41292,Sanja,1,Private room,68,0,0.59,68
41293,Kat,2,Private room,365,79,1.52,444
41294,Beautiful Brooklyn,2,Private room,71,223,3.38,294
41298,Henry,4,Entire home/apt,148,358,1.74,506
41299,Jay,2,Private room,46,155,2.38,201
41300,Tiffany,1,Entire home/apt,165,2,2.01,167
41301,Virginie,3,Entire home/apt,225,30,1.0,255
41303,Seth,1,Entire home/apt,250,26,3.83,276
41304,Artem,1,Entire home/apt,170,123,1.05,293
41305,Matthew,1,Entire home/apt,175,50,2.37,225
41306,Adam,2,Private room,100,3,0.9,103
41308,Santiago,3,Entire home/apt,70,141,1.73,211
41309,Chen,2,Private room,100,89,0.56,189
41310,Florencio,1,Private room,180,151,0.63,331
41311,Otto,2,Private room,98,53,2.37,151
41312,Molly,1,Private room,96,5,0.41,101
41313,Akram,2,Entire home/apt,167,284,4.96,451
41314,Madeleine,1,Private room,85,0,5.7,85
41315,Noemi,1,Entire home/apt,500,77,0.63,577
41316,Omar,3,Entire home/apt,98,337,4.13,435
41317,Rosemary,2,Entire home/apt,125,28,4.43,153
41318,Josefina,1,Private room,75,223,4.88,298
41320,Thomas,1,Private room,99,29,0.79,128
41321,Sophie,2,Entire home/apt,400,20,1.18,420
41322,Emily,1,Entire home/apt,290,313,0.52,603
41323,Kazuya,3,Private room,37,238,0.77,275
41324,Ruth,1,Private room,80,0,0.71,80
41325,Alci,1,Entire home/apt,295,228,4.49,523
41326,Glenn,1,Entire home/apt,160,126,0.86,286
41328,Jose,3,Private room,45,168,2.96,213
41329,Thomas,2,Entire home/apt,245,272,2.79,517
41330,Dor,2,Private room,80,14,0.63,94
41331,Misty,2,Private room,75,5,2.64,80
41334,Mamun,3,Entire home/apt,145,331,2.9,476
41335,Lauren,1,Private room,100,0,0.85,100
41336,Eduardo,3,Private room,80,157,1.06,237
41337,EStelle,1,Entire home/apt,100,24,2.77,124
41340,E,1,Entire home/apt,250,200,3.98,450
41342,Kristen,3,Private room,100,42,1.4,142
41343,Sam,2,Entire home/apt,418,153,3.97,571
41344,Shanée & Ash,2,Private room,110,152,2.44,262
41345,Alejandro,3,Entire home/apt,140,35,0.85,175
41347,Malvern,1,Entire home/apt,250,336,3.59,586
41348,Leandro,4,Entire home/apt,65,51,3.26,116
41350,Maria,5,Private room,30,188,1.0,218
41351,Eliahu,1,Private room,69,365,0.33,434
41353,Eliahu,1,Private room,69,365,1.0,434
41354,Eliahu,1,Shared room,69,365,0.39,434
41355,Karin,2,Entire home/apt,140,68,0.47,208
41356,Saira,2,Entire home/apt,450,204,0.52,654
41357,Matty,1,Entire home/apt,220,310,0.33,530
41358,Matthew,1,Entire home/apt,210,156,1.29,366
41360,April G,2,Private room,58,94,2.02,152
41362,Sonder (NYC),1,Entire home/apt,245,272,1.65,517
41363,Sonder (NYC),1,Entire home/apt,245,299,2.0,544
41364,Sonder (NYC),1,Private room,200,352,2.81,552
41365,Sonder (NYC),1,Entire home/apt,229,355,3.0,584
41366,Sonder (NYC),1,Private room,204,327,0.96,531
41367,Rhaynelina,2,Entire home/apt,100,0,0.43,100
41368,Claribel,1,Entire home/apt,156,51,2.22,207
41369,Bianca,4,Private room,30,0,1.76,30
41370,Michael,2,Entire home/apt,240,89,0.25,329
41371,Brian,2,Entire home/apt,132,205,1.03,337
41372,Monika,2,Entire home/apt,130,119,3.31,249
41373,Sonder (NYC),1,Entire home/apt,404,330,2.26,734
41374,Sonder (NYC),1,Entire home/apt,234,332,1.46,566
41375,Sonder (NYC),1,Entire home/apt,425,339,2.11,764
41376,Sonder (NYC),1,Entire home/apt,235,306,1.52,541
41377,Sonder (NYC),1,Entire home/apt,503,315,1.34,818
41378,Li,1,Entire home/apt,250,71,3.86,321
41379,Mary Luz,3,Private room,40,10,1.88,50
41380,Sonder (NYC),1,Private room,258,332,1.27,590
41381,Sonder (NYC),1,Entire home/apt,392,286,0.63,678
41382,Sonder (NYC),1,Private room,375,280,1.24,655
41383,Sonder (NYC),1,Entire home/apt,231,347,1.69,578
41384,Sonder (NYC),1,Entire home/apt,194,341,1.85,535
41385,Sonder (NYC),1,Entire home/apt,240,357,1.98,597
41386,Sonder (NYC),1,Entire home/apt,229,346,1.75,575
41387,Sonder (NYC),1,Entire home/apt,230,346,1.49,576
41388,Sonder (NYC),1,Entire home/apt,472,234,2.67,706
41389,Sonder (NYC),1,Private room,256,329,3.75,585
41390,Jhonnil,1,Entire home/apt,149,155,1.47,304
41391,John,3,Private room,40,188,1.88,228
41392,Fa,1,Private room,95,131,2.55,226
41393,Amanda,2,Private room,150,20,1.48,170
41394,Kazuya,3,Private room,51,239,0.58,290
41395,Heather,1,Entire home/apt,175,3,2.92,178
41396,Reesey,2,Shared room,75,1,0.63,76
41397,Matthew,1,Entire home/apt,125,72,0.21,197
41399,Sherril,4,Entire home/apt,200,0,0.67,200
41400,Incentra,1,Private room,999,310,0.39,1309
41401,Sonder (NYC),1,Entire home/apt,454,297,3.33,751
41402,Sonder (NYC),1,Private room,262,328,1.59,590
41403,Sonder (NYC),1,Entire home/apt,472,316,1.41,788
41404,Sonder (NYC),1,Entire home/apt,203,338,1.88,541
41405,Sonder (NYC),1,Entire home/apt,247,263,2.13,510
41406,Sonder (NYC),1,Entire home/apt,377,273,3.52,650
41407,Sonder (NYC),1,Entire home/apt,229,323,3.65,552
41408,Sonder (NYC),1,Entire home/apt,234,340,3.05,574
41409,Sonder (NYC),1,Entire home/apt,503,294,2.1,797
41410,Sonder (NYC),1,Entire home/apt,228,350,0.73,578
41411,Sonder (NYC),1,Entire home/apt,404,310,3.19,714
41412,Sonder (NYC),1,Entire home/apt,252,302,3.03,554
41413,Sonder (NYC),1,Entire home/apt,229,337,1.69,566
41414,Sonder (NYC),1,Entire home/apt,431,323,2.11,754
41415,Sonder (NYC),1,Entire home/apt,412,341,3.07,753
41416,Sonder (NYC),1,Entire home/apt,403,273,1.9,676
41417,Sonder (NYC),1,Entire home/apt,229,349,2.34,578
41418,Sonder (NYC),1,Entire home/apt,227,356,1.88,583
41419,Sonder (NYC),1,Entire home/apt,205,338,2.54,543
41420,Alexandra,1,Private room,85,7,0.82,92
41421,Sonder (NYC),1,Entire home/apt,194,318,2.26,512
41422,Sonder (NYC),1,Entire home/apt,214,312,3.2,526
41423,Sonder (NYC),1,Entire home/apt,229,346,2.11,575
41424,Sonder (NYC),1,Entire home/apt,185,295,1.58,480
41425,Sonder (NYC),1,Entire home/apt,234,333,2.31,567
41426,Sonder (NYC),1,Entire home/apt,201,333,4.11,534
41427,Sonder (NYC),1,Entire home/apt,229,335,1.25,564
41428,Sonder (NYC),1,Entire home/apt,244,258,0.7,502
41429,Sonder (NYC),1,Entire home/apt,227,349,3.64,576
41430,Sonder (NYC),1,Entire home/apt,451,254,4.37,705
41431,Sonder (NYC),1,Entire home/apt,241,284,1.35,525
41432,Sonder (NYC),1,Entire home/apt,252,260,3.19,512
41433,Sonder (NYC),1,Entire home/apt,250,292,2.59,542
41434,Roman,1,Entire home/apt,419,326,1.57,745
41435,Sonder (NYC),1,Entire home/apt,505,275,1.79,780
41436,Sonder (NYC),1,Entire home/apt,228,348,2.02,576
41437,Sonder (NYC),1,Entire home/apt,242,261,3.75,503
41438,Elsa,2,Entire home/apt,175,40,1.19,215
41439,Sonder (NYC),1,Entire home/apt,221,333,1.97,554
41440,Sonder (NYC),1,Entire home/apt,203,336,2.16,539
41441,Sonder (NYC),1,Entire home/apt,228,355,2.73,583
41442,Sonder (NYC),1,Entire home/apt,215,313,2.31,528
41444,Sonder (NYC),1,Entire home/apt,198,346,1.65,544
41445,Sonder (NYC),1,Entire home/apt,468,267,3.0,735
41446,Sonder (NYC),1,Entire home/apt,227,350,0.81,577
41447,Sonder (NYC),1,Entire home/apt,236,347,2.52,583
41448,Sonder (NYC),1,Entire home/apt,244,317,1.82,561
41450,Sonder (NYC),1,Entire home/apt,248,271,4.08,519
41451,Sonder (NYC),1,Entire home/apt,241,331,2.08,572
41452,Sonder (NYC),1,Entire home/apt,390,268,2.43,658
41453,Sonder (NYC),1,Entire home/apt,230,357,2.57,587
41454,Sonder (NYC),1,Entire home/apt,230,323,2.11,553
41455,Sonder (NYC),1,Entire home/apt,227,328,2.5,555
41456,Sonder (NYC),1,Entire home/apt,214,304,2.97,518
41457,Sonder (NYC),1,Entire home/apt,188,298,1.08,486
41458,Sonder (NYC),1,Entire home/apt,247,314,0.97,561
41459,Sonder (NYC),1,Entire home/apt,220,331,1.15,551
41460,Sonder (NYC),1,Entire home/apt,196,325,1.48,521
41461,Sonder (NYC),1,Entire home/apt,218,279,1.04,497
41462,Beryl,2,Entire home/apt,130,301,2.93,431
41463,Sonder (NYC),1,Entire home/apt,396,289,2.12,685
41464,Sonder (NYC),1,Entire home/apt,214,268,1.43,482
41465,Murat,2,Private room,50,0,1.0,50
41466,Sonder (NYC),1,Entire home/apt,196,318,2.48,514
41467,Sonder (NYC),1,Entire home/apt,380,302,3.5,682
41468,Sonder (NYC),1,Entire home/apt,229,351,0.77,580
41469,Sonder (NYC),1,Entire home/apt,498,255,2.5,753
41470,Sonder (NYC),1,Entire home/apt,215,317,0.77,532
41471,Sonder (NYC),1,Entire home/apt,231,331,3.42,562
41472,Sonder (NYC),1,Entire home/apt,234,343,1.36,577
41473,Sonder (NYC),1,Entire home/apt,212,293,0.74,505
41474,Sonder (NYC),1,Entire home/apt,228,343,2.12,571
41475,Sonder (NYC),1,Entire home/apt,214,343,1.57,557
41476,Sonder (NYC),1,Entire home/apt,214,333,1.23,547
41477,Sonder (NYC),1,Entire home/apt,201,271,2.62,472
41478,Sonder (NYC),1,Entire home/apt,214,331,0.59,545
41479,Sonder (NYC),1,Entire home/apt,235,341,1.58,576
41480,Clement & Rose,2,Entire home/apt,165,365,1.58,530
41481,Sonder (NYC),1,Entire home/apt,256,277,2.6,533
41482,Sonder (NYC),1,Entire home/apt,248,284,2.48,532
41483,Sonder (NYC),1,Entire home/apt,216,332,2.23,548
41484,Sonder (NYC),1,Entire home/apt,223,310,0.74,533
41485,Sonder (NYC),1,Entire home/apt,229,329,2.37,558
41486,Marissa,2,Entire home/apt,200,142,3.98,342
41487,Jae,2,Private room,110,86,1.1,196
41489,George,3,Private room,55,32,4.97,87
41490,Stephanie,2,Private room,65,0,0.38,65
41491,V,1,Entire home/apt,150,106,4.66,256
41492,Lc,2,Entire home/apt,100,73,0.97,173
41493,Joseph,1,Private room,68,90,4.15,158
41494,Adam,2,Entire home/apt,100,7,0.48,107
41495,Heather & Alex,2,Entire home/apt,215,6,2.88,221
41496,Marysell,3,Private room,65,0,0.41,65
41497,Chris,3,Entire home/apt,85,84,0.3,169
41498,George,3,Private room,50,38,4.2,88
41499,George,3,Entire home/apt,255,114,2.87,369
41501,Lizhen,3,Private room,300,89,0.21,389
41502,Luke,2,Private room,75,188,0.85,263
41503,Denny,4,Shared room,50,158,1.54,208
41504,Nitzan,2,Entire home/apt,64,0,0.25,64
41505,Cuitlahuac,1,Private room,225,66,0.27,291
41506,Esteban,2,Private room,50,49,3.33,99
41507,Ismael,4,Private room,35,6,2.1,41
41509,Chin,1,Entire home/apt,211,74,4.18,285
41510,Steve,3,Entire home/apt,95,23,4.5,118
41511,Marlon,1,Private room,52,11,1.68,63
41512,Nick,2,Private room,64,13,6.13,77
41513,Dino,1,Private room,85,104,8.45,189
41514,Vlasta,2,Entire home/apt,200,26,1.05,226
41516,Ella,3,Private room,54,319,2.34,373
41518,Jennifer,2,Entire home/apt,195,20,1.1,215
41519,Angela,2,Private room,33,37,3.09,70
41521,Diego,2,Entire home/apt,210,188,5.91,398
41523,Mike,1,Entire home/apt,612,91,3.52,703
41524,Rosy,3,Private room,45,66,11.59,111
41525,Ali,2,Entire home/apt,650,365,0.29,1015
41527,Dave,1,Entire home/apt,175,3,1.0,178
41528,Pete And Chloe,2,Private room,65,107,4.23,172
41529,Irina,2,Entire home/apt,70,63,3.19,133
41530,Ninja & Sung,2,Entire home/apt,195,38,3.71,233
41533,Leila,2,Private room,80,89,2.23,169
41534,Clinton,1,Entire home/apt,300,0,0.58,300
41535,Carol,1,Entire home/apt,215,128,2.55,343
41536,Memory,2,Private room,40,0,1.9,40
41538,Camille,1,Private room,77,52,4.38,129
41541,Rafael,3,Private room,49,55,1.25,104
41543,Lisa,3,Entire home/apt,89,0,4.29,89
41545,Oscar,1,Entire home/apt,170,64,8.48,234
41546,Shalini,2,Private room,65,63,1.5,128
41547,Alison,2,Entire home/apt,120,8,0.88,128
41548,Shoshana,2,Entire home/apt,150,5,2.78,155
41549,Pete And Chloe,2,Private room,57,116,6.46,173
41550,Alexis,2,Entire home/apt,108,99,2.6,207
41551,Pete And Chloe,2,Private room,70,132,7.03,202
41552,Barbara,2,Private room,89,0,1.4,89
41553,Manon,2,Private room,99,19,2.03,118
41554,Amy,2,Private room,115,89,0.61,204
41557,Blacky,2,Entire home/apt,119,5,0.44,124
41558,Kel,1,Entire home/apt,136,47,5.91,183
41559,Deborah,3,Private room,67,318,6.88,385
41562,Mary,2,Entire home/apt,100,0,4.5,100
41563,Ashlin,1,Entire home/apt,220,36,0.62,256
41565,Dafni,3,Private room,45,31,1.15,76
41566,George,1,Private room,145,113,2.98,258
41567,Maria,1,Entire home/apt,195,0,0.99,195
41568,Mick,1,Private room,75,67,2.73,142
41569,Vlad,2,Entire home/apt,160,177,0.79,337
41570,Eric,2,Shared room,25,29,0.21,54
41572,Jay/Carolina Bastidas Family,2,Private room,38,307,2.44,345
41574,Xu,1,Private room,75,34,1.96,109
41576,Brooke,2,Private room,55,22,1.29,77
41577,Nick,2,Entire home/apt,100,6,1.04,106
41578,Skylar,2,Entire home/apt,125,128,2.6,253
41580,Anika,1,Entire home/apt,1200,166,0.7,1366
41581,Ethan,1,Entire home/apt,177,8,1.74,185
41583,Incentra,1,Private room,999,329,2.43,1328
41584,Incentra,1,Private room,999,334,0.59,1333
41585,Incentra,1,Private room,999,341,0.7,1340
41586,Tina,2,Private room,60,21,6.5,81
41587,Beauty,2,Private room,60,282,4.49,342
41588,Beka And Strat,2,Private room,158,179,3.0,337
41589,Law,1,Entire home/apt,140,9,4.2,149
41590,Adrian,2,Private room,60,144,1.26,204
41591,Beauty,2,Private room,60,301,7.96,361
41593,Ana,1,Private room,140,120,0.38,260
41594,Paulina,2,Private room,100,53,1.36,153
41595,Patrick,2,Entire home/apt,125,0,1.2,125
41596,Angela,1,Entire home/apt,74,0,0.95,74
41597,John,3,Private room,65,342,1.29,407
41598,John,1,Entire home/apt,500,352,0.81,852
41599,Blanca,3,Private room,30,77,3.41,107
41600,John,1,Entire home/apt,650,297,0.25,947
41601,Di Di,1,Entire home/apt,125,0,1.1,125
41603,Reesey,2,Private room,80,0,2.11,80
41604,Yara,1,Entire home/apt,379,252,3.3,631
41608,Jim,2,Private room,40,62,0.82,102
41609,Kazuya,3,Private room,42,0,0.38,42
41610,James And Laureta,2,Entire home/apt,90,85,3.09,175
41611,Jacqueline,2,Private room,145,343,1.0,488
41612,Lorena,1,Entire home/apt,400,0,0.83,400
41613,Jennifer,1,Private room,150,81,2.92,231
41615,Raphael,2,Private room,50,0,0.25,50
41616,Austin,2,Entire home/apt,95,0,1.2,95
41618,Yesenia,2,Private room,40,0,0.69,40
41619,Yesenia,2,Private room,40,0,1.67,40
41621,Yuval,3,Private room,42,204,0.6,246
41623,Yuval,3,Private room,42,208,1.62,250
41625,Yuval,3,Private room,37,318,0.29,355
41626,Christina,3,Entire home/apt,225,89,1.12,314
41627,Nathalie,2,Private room,43,0,0.61,43
41628,Stefy,1,Entire home/apt,160,12,1.78,172
41629,Marccelo Gabriel,1,Private room,115,94,5.79,209
41631,Jackson,2,Private room,40,61,1.86,101
41632,Julio,4,Entire home/apt,159,118,2.26,277
41633,Yaevette,2,Entire home/apt,150,70,2.0,220
41635,Niky,1,Entire home/apt,249,227,3.12,476
41636,Kiara,1,Private room,85,0,6.27,85
41637,Kendrick,2,Entire home/apt,188,199,2.4,387
41638,Maria,1,Entire home/apt,488,76,3.65,564
41639,Marlon,1,Private room,55,6,2.0,61
41643,Florentino,1,Private room,79,365,2.23,444
41644,Caroline,2,Entire home/apt,100,0,0.25,100
41645,Nubia,2,Private room,57,114,5.11,171
41646,Elizabeth,1,Entire home/apt,260,76,0.75,336
41647,Jenny,1,Entire home/apt,1497,363,2.36,1860
41648,Nubia,2,Private room,55,188,4.0,243
41649,Nubia,2,Private room,51,111,3.33,162
41650,Irina,1,Private room,95,6,3.61,101
41651,Aushra,2,Entire home/apt,125,11,0.24,136
41652,Peter,5,Entire home/apt,275,182,3.51,457
41653,Vena,2,Private room,35,365,1.47,400
41654,Vena,2,Private room,35,351,1.84,386
41655,Sarah & John @ Bedly,2,Shared room,26,23,0.59,49
41656,Sarah & John @ Bedly,2,Shared room,26,49,0.75,75
41657,Samia,1,Entire home/apt,175,90,3.44,265
41658,Britt,1,Private room,95,160,1.49,255
41660,Amir,1,Entire home/apt,95,3,0.6,98
41666,Coronado,2,Private room,60,0,0.76,60
41667,Anwar,1,Entire home/apt,110,214,1.23,324
41669,Lily,2,Private room,67,345,1.99,412
41670,Mariah,2,Private room,75,364,0.93,439
41672,Ruth,4,Private room,60,308,1.97,368
41673,Hugo,2,Entire home/apt,190,207,3.33,397
41674,Kim,2,Private room,85,111,2.56,196
41675,Joe,4,Entire home/apt,125,365,1.0,490
41676,Patricia,2,Private room,50,0,1.0,50
41677,Matthias,1,Entire home/apt,172,42,1.98,214
41678,Larissa,3,Private room,80,51,3.26,131
41679,Belkis,1,Private room,58,365,0.85,423
41680,Brynlee & Lawrence,2,Entire home/apt,179,17,3.37,196
41681,Bryan,4,Private room,49,0,2.0,49
41682,Lakisha,2,Entire home/apt,166,177,2.56,343
41683,Javicia,2,Entire home/apt,133,0,1.0,133
41684,Lucca & Paula,3,Entire home/apt,220,308,2.81,528
41685,Lucca & Paula,3,Private room,62,308,3.38,370
41686,Rich,3,Entire home/apt,125,14,0.92,139
41687,Lucca & Paula,3,Private room,80,313,4.53,393
41688,Lucca & Paula,3,Private room,70,313,3.26,383
41689,Lucca & Paula,3,Shared room,40,313,3.59,353
41692,Anna,2,Entire home/apt,179,323,4.66,502
41693,Daniel,1,Entire home/apt,240,99,1.79,339
41694,Owen,3,Private room,55,0,4.22,55
41696,Norma,1,Entire home/apt,515,163,6.84,678
41698,Whitney&Theo,2,Entire home/apt,175,103,0.56,278
41699,Amaury,4,Private room,41,357,0.58,398
41700,Fiona,2,Entire home/apt,180,0,1.72,180
41702,Kay,2,Entire home/apt,200,357,1.13,557
41703,Benjamin,2,Private room,60,0,0.25,60
41704,Chaim,2,Entire home/apt,125,87,9.68,212
41705,Miguel,1,Entire home/apt,200,0,4.89,200
41707,Alexo & JC,1,Entire home/apt,220,1,1.95,221
41708,Dina,2,Shared room,25,0,1.73,25
41710,Justin,1,Private room,75,0,1.19,75
41712,Veronica,1,Private room,250,76,1.15,326
41713,Ilham,3,Private room,62,13,2.33,75
41714,Zahavah Cara,2,Private room,65,81,1.15,146
41716,Pit,1,Entire home/apt,180,4,0.85,184
41717,Robertina,3,Private room,85,50,3.72,135
41718,Brett,1,Entire home/apt,325,31,1.24,356
41719,Alejandro,2,Entire home/apt,104,174,6.13,278
41720,Adrienne,1,Private room,77,0,2.5,77
41721,Alex,2,Private room,50,0,2.19,50
41722,Daniel,2,Entire home/apt,120,137,3.87,257
41724,Cheyenne,1,Entire home/apt,95,0,4.07,95
41726,Luz,3,Private room,42,80,4.48,122
41727,Frankie,1,Entire home/apt,180,281,3.75,461
41728,Melissa,1,Private room,110,0,3.0,110
41729,Lola,4,Private room,52,0,0.22,52
41732,Howard,2,Entire home/apt,90,66,2.26,156
41733,Kiara,1,Private room,79,93,7.38,172
41734,Regina,1,Entire home/apt,100,50,0.44,150
41737,Dana,2,Entire home/apt,135,117,1.96,252
41738,Julia,2,Private room,51,166,2.41,217
41739,K,4,Private room,64,358,3.47,422
41740,David,2,Private room,48,257,5.37,305
41745,Sonder (NYC),1,Entire home/apt,282,125,1.93,407
41748,Sonder (NYC),1,Entire home/apt,169,332,0.6,501
41750,Sonder (NYC),1,Entire home/apt,169,220,0.48,389
41751,Sonder (NYC),1,Entire home/apt,172,338,0.75,510
41752,S,1,Entire home/apt,199,65,6.49,264
41753,Sonder (NYC),1,Entire home/apt,202,338,0.47,540
41754,Jorge,2,Entire home/apt,150,217,3.93,367
41758,Paul,2,Entire home/apt,150,63,0.41,213
41759,Alli,2,Entire home/apt,179,2,0.47,181
41760,Mansi,1,Private room,99,0,1.49,99
41763,Julia,1,Private room,150,345,1.4,495
41765,Becky,1,Private room,175,252,0.25,427
41767,Perrian,2,Private room,96,103,1.82,199
41768,Jeromy,2,Entire home/apt,74,86,2.84,160
41769,Lian,4,Entire home/apt,100,3,4.93,103
41772,Sancar,2,Entire home/apt,120,113,0.82,233
41773,Audrey,2,Private room,35,42,2.59,77
41774,David,1,Entire home/apt,120,65,4.45,185
41776,Endazsia,2,Entire home/apt,400,5,1.23,405
41780,Jfk,3,Entire home/apt,175,68,3.31,243
41781,Christine,2,Entire home/apt,100,0,0.93,100
41782,King-Lyndon,1,Entire home/apt,100,8,3.58,108
41783,Jfk,3,Private room,75,163,6.35,238
41784,Jfk,3,Entire home/apt,175,160,3.75,335
41785,Jfk,3,Private room,55,161,3.92,216
41786,Jfk,3,Private room,75,179,1.86,254
41787,Shemar,2,Shared room,30,157,2.34,187
41788,Alanna,2,Entire home/apt,69,0,0.86,69
41789,Jfk,3,Private room,65,177,3.23,242
41790,Jfk,3,Private room,85,163,3.89,248
41791,Victoria,2,Entire home/apt,143,81,5.0,224
41793,New York Italians,2,Private room,65,9,3.33,74
41794,Natalia,2,Entire home/apt,150,146,1.0,296
41795,Scarlett,2,Entire home/apt,107,53,0.55,160
41797,Tito,1,Private room,87,76,2.0,163
41798,Linsey,2,Entire home/apt,175,73,7.14,248
41799,Maya,3,Private room,48,0,0.22,48
41800,Maisie,2,Entire home/apt,82,42,1.25,124
41801,Edna,1,Private room,78,116,2.6,194
41802,Alex,2,Entire home/apt,105,38,0.29,143
41803,Joe,1,Entire home/apt,285,261,4.08,546
41805,Vlad,5,Entire home/apt,83,316,0.9,399
41809,Tommy,1,Private room,150,334,2.54,484
41811,Ady,1,Entire home/apt,145,36,2.88,181
41813,Janey,1,Entire home/apt,150,88,1.84,238
41814,Valentina,2,Private room,55,317,4.69,372
41815,Momoyo,3,Private room,33,34,1.0,67
41817,Chris And Jamie,1,Entire home/apt,175,133,6.59,308
41818,Rosario,1,Private room,90,0,0.88,90
41819,Shay,2,Entire home/apt,85,215,3.33,300
41824,Cory,1,Private room,90,14,2.34,104
41825,Emmanuel,2,Entire home/apt,199,31,5.05,230
41826,Elenora And Jason,2,Private room,40,43,2.34,83
41827,Luis & Tiana,2,Private room,90,83,1.0,173
41829,Scott And Bea,5,Entire home/apt,125,252,3.19,377
41830,Smart Accommodations,3,Entire home/apt,350,97,0.99,447
41831,Dardana,1,Private room,70,3,1.0,73
41832,Karla,2,Private room,36,0,0.24,36
41834,Vincent,2,Private room,75,151,0.44,226
41835,Antonio,1,Entire home/apt,160,29,5.47,189
41837,Stephan And Leo,1,Entire home/apt,295,39,1.0,334
41838,Stephan And Leo,1,Entire home/apt,295,2,0.52,297
41839,Bel,1,Private room,125,0,0.35,125
41840,Felix,1,Entire home/apt,215,148,0.53,363
41841,Alba,3,Entire home/apt,115,34,4.36,149
41842,Ben,3,Entire home/apt,175,331,4.03,506
41843,Jon,1,Entire home/apt,299,324,2.05,623
41844,Michael,1,Entire home/apt,146,89,0.23,235
41845,Misha,3,Entire home/apt,250,94,4.46,344
41846,Joe,1,Entire home/apt,161,204,4.22,365
41847,Lara,1,Entire home/apt,140,327,0.35,467
41848,Beauty,2,Private room,55,298,7.17,353
41851,Daisy,2,Private room,48,15,0.48,63
41852,Brooke,1,Private room,66,125,0.36,191
41856,Tina,2,Private room,70,99,1.57,169
41859,Anthony,2,Entire home/apt,85,312,0.25,397
41860,Vincent,1,Entire home/apt,300,168,1.88,468
41861,Amy,2,Entire home/apt,160,71,3.13,231
41864,Peter,2,Private room,58,365,2.7,423
41865,Daniel,1,Entire home/apt,145,0,0.79,145
41867,Lera,3,Private room,70,0,0.29,70
41868,Jane,3,Shared room,35,53,4.52,88
41869,Ana,1,Entire home/apt,50,51,4.25,101
41870,Cylia,1,Entire home/apt,500,298,3.78,798
41871,Mary Ann,2,Entire home/apt,126,52,5.16,178
41872,Fang,3,Private room,48,244,3.18,292
41873,Matan,1,Entire home/apt,139,58,1.17,197
41875,Sebastian,1,Entire home/apt,135,0,0.3,135
41877,Alexandre,1,Entire home/apt,369,97,3.75,466
41878,Timothy,1,Private room,35,2,1.11,37
41879,Adila,2,Private room,39,13,3.36,52
41881,Qiulan,2,Private room,50,71,3.16,121
41882,빈나,1,Private room,125,0,0.24,125
41883,Qiulan,2,Private room,60,84,3.13,144
41884,Luis,1,Entire home/apt,200,13,1.21,213
41885,Kelly,2,Private room,55,0,0.27,55
41887,Pam,2,Entire home/apt,200,344,1.38,544
41891,Fabiola,3,Entire home/apt,120,0,0.72,120
41893,Especial,1,Private room,990,343,1.0,1333
41894,Jacqueline,2,Entire home/apt,150,2,1.5,152
41897,Jacqueline,2,Entire home/apt,69,282,7.5,351
41898,Maxime,2,Entire home/apt,110,25,0.98,135
41900,Sonder (NYC),1,Entire home/apt,257,108,2.03,365
41901,Sonder (NYC),1,Entire home/apt,243,140,1.35,383
41902,Fang,3,Private room,39,142,3.61,181
41904,Katie Rose,1,Private room,65,1,1.59,66
41905,Reuven,2,Entire home/apt,165,269,2.75,434
41906,Madeleine,1,Private room,59,0,1.59,59
41907,Anchor,2,Shared room,35,49,0.75,84
41908,David,1,Private room,115,217,3.75,332
41910,David,1,Private room,105,241,3.62,346
41912,Amit,3,Entire home/apt,107,133,0.9,240
41913,Sonder (NYC),1,Entire home/apt,308,81,1.55,389
41914,C,2,Entire home/apt,99,19,2.36,118
41918,Aminul,2,Private room,35,260,1.19,295
41919,Patrick,3,Entire home/apt,300,364,0.97,664
41920,Allen,2,Entire home/apt,395,0,0.64,395
41921,Harmony,2,Private room,105,349,2.43,454
41922,Jen,1,Private room,80,0,0.3,80
41923,Julia,2,Entire home/apt,120,292,3.52,412
41924,Fabiana,3,Private room,48,0,0.91,48
41925,Avery,2,Private room,51,0,1.52,51
41926,Claudia,1,Entire home/apt,120,37,0.39,157
41927,Studioplus,1,Entire home/apt,260,259,1.13,519
41928,Terrence & Skye,1,Private room,82,90,0.94,172
41929,Michael,2,Private room,45,351,1.18,396
41930,Jessy & Christian,3,Shared room,23,308,2.12,331
41931,Yanilin,1,Private room,37,88,1.05,125
41932,Jim,2,Entire home/apt,115,0,0.26,115
41933,Sonder (NYC),1,Entire home/apt,300,58,1.17,358
41934,Sonder (NYC),1,Entire home/apt,316,76,1.17,392
41935,Sonder (NYC),1,Entire home/apt,228,133,1.12,361
41937,Elo,1,Private room,79,97,3.56,176
41939,Brett,1,Private room,95,74,5.37,169
41942,Jack,2,Entire home/apt,200,76,2.5,276
41943,Aaron,1,Entire home/apt,160,0,0.94,160
41944,Christopher,3,Private room,42,178,0.9,220
41945,Yoselyn,4,Entire home/apt,95,153,8.62,248
41946,Karim,1,Private room,90,0,1.7,90
41947,C,2,Private room,89,5,0.9,94
41949,Laura,2,Entire home/apt,83,163,0.3,246
41950,Angela,1,Entire home/apt,349,355,0.23,704
41951,Kelly,2,Entire home/apt,90,2,4.96,92
41952,Temp,3,Entire home/apt,100,183,3.28,283
41954,Ben,1,Private room,80,16,13.13,96
41955,Sahar,1,Private room,75,332,1.17,407
41956,Trendi,1,Entire home/apt,278,133,0.99,411
41957,Lisa,2,Entire home/apt,150,5,0.98,155
41958,Arnol,4,Private room,40,84,6.72,124
41959,Tina,2,Private room,65,100,2.09,165
41960,Nicolas,2,Entire home/apt,90,6,1.53,96
41961,Erica,1,Entire home/apt,199,49,5.17,248
41962,Kerri-Ann,2,Entire home/apt,106,15,7.56,121
41964,Antony,2,Shared room,28,0,0.55,28
41965,Mike,1,Entire home/apt,132,174,2.45,306
41966,Aminul,2,Private room,35,247,3.1,282
41967,Esteban,2,Private room,29,18,1.74,47
41968,Aminul,2,Private room,35,252,1.75,287
41969,Giancarlo,2,Entire home/apt,100,326,1.17,426
41970,Aminul,2,Private room,42,98,0.64,140
41971,Pablo,2,Private room,43,68,4.05,111
41972,Eliza Alex,3,Private room,100,124,2.89,224
41973,Aminul,2,Private room,35,116,1.33,151
41974,Aminul,2,Private room,40,198,2.05,238
41975,Aminul,2,Private room,38,301,1.64,339
41976,Aminul,2,Private room,40,247,1.95,287
41977,Haruhisa,3,Private room,35,2,0.87,37
41978,Yeufre,4,Private room,60,90,0.33,150
41980,Anthony,3,Entire home/apt,147,107,4.92,254
41981,Davis,1,Private room,80,0,3.64,80
41982,Katie Rose,1,Entire home/apt,135,3,0.41,138
41983,Sonder (NYC),1,Entire home/apt,484,247,2.0,731
41984,Sonder (NYC),1,Entire home/apt,211,325,4.21,536
41985,Sonder (NYC),1,Entire home/apt,388,262,2.35,650
41986,Sonder (NYC),1,Entire home/apt,407,294,2.18,701
41987,Sonder (NYC),1,Entire home/apt,425,311,1.18,736
41988,Sonder (NYC),1,Entire home/apt,432,323,1.11,755
41989,Sonder (NYC),1,Entire home/apt,205,327,2.64,532
41990,Sonder (NYC),1,Entire home/apt,248,294,2.59,542
41991,Sonder (NYC),1,Entire home/apt,396,323,1.8,719
41992,Sonder (NYC),1,Entire home/apt,376,276,2.46,652
41994,Zoe,2,Shared room,125,365,0.54,490
41995,Sonder (NYC),1,Entire home/apt,230,297,1.98,527
41996,Sonder (NYC),1,Entire home/apt,416,338,1.72,754
41997,Christopher,1,Private room,50,24,5.41,74
42000,Jason,4,Entire home/apt,93,306,0.23,399
42002,Nikki,2,Entire home/apt,100,13,3.86,113
42003,Roxanne And Stan,2,Entire home/apt,235,153,2.98,388
42005,Melody-Lane,2,Private room,45,43,3.13,88
42006,Andrzej,3,Entire home/apt,180,82,2.98,262
42007,Jeremy & Laura,1,Entire home/apt,202,327,0.77,529
42008,Carlton,1,Private room,50,168,3.22,218
42009,Irina,1,Entire home/apt,160,332,0.58,492
42011,Thaweesab,1,Private room,90,66,0.48,156
42013,Alina,1,Private room,220,0,0.23,220
42014,Davis,1,Private room,67,38,5.64,105
42015,Jessica,2,Private room,45,9,1.55,54
42016,Joseph,1,Entire home/apt,250,233,1.47,483
42017,Emily,3,Entire home/apt,190,70,2.28,260
42018,Sonia,3,Private room,42,0,3.05,42
42019,Alice,2,Entire home/apt,109,0,1.24,109
42021,Maybee,1,Private room,150,255,4.17,405
42023,Sinead,1,Entire home/apt,150,0,0.98,150
42024,Selcuk,1,Entire home/apt,137,12,0.33,149
42025,Ozzy,1,Private room,44,0,1.71,44
42026,Evgeny,1,Entire home/apt,350,318,2.18,668
42027,Rick,1,Private room,275,233,3.15,508
42028,Bianca,3,Entire home/apt,150,75,0.99,225
42030,Ryan,1,Entire home/apt,125,191,2.13,316
42032,Abby,1,Shared room,65,208,4.45,273
42035,Maya,2,Private room,70,9,0.9,79
42036,Enrico,1,Entire home/apt,166,0,0.65,166
42037,Dinneal,3,Private room,55,114,3.88,169
42038,Ines,3,Private room,55,61,4.0,116
42040,Erika,2,Private room,95,32,3.44,127
42041,Barrett,1,Entire home/apt,115,5,0.25,120
42043,Jessica,2,Entire home/apt,350,82,1.11,432
42044,Roman,2,Entire home/apt,506,134,2.18,640
42045,Sonder (NYC),1,Entire home/apt,165,342,0.59,507
42046,Sonder (NYC),1,Entire home/apt,160,345,0.63,505
42047,James And Siobhan,2,Entire home/apt,650,307,5.41,957
42050,Hui Chong,2,Entire home/apt,102,4,1.72,106
42051,Chris,1,Entire home/apt,359,2,2.42,361
42052,Gwendolyn,2,Entire home/apt,190,351,1.47,541
42055,Cleo & Job,2,Entire home/apt,168,83,2.46,251
42056,Ali,2,Entire home/apt,125,0,3.98,125
42058,Jasmine,1,Entire home/apt,170,3,1.01,173
42059,Sergii,2,Private room,85,222,4.43,307
42061,Robert,1,Entire home/apt,150,0,0.28,150
42062,Stephanie,1,Entire home/apt,125,42,1.51,167
42063,Max,2,Entire home/apt,95,14,1.89,109
42064,Stewart Hotel,1,Private room,100,275,3.42,375
42065,Stewart Hotel,1,Private room,100,323,1.85,423
42066,Lucio,3,Private room,58,129,4.44,187
42067,Stewart Hotel,1,Private room,100,315,7.67,415
42068,Stewart Hotel,1,Private room,100,319,9.85,419
42070,Stewart Hotel,1,Private room,100,269,1.8,369
42071,Stewart Hotel,1,Private room,100,317,1.69,417
42072,Stewart Hotel,1,Private room,100,324,0.68,424
42073,Stewart Hotel,1,Private room,100,324,7.08,424
42075,Row NYC,1,Private room,100,299,58.5,399
42076,Row NYC,1,Private room,199,299,27.95,498
42077,Row NYC,1,Private room,100,295,14.62,395
42078,Row NYC,1,Private room,100,289,2.61,389
42080,Row NYC,1,Private room,249,283,7.59,532
42081,Row NYC,1,Private room,100,299,0.45,399
42083,Arthouse Hotel,1,Private room,209,288,2.81,497
42084,Arthouse Hotel,1,Private room,250,281,0.45,531
42086,Arthouse Hotel,1,Private room,230,288,0.88,518
42091,Arthouse Hotel,1,Private room,230,252,0.74,482
42093,Paramount Hotel,1,Private room,324,363,1.85,687
42094,Paramount Hotel,1,Private room,379,353,4.55,732
42095,Paramount Hotel,1,Private room,299,362,7.69,661
42096,Paramount Hotel,1,Private room,359,358,1.54,717
42097,Paramount Hotel,1,Private room,304,351,2.54,655
42098,Renel,2,Entire home/apt,146,24,0.77,170
42099,Alexandra,1,Entire home/apt,149,129,2.31,278
42100,Ngozi,1,Entire home/apt,73,43,0.61,116
42101,Yuval,3,Private room,42,37,0.79,79
42102,Yuval,3,Private room,42,225,0.86,267
42103,Natalya,5,Entire home/apt,150,85,3.79,235
42110,Ekaterina,2,Private room,45,37,0.3,82
42111,Peter,2,Entire home/apt,300,112,2.83,412
42112,William,1,Entire home/apt,105,0,2.56,105
42113,Larry,3,Entire home/apt,135,121,8.52,256
42114,Bel,1,Entire home/apt,200,0,0.79,200
42115,Bernadette,4,Private room,75,54,3.17,129
42116,Lauro,3,Entire home/apt,300,40,2.26,340
42117,Richardene,1,Entire home/apt,185,338,1.2,523
42118,Khaled,2,Private room,45,189,3.23,234
42119,Steven,1,Entire home/apt,199,103,2.97,302
42121,Alba,3,Entire home/apt,180,123,2.48,303
42122,Sebastian,2,Private room,80,160,3.42,240
42123,Brianna,1,Shared room,39,365,0.5,404
42124,Erick,1,Entire home/apt,113,35,0.84,148
42125,Miguel,1,Entire home/apt,234,51,6.69,285
42127,Lilly Rose,4,Private room,50,27,1.62,77
42131,Mj,1,Entire home/apt,120,311,0.75,431
42132,Jingyeong,3,Private room,55,152,1.82,207
42134,Sarah,1,Entire home/apt,170,8,0.7,178
42135,Amanda,2,Entire home/apt,189,60,3.51,249
42136,Yuval,3,Private room,42,311,0.86,353
42137,Yuval,3,Private room,45,309,1.0,354
42139,Brigitte,2,Entire home/apt,175,301,4.0,476
42140,Luca,2,Entire home/apt,130,121,0.48,251
42141,Yogi,1,Private room,94,55,5.9,149
42143,Samantha,2,Entire home/apt,375,242,2.0,617
42146,Hiroki,1,Private room,27,32,0.77,59
42147,James R,1,Private room,125,139,2.0,264
42148,July,2,Private room,60,95,0.67,155
42149,Joanna,2,Entire home/apt,250,122,1.0,372
42150,Samantha,2,Entire home/apt,175,0,1.2,175
42151,Gina,2,Entire home/apt,50,0,0.28,50
42152,Jean-Paul,2,Private room,72,311,1.11,383
42153,Karin,2,Entire home/apt,160,68,1.49,228
42154,Christopher,3,Private room,35,54,2.73,89
42155,Frederic,1,Private room,80,177,4.21,257
42156,Ramón Emilio,2,Private room,55,12,6.11,67
42157,Marcelo,2,Private room,75,227,4.51,302
42159,Karina,2,Shared room,30,27,1.89,57
42162,Melissa,2,Private room,55,45,5.2,100
42163,Colton,2,Private room,40,0,0.3,40
42164,Michael,1,Entire home/apt,150,33,2.24,183
42166,Jessica,1,Private room,80,0,2.38,80
42167,Forum,1,Entire home/apt,111,0,1.39,111
42168,Min,1,Private room,82,364,0.51,446
42169,Sonder (NYC),1,Entire home/apt,262,113,2.35,375
42170,Sonder (NYC),1,Entire home/apt,244,133,2.31,377
42171,Sonder (NYC),1,Entire home/apt,240,105,1.95,345
42173,Abraham,3,Entire home/apt,110,309,1.54,419
42174,Anika,2,Private room,50,0,2.98,50
42175,Maria,2,Private room,38,365,2.46,403
42176,Noel,3,Private room,33,208,6.46,241
42178,Anna,1,Entire home/apt,220,233,2.23,453
42180,Shel,1,Entire home/apt,123,0,0.65,123
42181,Nina,2,Private room,50,13,3.13,63
42182,Brianna,1,Shared room,39,345,1.0,384
42184,Glen,2,Private room,100,360,1.85,460
42185,Glen,2,Private room,110,354,2.54,464
42186,Blake,2,Entire home/apt,250,179,1.15,429
42187,Vinicius,3,Private room,85,208,3.71,293
42188,Northern Star Realty,3,Entire home/apt,85,145,1.69,230
42189,Hong,1,Private room,80,0,2.5,80
42190,Antony,2,Shared room,30,0,0.86,30
42192,William,1,Private room,45,205,5.95,250
42193,Jean,3,Private room,70,89,1.61,159
42194,Eugenia,2,Private room,44,12,1.29,56
42195,Joyce,1,Entire home/apt,181,22,4.21,203
42197,Rosalina,1,Private room,65,125,2.0,190
42198,Tina,3,Private room,70,89,2.95,159
42199,Shoshana,1,Entire home/apt,650,339,0.6,989
42201,Louis,2,Private room,51,0,0.25,51
42204,Ananth,1,Private room,140,11,2.73,151
42205,Ragini,3,Entire home/apt,170,60,0.52,230
42207,Deborah,3,Private room,79,85,0.55,164
42208,Lucca & Paula,3,Shared room,36,313,2.36,349
42209,Qing,1,Entire home/apt,145,0,1.74,145
42211,Joselyn,3,Private room,55,180,2.35,235
42212,Diego,1,Entire home/apt,149,151,3.03,300
42213,Rebecca,2,Entire home/apt,99,0,2.03,99
42214,William,1,Private room,45,227,4.88,272
42215,Anchor,2,Shared room,28,89,1.5,117
42216,Kelsey,2,Private room,55,5,0.43,60
42217,Jasmine,1,Entire home/apt,400,95,6.2,495
42218,Christina,3,Private room,115,90,1.05,205
42219,Yany,4,Private room,39,49,1.57,88
42221,Gerrod & Rebecca,1,Entire home/apt,158,70,5.05,228
42222,Tirinda,2,Entire home/apt,175,40,3.13,215
42223,Anna,1,Entire home/apt,300,247,7.13,547
42224,Jeff,2,Entire home/apt,150,159,0.77,309
42225,Julia,4,Private room,95,359,1.65,454
42226,Todd,2,Entire home/apt,140,227,2.33,367
42228,Sol,3,Private room,28,14,6.49,42
42229,Todd,1,Entire home/apt,145,6,3.55,151
42230,Nalya,2,Private room,60,158,0.51,218
42231,Shai,1,Private room,80,50,2.4,130
42232,Yuki,2,Private room,52,23,2.0,75
42233,Elena,1,Entire home/apt,145,34,3.17,179
42234,Yuki,2,Private room,48,28,1.91,76
42236,Sebastian,2,Private room,50,4,1.33,54
42237,Juan,4,Entire home/apt,101,46,3.4,147
42238,Abrm,3,Private room,62,25,2.1,87
42239,Andrew,1,Entire home/apt,175,5,1.4,180
42240,Jovid,4,Private room,55,358,2.67,413
42241,Helio,3,Private room,60,115,1.0,175
42243,Erica,2,Entire home/apt,145,30,5.18,175
42244,Linn,1,Entire home/apt,140,0,1.4,140
42246,Hiroki,1,Private room,33,32,0.79,65
42247,D,1,Private room,75,155,2.02,230
42248,Denise,5,Private room,63,179,2.65,242
42249,Sharon & Erika,4,Private room,62,229,6.36,291
42250,Sharon & Erika,4,Private room,65,183,1.9,248
42251,Gia,1,Entire home/apt,199,237,1.91,436
42252,Sharon & Erika,4,Private room,150,247,8.37,397
42253,Lindsey,1,Entire home/apt,130,2,1.82,132
42254,Tk,1,Entire home/apt,190,365,0.63,555
42255,Jamika,1,Private room,100,175,1.88,275
42257,Eugene,1,Private room,50,64,4.18,114
42258,Paramount Hotel,1,Private room,339,364,6.59,703
42259,Ramon,2,Entire home/apt,129,14,0.24,143
42260,Rep,2,Entire home/apt,200,2,2.67,202
42261,Karan,2,Private room,76,0,1.72,76
42263,Sonder (NYC),1,Entire home/apt,231,82,1.32,313
42264,Ben,1,Entire home/apt,300,104,2.44,404
42265,Xian,4,Private room,140,365,0.97,505
42267,Lauren,3,Entire home/apt,300,2,1.0,302
42268,Mel,1,Private room,63,188,1.0,251
42269,Elad,3,Entire home/apt,65,0,0.67,65
42270,Ang,1,Entire home/apt,290,149,3.96,439
42271,Allison,2,Private room,59,64,0.28,123
42273,Kathleen,2,Private room,40,89,1.35,129
42274,John,4,Private room,80,70,1.84,150
42276,Paulina,3,Shared room,35,11,2.66,46
42279,Aviel,1,Entire home/apt,250,0,0.24,250
42280,Lacey,1,Entire home/apt,225,1,1.24,226
42281,Rhykel & Glenny,2,Entire home/apt,135,297,5.56,432
42282,Nick,1,Entire home/apt,168,47,1.85,215
42283,Morgan,1,Entire home/apt,250,32,3.16,282
42284,Ronald And Cookie,4,Private room,50,132,3.59,182
42285,Ravi,1,Private room,125,36,3.96,161
42286,Ronald And Cookie,4,Private room,50,117,4.96,167
42287,Keith,2,Private room,70,142,4.7,212
42288,Eddie,2,Entire home/apt,110,243,2.16,353
42289,Donna,2,Entire home/apt,180,280,3.37,460
42290,Erica,1,Entire home/apt,300,192,2.96,492
42291,Shubham,1,Entire home/apt,489,81,2.68,570
42292,Jimmy,1,Private room,69,2,0.93,71
42293,Melanie,1,Shared room,53,297,0.59,350
42294,Tia,1,Private room,99,13,1.13,112
42295,Yogi,1,Private room,115,37,6.63,152
42297,Yogi,1,Private room,69,35,6.43,104
42298,John,1,Private room,99,318,1.69,417
42299,Aurora,2,Private room,42,5,1.3,47
42300,Svetlana,1,Entire home/apt,220,135,1.94,355
42301,Alex,2,Private room,65,25,3.25,90
42302,Frank,3,Private room,40,75,2.42,115
42303,Christiana,2,Private room,105,0,3.87,105
42304,Felix,3,Private room,79,37,3.95,116
42305,Alexandra,2,Private room,60,197,0.82,257
42307,Hadass,2,Entire home/apt,95,0,2.5,95
42308,Diana Carolina,3,Private room,45,294,3.67,339
42309,Anastasia,2,Entire home/apt,139,209,4.96,348
42310,Claire,2,Private room,56,0,1.86,56
42311,Steven,1,Private room,55,1,0.97,56
42312,Clara,2,Private room,68,0,2.23,68
42313,Sonder (NYC),1,Entire home/apt,221,354,2.78,575
42314,Daniel,2,Private room,58,70,7.03,128
42315,Waqas,2,Private room,40,37,0.83,77
42316,Sunny,3,Entire home/apt,189,51,2.68,240
42317,Waqas,2,Private room,40,151,5.05,191
42318,Andrea,1,Entire home/apt,250,0,0.38,250
42319,Serena,3,Entire home/apt,135,178,3.13,313
42320,Jacqueline,3,Private room,55,37,2.0,92
42322,Amber,1,Private room,100,220,7.88,320
42323,Paramount Hotel,1,Private room,324,331,5.42,655
42325,Ilya,3,Entire home/apt,95,329,4.51,424
42326,Carly,1,Private room,75,0,0.89,75
42327,Kat,3,Entire home/apt,140,3,0.47,143
42328,James And Laureta,2,Entire home/apt,90,63,3.59,153
42329,James And Laureta,2,Entire home/apt,90,55,3.39,145
42330,Renzo,2,Entire home/apt,223,310,4.47,533
42331,Sean,2,Private room,150,267,1.26,417
42332,Denise,2,Private room,70,308,1.54,378
42333,Steve,1,Private room,45,35,0.34,80
42334,Paul,1,Entire home/apt,260,212,4.24,472
42335,Stefany,2,Private room,53,83,5.32,136
42337,George & Diana,3,Entire home/apt,140,79,4.21,219
42339,Helena,2,Shared room,25,32,1.95,57
42340,James And Laureta,2,Entire home/apt,104,48,3.66,152
42341,Bret,1,Private room,95,7,3.5,102
42342,James And Laureta,2,Entire home/apt,90,50,2.42,140
42343,Artez,1,Entire home/apt,150,0,1.98,150
42344,Keegan,2,Private room,50,12,7.01,62
42345,Kate,2,Entire home/apt,300,4,0.42,304
42347,Janet,1,Private room,375,179,1.13,554
42349,Dominique,1,Entire home/apt,325,176,2.53,501
42350,Georgiana,1,Entire home/apt,175,19,2.44,194
42351,Gedan,3,Private room,33,189,0.74,222
42352,Gonzalo And Nora,3,Entire home/apt,170,336,2.79,506
42356,Helena,2,Shared room,38,31,0.81,69
42357,Anne,1,Private room,110,0,3.65,110
42358,Yuki,2,Private room,42,23,0.76,65
42359,Madison,1,Entire home/apt,197,2,3.0,199
42360,Mia,2,Entire home/apt,160,350,0.41,510
42361,Sebastian,2,Private room,80,154,5.5,234
42362,David,2,Private room,48,242,5.04,290
42365,Stacey,1,Private room,200,0,2.4,200
42366,Evelyn,3,Entire home/apt,130,24,0.5,154
42367,Arielle,2,Entire home/apt,400,351,2.63,751
42368,Shai,1,Private room,90,8,0.25,98
42369,Raya,2,Shared room,50,177,0.25,227
42370,Kynara,2,Private room,45,37,1.28,82
42371,Kelly,2,Private room,55,0,2.56,55
42372,Danielle,1,Entire home/apt,180,0,2.31,180
42373,Antwoine,2,Private room,239,364,0.58,603
42374,Jay/Carolina Bastidas Family,2,Private room,50,365,0.52,415
42375,Vinicius,3,Private room,50,220,3.71,270
42376,Kristin,2,Entire home/apt,149,170,1.0,319
42377,Angelo,2,Private room,33,188,0.75,221
42378,Valerie,5,Private room,100,365,1.0,465
42380,Krista,1,Private room,64,48,3.78,112
42381,Erdi,3,Shared room,30,320,4.12,350
42382,Angela,2,Private room,35,66,8.02,101
42383,Joseph,1,Private room,68,94,7.69,162
42384,Kamila,1,Shared room,44,324,0.79,368
42385,Alexandra,2,Private room,60,189,0.54,249
42386,Sonder (NYC),1,Entire home/apt,177,343,1.0,520
42387,Diego,2,Entire home/apt,50,0,2.47,50
42391,Karla,4,Private room,39,176,3.38,215
42392,Kirk,1,Entire home/apt,219,292,4.46,511
42393,Anthony,2,Entire home/apt,80,317,0.5,397
42394,Ronald,3,Private room,70,88,1.6,158
42397,Elena,2,Private room,50,0,0.88,50
42398,Víctor,2,Private room,60,316,2.22,376
42400,Melinda,4,Private room,50,265,1.84,315
42401,Elise,2,Private room,95,0,1.58,95
42402,Edwin,3,Entire home/apt,260,32,5.0,292
42403,Silvia,2,Entire home/apt,159,10,5.78,169
42404,Jonathan,5,Private room,55,61,1.11,116
42405,Gloria,1,Private room,120,275,3.0,395
42406,Gk,2,Entire home/apt,135,271,3.59,406
42407,Alex,1,Entire home/apt,325,304,4.57,629
42408,Alexa,2,Entire home/apt,190,86,2.94,276
42409,Linden & Bah,1,Private room,52,365,1.0,417
42410,Chris,2,Private room,60,9,3.64,69
42411,Matthew,1,Entire home/apt,199,5,0.26,204
42413,Frank,3,Private room,45,64,1.74,109
42414,Grinis,2,Private room,60,89,0.57,149
42415,Genny,5,Private room,52,365,0.93,417
42416,Frank,3,Private room,45,66,1.54,111
42417,Elena,3,Private room,45,6,4.1,51
42418,Adrian,2,Private room,49,158,4.74,207
42419,Adrian,2,Private room,55,169,4.36,224
42420,Elena,3,Shared room,35,34,2.0,69
42421,Reynald,2,Private room,60,61,1.0,121
42422,Austin,1,Private room,65,72,2.07,137
42424,Miguel & Marisol,4,Entire home/apt,100,161,4.32,261
42425,William,1,Private room,45,217,5.95,262
42429,Ramiro & Jeff,1,Private room,140,45,1.67,185
42431,Tapashi,3,Private room,65,340,7.85,405
42434,Yudum,3,Private room,55,110,2.26,165
42435,Devin,1,Entire home/apt,128,16,2.0,144
42437,Shawn,1,Entire home/apt,180,32,1.54,212
42438,Raj,3,Entire home/apt,115,66,5.95,181
42440,Daniel,2,Private room,65,88,0.28,153
42441,Dawn,2,Entire home/apt,115,46,1.29,161
42442,Daniela,2,Entire home/apt,150,342,3.62,492
42443,Miguel & Marisol,4,Entire home/apt,100,145,4.78,245
42444,Doreshia,3,Entire home/apt,122,81,3.0,203
42446,Frank,3,Private room,39,58,5.64,97
42447,Jess & Ben,2,Private room,35,24,1.0,59
42448,Bobby,2,Private room,59,0,1.24,59
42449,Sonia,3,Private room,30,135,4.84,165
42452,Vic,1,Entire home/apt,175,64,5.5,239
42453,Sergo,1,Entire home/apt,325,346,4.21,671
42454,Dion,3,Private room,115,304,2.26,419
42455,Eric,2,Entire home/apt,120,126,2.29,246
42459,Angie,3,Entire home/apt,131,319,2.87,450
42461,Harkiran,1,Private room,100,0,1.29,100
42462,Will,3,Entire home/apt,66,0,0.85,66
42463,L.Anouk,1,Entire home/apt,190,24,2.7,214
42465,Veronica Gallardo,1,Entire home/apt,220,189,0.75,409
42466,Sara,1,Entire home/apt,165,75,3.03,240
42467,Kayla,2,Private room,99,47,2.75,146
42468,Roda,1,Shared room,65,35,2.07,100
42469,Diego,2,Entire home/apt,70,0,4.09,70
42471,Brian,1,Private room,145,42,5.43,187
42472,Moises,1,Private room,90,254,6.0,344
42473,Malika,2,Entire home/apt,100,246,2.17,346
42474,Moises,1,Private room,90,238,5.74,328
42475,R.Henry,1,Shared room,65,206,3.68,271
42476,Arline,2,Private room,175,61,2.14,236
42477,Nik,1,Entire home/apt,170,3,1.94,173
42482,Jeromy,2,Private room,90,0,2.05,90
42483,Brett,1,Private room,105,91,5.57,196
42484,Brett,1,Private room,230,53,0.67,283
42486,Steven,4,Private room,60,335,0.68,395
42487,Shay,2,Entire home/apt,170,157,1.3,327
42488,Mirta,2,Private room,65,119,0.63,184
42489,Stanislav,2,Private room,55,0,1.29,55
42490,Daniella,2,Entire home/apt,95,275,4.2,370
42491,Erik,4,Entire home/apt,107,339,6.8,446
42493,Portia,2,Shared room,35,344,0.37,379
42494,Paraskevi,1,Entire home/apt,199,49,1.88,248
42496,Emeline,1,Entire home/apt,200,72,1.09,272
42497,Mathew,1,Private room,50,65,3.42,115
42499,Tom,1,Entire home/apt,299,0,5.91,299
42500,Patrick,1,Private room,100,30,5.25,130
42501,Shai,1,Entire home/apt,185,92,0.59,277
42502,Anissa,3,Private room,50,225,2.07,275
42503,Joel,3,Private room,89,288,7.2,377
42504,Maria,4,Entire home/apt,90,321,1.38,411
42505,Geoff,1,Entire home/apt,200,319,2.03,519
42506,Sherry,3,Private room,80,352,1.55,432
42507,Christina,1,Entire home/apt,150,9,3.86,159
42508,Valerie,3,Private room,200,0,0.28,200
42509,Valerie,2,Entire home/apt,117,308,3.9,425
42510,Marina,2,Entire home/apt,117,15,1.29,132
42511,Joseph,2,Entire home/apt,180,38,1.51,218
42512,Elisha,1,Private room,150,36,2.57,186
42513,Austin,2,Private room,93,234,7.01,327
42514,David,1,Private room,75,58,5.28,133
42515,Anand,2,Private room,60,179,0.99,239
42516,Stephen,2,Private room,81,175,1.32,256
42517,Yury,2,Private room,70,4,0.37,74
42518,Jessica,1,Private room,79,0,3.23,79
42519,Alexander,2,Private room,21,90,1.02,111
42520,Ligel,4,Private room,35,241,7.08,276
42521,Martita,2,Private room,40,323,8.57,363
42522,Justin,1,Private room,80,312,0.77,392
42524,Jiali,3,Private room,75,126,2.94,201
42525,Richard,1,Entire home/apt,225,0,0.48,225
42527,Ita,2,Entire home/apt,168,190,3.44,358
42528,Luz,3,Private room,55,158,4.36,213
42531,Min,1,Private room,62,325,0.77,387
42533,Annie,2,Entire home/apt,200,0,3.0,200
42534,Min,1,Private room,62,310,0.71,372
42536,Ousmane,1,Private room,75,13,7.3,88
42537,Margie,2,Entire home/apt,200,157,1.06,357
42538,Ido,1,Entire home/apt,250,2,1.11,252
42540,Michelle,3,Private room,85,13,3.79,98
42541,Adam And Ana,1,Entire home/apt,195,174,4.59,369
42542,Sally,1,Entire home/apt,3613,158,1.0,3771
42543,Marshall,1,Entire home/apt,225,138,1.03,363
42544,Gúney,1,Shared room,75,365,5.17,440
42545,Yosub,2,Private room,90,9,0.63,99
42546,Gúney,1,Shared room,75,361,2.16,436
42547,Gúney,1,Shared room,75,361,1.7,436
42549,Gúney,1,Shared room,75,365,1.38,440
42550,Gúney,1,Shared room,75,363,2.33,438
42551,Alvise,2,Private room,75,0,2.43,75
42552,Lea,1,Private room,299,303,5.69,602
42554,Albeiro Y Katalina,3,Private room,35,150,0.78,185
42555,Roxanne,2,Private room,82,156,1.02,238
42556,Jorge,3,Private room,60,64,0.3,124
42559,Jillian,3,Private room,80,53,3.1,133
42561,Brian,1,Private room,75,80,2.31,155
42562,Kathy,1,Private room,86,115,2.84,201
42563,Adam,2,Entire home/apt,319,47,1.9,366
42564,Martita,2,Private room,100,356,0.39,456
42565,J.C & Johanna,2,Entire home/apt,260,45,6.43,305
42566,Petra,1,Private room,70,10,0.84,80
42567,Barry And Jimmy,1,Private room,100,38,4.57,138
42569,Max,1,Private room,50,9,1.97,59
42570,Diana And Peter,2,Private room,65,272,2.02,337
42571,Diana And Peter,2,Private room,65,347,1.32,412
42573,Rumana & Dan,3,Entire home/apt,125,288,3.68,413
42574,Flynn,1,Private room,249,91,3.45,340
42575,Jeyruth,1,Private room,93,0,0.75,93
42576,Sam,2,Entire home/apt,400,278,5.34,678
42577,Kristin,2,Entire home/apt,135,318,1.81,453
42578,Aidin,1,Entire home/apt,150,29,7.02,179
42579,Christine,1,Private room,50,4,4.55,54
42581,Andrey,1,Entire home/apt,250,21,1.59,271
42582,Malika,2,Entire home/apt,100,250,2.03,350
42583,Helena & Jim,1,Entire home/apt,168,30,5.22,198
42584,Mié,2,Private room,40,0,1.0,40
42585,Sharone,1,Private room,82,178,2.44,260
42586,Carla,2,Private room,85,1,4.05,86
42587,Anayah,1,Entire home/apt,160,1,2.58,161
42588,Lee,1,Entire home/apt,160,33,3.38,193
42589,Jessy,1,Private room,72,49,5.0,121
42590,Shelley,2,Entire home/apt,150,75,4.89,225
42591,Justin,1,Private room,80,260,1.25,340
42592,Jiali,3,Private room,60,125,4.94,185
42593,J. Westley,2,Private room,80,83,3.0,163
42594,Shae,1,Entire home/apt,150,10,1.59,160
42596,Chase,2,Private room,45,109,3.0,154
42597,Sergii,2,Shared room,35,341,0.26,376
42598,Bilikis,3,Private room,50,179,0.67,229
42600,Anton,1,Entire home/apt,195,203,5.1,398
42601,Lennon,1,Private room,83,0,0.33,83
42603,Janneth,3,Shared room,70,89,0.41,159
42604,Jeremy & Laura,1,Entire home/apt,260,343,0.46,603
42607,Sonder (NYC),1,Entire home/apt,520,262,2.43,782
42608,Brittany,2,Entire home/apt,300,59,0.98,359
42610,Tugce,1,Entire home/apt,175,270,1.52,445
42611,Jeremy & Laura,1,Entire home/apt,170,345,0.51,515
42613,Krista,1,Private room,73,35,3.72,108
42614,Rebekah,1,Private room,95,118,2.28,213
42615,Lukasz,3,Entire home/apt,100,323,0.77,423
42616,Sasha,1,Entire home/apt,160,90,4.34,250
42617,Leoluis,2,Private room,45,167,6.61,212
42620,Carly,1,Shared room,35,353,0.57,388
42621,Veronica,2,Entire home/apt,160,71,6.72,231
42623,Sergii,2,Shared room,35,341,0.35,376
42624,Jeannette,2,Private room,49,0,1.62,49
42625,Gloria,2,Entire home/apt,110,161,3.71,271
42626,Hayley,2,Entire home/apt,94,31,1.32,125
42629,Joseph,1,Entire home/apt,299,306,2.89,605
42630,Natasha,1,Private room,120,13,1.96,133
42632,Haley,1,Entire home/apt,204,6,1.36,210
42633,Ode,3,Private room,55,180,3.13,235
42634,Eugene,1,Entire home/apt,279,229,7.22,508
42635,Ana Maria,3,Private room,52,188,1.6,240
42636,Arkady,5,Entire home/apt,300,174,0.58,474
42637,Ammy,1,Entire home/apt,388,246,3.61,634
42638,Pouliasis,2,Private room,40,17,0.31,57
42639,Richard,1,Entire home/apt,195,24,3.87,219
42640,Anne,2,Private room,40,364,0.36,404
42642,Evelyn,1,Entire home/apt,400,102,0.65,502
42643,Gedan,3,Private room,45,113,2.67,158
42646,Laura,1,Private room,70,119,0.86,189
42649,Yuki,1,Entire home/apt,99,188,0.59,287
42651,Ysa,4,Private room,24,0,0.68,24
42652,Greg,1,Entire home/apt,220,1,0.26,221
42653,Bendji,2,Private room,50,2,1.78,52
42654,Jiali,3,Private room,39,133,8.62,172
42655,Sean,1,Entire home/apt,175,15,1.11,190
42656,Jay,1,Private room,70,260,1.14,330
42657,Yara,1,Entire home/apt,350,66,0.7,416
42658,Miguel,1,Entire home/apt,120,0,0.26,120
42659,Stella,1,Private room,129,85,3.53,214
42660,Pasang,3,Private room,50,262,0.51,312
42661,Guoxin,4,Entire home/apt,35,51,5.35,86
42662,Boho,2,Private room,45,135,1.88,180
42663,Michael,1,Private room,82,288,7.29,370
42664,Deo,1,Private room,180,123,0.51,303
42665,Tio,3,Entire home/apt,55,6,10.37,61
42666,Daniel,3,Private room,65,71,3.48,136
42667,Oliver,1,Private room,84,21,5.35,105
42668,Hoon J,1,Entire home/apt,150,255,2.38,405
42669,Ode,3,Private room,55,269,4.21,324
42670,Christopher,3,Private room,70,180,1.11,250
42672,Jerry,1,Entire home/apt,148,334,2.82,482
42674,Alex,2,Entire home/apt,285,16,3.0,301
42677,Gabriel,1,Entire home/apt,150,4,1.33,154
42678,Green,1,Entire home/apt,85,6,1.13,91
42679,Mark,2,Entire home/apt,75,8,3.56,83
42680,Shah,3,Entire home/apt,2600,362,1.73,2962
42681,Miriam,2,Entire home/apt,110,0,2.08,110
42682,Jessica,1,Private room,80,0,3.89,80
42684,Carolina,1,Entire home/apt,250,19,2.12,269
42685,Ginta,1,Entire home/apt,150,33,1.25,183
42686,Geoffrey,2,Entire home/apt,110,260,0.28,370
42687,Christina,2,Entire home/apt,122,12,0.77,134
42688,William,1,Entire home/apt,375,26,3.75,401
42689,Ilan,1,Entire home/apt,399,303,1.32,702
42690,Shayaa,2,Entire home/apt,201,296,7.58,497
42691,Isabella,1,Private room,150,351,1.65,501
42692,Jon,2,Entire home/apt,95,0,2.5,95
42693,Jesse,2,Private room,69,0,1.14,69
42694,Mike,1,Entire home/apt,75,13,0.77,88
42695,Pedro,4,Entire home/apt,103,75,5.7,178
42696,Melissa,2,Entire home/apt,150,92,0.78,242
42697,Frampton,2,Private room,46,130,2.04,176
42698,Adam,2,Private room,95,80,5.11,175
42700,Drake,1,Entire home/apt,199,125,2.89,324
42702,Douglas And Juthamas,3,Private room,62,313,4.53,375
42703,Eric,3,Private room,65,7,2.0,72
42704,Javier,2,Entire home/apt,85,7,2.65,92
42705,Yu Qun,3,Entire home/apt,109,0,1.15,109
42706,Ally,2,Entire home/apt,90,0,0.94,90
42707,Barry,2,Entire home/apt,175,196,1.64,371
42708,Rebecca,1,Entire home/apt,190,84,0.88,274
42709,Katalin,2,Entire home/apt,170,1,1.22,171
42710,Inna,1,Entire home/apt,130,14,3.4,144
42711,David,2,Entire home/apt,600,44,2.96,644
42712,Laura,2,Entire home/apt,100,0,1.61,100
42713,Santiago,2,Entire home/apt,150,6,0.46,156
42715,Jason,1,Entire home/apt,290,75,2.26,365
42716,Brenda,2,Entire home/apt,110,339,2.28,449
42718,Tenzin,3,Private room,53,79,4.49,132
42720,Cara,1,Entire home/apt,200,3,1.54,203
42721,Filiz,1,Entire home/apt,180,40,4.77,220
42722,Karen,3,Entire home/apt,80,176,1.0,256
42723,Emily,1,Entire home/apt,260,274,2.73,534
42724,Inna,1,Entire home/apt,190,310,0.45,500
42726,Cecilia,2,Private room,75,177,2.83,252
42727,Gabriel,3,Entire home/apt,100,296,3.3,396
42728,Jeremy,2,Private room,75,55,1.98,130
42729,Edgar,3,Private room,50,174,2.0,224
42730,Paolo,1,Entire home/apt,125,46,0.68,171
42731,Rafael,3,Entire home/apt,95,81,4.4,176
42735,Johanna,4,Entire home/apt,125,336,5.77,461
42737,Filiz,1,Entire home/apt,180,87,6.0,267
42738,Filiz,1,Entire home/apt,165,102,6.83,267
42739,Ed,2,Entire home/apt,85,347,0.31,432
42740,Dan & Bliss,2,Entire home/apt,199,67,3.0,266
42741,Samantha,2,Private room,90,0,0.71,90
42744,Leanne,2,Private room,65,3,1.29,68
42745,Carissa,2,Private room,45,87,5.05,132
42746,Ousmane,1,Private room,70,9,6.76,79
42748,Vanessa,2,Private room,60,22,2.76,82
42749,Melat,2,Private room,65,124,1.15,189
42750,Raanan,1,Entire home/apt,130,148,1.0,278
42751,Christopher,2,Entire home/apt,135,162,3.86,297
42753,Janet,1,Private room,399,364,0.81,763
42754,Joy,2,Private room,75,166,8.02,241
42755,Yezica,2,Entire home/apt,89,0,3.28,89
42756,Lauren And Jeff,2,Entire home/apt,250,183,2.44,433
42758,Víctor,1,Private room,58,0,1.03,58
42759,Natalli,1,Entire home/apt,700,282,3.93,982
42760,Thia,4,Private room,120,268,0.32,388
42761,Jay,1,Private room,100,275,1.6,375
42762,Jay,1,Private room,85,150,2.61,235
42763,Ana,1,Entire home/apt,215,188,0.3,403
42765,Sam,2,Entire home/apt,150,88,0.39,238
42766,Nadia,1,Private room,85,0,1.76,85
42768,T. S.,1,Private room,98,327,4.35,425
42769,Max,1,Private room,293,75,3.18,368
42771,Saman,2,Private room,65,20,1.94,85
42772,Martha,5,Entire home/apt,85,316,2.2,401
42773,Jay,2,Private room,120,89,0.59,209
42774,Lily,2,Private room,69,345,0.28,414
42775,Danny,4,Private room,63,167,0.94,230
42777,Danalee,2,Private room,58,126,2.0,184
42779,Norma-Jean,2,Private room,41,79,1.86,120
42782,Joie,4,Private room,39,15,2.73,54
42783,Izi,1,Entire home/apt,180,325,0.47,505
42786,Ivy,2,Private room,44,163,2.37,207
42787,Sonder (NYC),1,Entire home/apt,177,354,0.85,531
42788,Ivy,3,Private room,49,165,4.08,214
42789,Ivy,3,Private room,44,128,3.13,172
42790,Ivy,3,Private room,44,154,3.18,198
42791,Chase,1,Private room,149,0,3.78,149
42792,Claudia,3,Entire home/apt,300,319,3.27,619
42793,Veronika,3,Entire home/apt,140,192,4.29,332
42794,Malik,2,Private room,35,4,0.47,39
42796,Michelle,2,Entire home/apt,75,24,1.33,99
42797,Geli,1,Private room,90,24,3.53,114
42798,Jean Paul,2,Private room,74,72,0.28,146
42799,Leonora,1,Entire home/apt,396,317,4.84,713
42800,Neha,2,Private room,70,2,1.63,72
42801,Jay,1,Private room,100,324,0.78,424
42802,Jay,1,Private room,100,315,1.58,415
42803,Jay,1,Private room,100,324,2.33,424
42804,Jay,1,Private room,180,323,1.94,503
42805,Manuel Ricardo,1,Entire home/apt,220,297,3.03,517
42806,Angelle,2,Entire home/apt,195,20,2.42,215
42807,Luda,3,Entire home/apt,75,43,1.22,118
42808,Hosteeva,1,Entire home/apt,310,0,0.7,310
42809,Emily,2,Entire home/apt,300,341,6.23,641
42810,Lily,1,Private room,85,339,3.36,424
42811,Lily,1,Private room,85,356,4.17,441
42812,Mala,2,Private room,65,43,3.42,108
42814,David,3,Private room,50,128,1.84,178
42815,Mohsin,5,Entire home/apt,78,38,3.88,116
42818,Mohsin,5,Private room,50,52,2.02,102
42820,Lily,1,Private room,85,332,3.93,417
42821,Norma-Jean,2,Private room,41,74,2.08,115
42822,Rachel,1,Entire home/apt,144,0,2.0,144
42823,Rita,3,Private room,69,349,1.0,418
42824,Mariana,1,Entire home/apt,230,83,0.57,313
42825,Eric,2,Private room,69,179,0.67,248
42826,Shana,2,Private room,40,22,2.84,62
42827,Lissa,1,Entire home/apt,151,7,3.0,158
42828,Danese,1,Entire home/apt,275,351,0.46,626
42829,Maria,1,Entire home/apt,180,188,2.79,368
42830,Danese,1,Private room,55,353,0.67,408
42831,Lisa,1,Private room,120,35,3.91,155
42833,Inbar,1,Private room,60,26,2.53,86
42834,Jiali,3,Private room,75,204,2.52,279
42835,Jernej,3,Private room,110,112,4.57,222
42836,Emily,1,Private room,129,15,3.08,144
42837,Emily,1,Private room,129,0,1.0,129
42838,"Tommy, Nate, And Kofi",2,Private room,55,89,3.53,144
42839,Katarina,1,Private room,217,242,1.94,459
42841,Leonard,1,Entire home/apt,299,217,0.54,516
42842,Patrice,2,Entire home/apt,120,52,4.12,172
42844,Julie,2,Entire home/apt,135,266,5.19,401
42845,Mika,2,Private room,75,0,0.67,75
42847,Jaclyn,1,Private room,159,302,2.56,461
42848,Andrew,2,Entire home/apt,100,13,1.67,113
42849,Tara,1,Entire home/apt,100,270,3.24,370
42851,Kim,3,Private room,85,330,3.56,415
42852,Tyrone,2,Private room,45,67,0.73,112
42853,Sherika,2,Private room,75,0,2.62,75
42855,Amber,2,Private room,45,82,2.41,127
42856,Tricia,2,Entire home/apt,135,296,4.0,431
42857,Nobin,3,Entire home/apt,71,0,3.19,71
42859,Alexis,2,Private room,70,0,0.49,70
42860,Eric,1,Entire home/apt,165,97,2.61,262
42862,Viktoriya,5,Entire home/apt,55,0,0.82,55
42864,Marietta,2,Entire home/apt,125,48,1.67,173
42867,Yotel,1,Private room,197,342,0.57,539
42869,Yotel,1,Private room,166,345,0.43,511
42872,Yotel,1,Private room,500,305,1.0,805
42873,Jenn,2,Private room,90,0,0.97,90
42874,Erin,2,Entire home/apt,140,13,1.58,153
42877,Mj,1,Private room,200,22,0.41,222
42879,Beatriz,3,Entire home/apt,190,255,2.56,445
42880,Angela,1,Shared room,35,353,0.59,388
42881,Elise,2,Entire home/apt,125,70,2.23,195
42882,Vivi,1,Entire home/apt,280,325,2.4,605
42883,Stratis,2,Entire home/apt,249,38,4.19,287
42884,John,1,Entire home/apt,200,323,3.96,523
42886,Karina,1,Private room,124,155,2.28,279
42887,Bani,1,Entire home/apt,120,14,5.0,134
42888,Karina,1,Private room,125,117,2.7,242
42891,Pro,1,Private room,95,5,1.0,100
42893,Jessica,1,Private room,105,0,2.4,105
42894,Bridgette,2,Entire home/apt,214,32,1.94,246
42896,Cristina,1,Private room,32,280,8.48,312
42897,Anthony,1,Entire home/apt,160,21,5.59,181
42898,Sean,2,Entire home/apt,165,272,1.97,437
42899,Taylor,1,Entire home/apt,300,363,1.22,663
42903,Justin & Lilo,2,Private room,75,114,7.5,189
42904,Michael,1,Private room,111,344,2.58,455
42905,Brandon & Caitlyn,2,Private room,150,48,2.66,198
42906,Brigitte,1,Entire home/apt,175,2,0.68,177
42907,Samantha,1,Entire home/apt,180,10,2.5,190
42908,Cheikh,1,Entire home/apt,165,53,2.58,218
42909,May,1,Entire home/apt,395,167,2.73,562
42910,Jonathan,2,Private room,90,0,0.9,90
42913,Nathan,2,Entire home/apt,225,11,1.29,236
42914,Guy,1,Entire home/apt,250,188,0.97,438
42917,Adi,2,Entire home/apt,150,0,0.67,150
42919,Shana,2,Private room,40,26,4.57,66
42920,Arlene,2,Entire home/apt,336,97,5.87,433
42921,Anna,1,Entire home/apt,320,236,1.72,556
42922,Jill Lauren,1,Entire home/apt,150,61,4.24,211
42923,Martin,1,Entire home/apt,250,0,0.43,250
42924,Jaime,4,Private room,46,179,1.13,225
42926,Michael,1,Private room,75,74,5.27,149
42927,Kay,3,Private room,60,84,0.96,144
42928,Kelly,2,Entire home/apt,400,89,0.46,489
42929,Peggy,1,Entire home/apt,208,170,0.61,378
42932,Julie,2,Private room,72,0,3.93,72
42933,Tanya,1,Private room,90,0,0.67,90
42934,Regine,3,Entire home/apt,70,0,0.38,70
42935,Chy,2,Entire home/apt,220,230,2.9,450
42936,Yanina,1,Entire home/apt,200,127,1.15,327
42938,Avery,2,Entire home/apt,140,4,1.58,144
42939,Mohamed,2,Entire home/apt,80,16,1.03,96
42941,Jonah,2,Entire home/apt,65,4,1.94,69
42942,Lucio,3,Private room,75,89,9.21,164
42943,Stella,1,Entire home/apt,125,0,3.96,125
42944,Kay,3,Private room,75,89,3.13,164
42947,Maria,3,Private room,55,162,2.86,217
42949,Marcia,3,Private room,60,323,1.91,383
42950,David,1,Entire home/apt,450,361,1.13,811
42952,Ben,2,Entire home/apt,163,263,0.79,426
42954,Alex,2,Private room,75,0,2.11,75
42955,Nuttamon,1,Private room,196,336,3.53,532
42956,Nuttamon,1,Entire home/apt,174,324,1.88,498
42957,Nicholas,2,Entire home/apt,295,0,0.32,295
42958,Alex,4,Entire home/apt,60,74,8.32,134
42959,Seth,2,Private room,100,44,0.59,144
42960,Feigy,2,Entire home/apt,199,178,1.46,377
42963,Jeromy,2,Private room,50,0,1.05,50
42965,Chris,1,Entire home/apt,595,80,2.28,675
42966,L,1,Entire home/apt,185,137,1.69,322
42967,Cristian,4,Private room,35,62,1.2,97
42969,Nikolay,2,Entire home/apt,80,0,0.29,80
42971,Yurany,3,Private room,45,32,5.05,77
42972,Miriam,2,Entire home/apt,110,0,2.79,110
42973,Monika,3,Entire home/apt,109,52,1.0,161
42974,Lina,1,Entire home/apt,180,20,1.47,200
42976,Andrey,1,Entire home/apt,245,13,3.24,258
42977,Vanieta,2,Entire home/apt,150,40,2.17,190
42979,Emanuel,1,Entire home/apt,139,74,0.89,213
42980,Liz,1,Entire home/apt,130,63,0.75,193
42981,Corina E.,1,Private room,228,341,0.96,569
42982,Corina E.,1,Entire home/apt,236,341,1.46,577
42984,Medena,1,Private room,97,77,3.85,174
42985,Zahir,3,Private room,55,171,8.44,226
42987,Linda,2,Private room,49,226,2.17,275
42988,Linda,2,Private room,49,250,2.93,299
42989,Einstein,2,Private room,65,64,1.97,129
42990,Lorena,2,Private room,50,0,0.33,50
42991,Ken,2,Entire home/apt,110,1,2.63,111
42993,Linda,2,Private room,49,254,4.23,303
42994,Liz,4,Entire home/apt,150,78,2.07,228
42995,Zahir,3,Private room,55,168,7.13,223
42996,Mike,1,Entire home/apt,195,0,3.75,195
42997,David,1,Private room,75,75,2.64,150
42998,Zahir,3,Private room,55,162,6.47,217
42999,Demir,1,Shared room,59,358,2.91,417
43000,Demir,1,Shared room,59,362,2.04,421
43001,Zahir,3,Private room,55,153,12.12,208
43004,Nico,1,Private room,48,0,0.75,48
43005,Erin,1,Entire home/apt,300,4,1.4,304
43006,Ari,2,Private room,55,0,1.15,55
43007,Joe,1,Entire home/apt,560,335,0.31,895
43008,Linda,2,Private room,52,268,3.42,320
43009,Debra,1,Entire home/apt,5100,343,1.0,5443
43010,Arnaud,1,Private room,65,292,5.29,357
43011,Nick,3,Private room,89,68,1.88,157
43012,Janelle,3,Private room,39,157,1.45,196
43014,Mohamad,5,Private room,65,35,2.62,100
43015,Charn,2,Entire home/apt,150,313,2.17,463
43016,Yun,1,Private room,169,365,0.53,534
43017,Yun,1,Private room,169,365,0.65,534
43018,John,2,Private room,70,76,5.13,146
43019,Yun,1,Private room,169,358,0.57,527
43020,Eden,2,Private room,65,320,2.93,385
43022,Nicole,1,Entire home/apt,380,0,0.74,380
43023,Jesse,1,Entire home/apt,300,16,3.16,316
43024,Randy,2,Entire home/apt,120,8,2.42,128
43025,Tomasz,3,Entire home/apt,200,178,0.93,378
43026,Lucy,1,Entire home/apt,285,215,1.8,500
43027,Amber,2,Entire home/apt,175,26,1.36,201
43028,Yun,1,Private room,169,323,1.97,492
43029,彼特,3,Private room,60,0,0.77,60
43030,Yogi,3,Entire home/apt,70,53,0.3,123
43031,Yun,1,Private room,169,358,0.95,527
43032,Yun,1,Private room,169,344,0.81,513
43033,Yun,1,Private room,169,358,1.0,527
43036,Yun,1,Private room,169,365,1.0,534
43037,Luke,1,Private room,90,282,0.97,372
43038,Luke,1,Private room,90,252,0.86,342
43039,Luke,1,Private room,90,258,0.6,348
43040,Luke,1,Private room,90,237,1.85,327
43041,Hamza,4,Entire home/apt,109,50,3.42,159
43042,Chris,1,Entire home/apt,144,12,7.98,156
43045,Alex,2,Private room,80,364,0.46,444
43046,Linda,2,Private room,58,261,5.19,319
43047,James,2,Private room,50,127,0.36,177
43048,Toni,2,Entire home/apt,89,194,0.92,283
43049,James,1,Entire home/apt,159,44,1.72,203
43050,Lana,3,Private room,60,318,4.34,378
43053,Trinize,4,Shared room,25,146,1.6,171
43054,Navin,1,Private room,120,55,3.33,175
43055,Victor,1,Entire home/apt,124,86,5.06,210
43056,Lana,3,Private room,70,308,2.54,378
43058,James,1,Entire home/apt,127,13,2.79,140
43059,Kieu,2,Private room,69,279,4.62,348
43060,Tyler,2,Private room,150,88,0.38,238
43061,Sebastian,2,Entire home/apt,295,3,2.9,298
43062,Fatima,1,Entire home/apt,800,364,0.59,1164
43063,Lincoln,1,Shared room,95,23,2.38,118
43064,Helena,2,Shared room,32,31,1.78,63
43065,Lorenzo,1,Private room,70,128,1.22,198
43066,Joe,1,Entire home/apt,180,193,1.76,373
43067,Leah,2,Private room,74,49,5.4,123
43068,Yan,2,Private room,49,48,7.04,97
43069,Simone,1,Private room,81,291,1.3,372
43070,Monica,1,Entire home/apt,898,294,3.13,1192
43071,Abby,2,Shared room,25,0,1.05,25
43072,Dieudonne,4,Private room,100,345,2.0,445
43073,Jonah,1,Entire home/apt,230,0,0.82,230
43074,Viviana,3,Private room,59,361,1.88,420
43076,Tucker,2,Entire home/apt,100,0,1.58,100
43077,Owen,1,Shared room,45,90,5.64,135
43078,Tiba,1,Private room,138,95,2.79,233
43079,Pablo,2,Private room,60,48,3.94,108
43080,Errol,2,Private room,85,125,3.1,210
43081,Owen,1,Shared room,49,83,6.53,132
43082,Zac,1,Entire home/apt,160,9,5.23,169
43083,Owen,1,Shared room,45,72,5.1,117
43084,Owen,1,Shared room,60,90,2.4,150
43085,Owen,1,Shared room,55,89,3.86,144
43086,Owen,1,Shared room,45,83,4.16,128
43088,Dakota,2,Private room,69,59,0.29,128
43089,Miki,1,Private room,59,103,0.67,162
43090,Warren,1,Private room,87,365,2.5,452
43091,Eden,2,Private room,65,323,1.91,388
43092,Nicola,2,Private room,85,86,2.38,171
43093,Fikile,1,Entire home/apt,300,52,5.78,352
43094,International,2,Private room,55,295,4.47,350
43095,J,1,Shared room,70,0,1.38,70
43096,Lincoln,1,Shared room,95,23,1.96,118
43097,Alex,1,Entire home/apt,240,121,6.13,361
43098,Ryan,2,Private room,50,0,2.77,50
43099,Diana,2,Private room,65,0,0.35,65
43100,Lina,1,Entire home/apt,240,8,3.23,248
43101,Eunice,3,Private room,47,28,1.38,75
43102,Lina,1,Private room,120,11,0.89,131
43104,Juliet,1,Private room,200,327,1.97,527
43105,Roman,1,Entire home/apt,419,218,0.58,637
43106,Lincoln,1,Shared room,95,23,1.3,118
43107,Charlene,1,Private room,150,4,2.43,154
43108,Finely,3,Private room,55,0,0.34,55
43111,Chris,2,Entire home/apt,78,17,1.18,95
43113,Christof,2,Entire home/apt,167,80,4.62,247
43114,Kateryna And Tim,3,Private room,65,334,7.26,399
43115,Joseph,2,Private room,88,85,3.47,173
43116,D'Arcy,2,Private room,40,0,0.43,40
43118,Edgar,1,Private room,135,365,4.04,500
43119,Raymel,2,Private room,70,66,1.58,136
43120,Alice,2,Private room,109,0,0.35,109
43121,Lincoln,1,Shared room,95,21,1.2,116
43122,Lincoln,1,Shared room,95,19,2.22,114
43123,Mena,1,Private room,65,364,2.03,429
43124,Cindy,2,Private room,50,0,0.81,50
43125,Cindy,2,Private room,56,0,1.2,56
43126,Jessica,2,Entire home/apt,125,22,1.0,147
43127,Matthew,1,Entire home/apt,160,33,1.54,193
43128,Javier,2,Entire home/apt,99,300,6.07,399
43130,Thomas,1,Private room,950,251,4.23,1201
43132,Fana,2,Private room,45,337,5.0,382
43133,Kelly,2,Entire home/apt,327,49,3.0,376
43134,Tianna,3,Entire home/apt,110,81,3.16,191
43135,Lisa,3,Entire home/apt,190,132,10.0,322
43136,Mandisa,3,Entire home/apt,120,44,3.14,164
43137,Luz & Ruben,1,Entire home/apt,99,271,1.3,370
43138,Daniel & Neena,1,Entire home/apt,350,82,5.74,432
43139,Marion,3,Private room,50,61,11.21,111
43140,Jaye,1,Private room,80,172,1.3,252
43141,Luz & Ruben,1,Private room,57,225,1.0,282
43142,Katerina,2,Private room,38,0,1.0,38
43143,Melanie,1,Entire home/apt,140,74,0.42,214
43144,Filiz,1,Entire home/apt,165,83,5.93,248
43146,Nyneve,2,Entire home/apt,750,179,4.06,929
43148,Filiz,1,Entire home/apt,165,56,6.0,221
43149,Ruchi,1,Private room,50,283,0.6,333
43150,Stella,1,Private room,65,0,4.72,65
43151,Leonora,1,Private room,125,318,0.95,443
43152,Gladys Germania,3,Entire home/apt,250,359,4.15,609
43153,Habiba,3,Private room,50,66,0.32,116
43154,Melvis,2,Entire home/apt,115,74,6.55,189
43156,Mari,2,Private room,40,35,0.32,75
43157,Leonora,1,Private room,80,318,1.26,398
43158,Cathy,2,Entire home/apt,85,100,1.07,185
43159,Clara,2,Entire home/apt,120,0,1.15,120
43160,Jesse,1,Entire home/apt,300,20,2.88,320
43162,Sarah,2,Private room,80,22,1.79,102
43163,Leo,1,Entire home/apt,74,0,0.32,74
43164,Artem,1,Private room,60,20,1.95,80
43165,April G,2,Private room,100,94,0.7,194
43166,Teya,4,Private room,47,167,1.9,214
43167,Julie,2,Entire home/apt,245,35,1.29,280
43170,Young,3,Private room,65,36,4.06,101
43171,Gary,3,Entire home/apt,130,338,1.88,468
43172,Nuan,1,Entire home/apt,173,3,0.76,176
43173,Pablo,1,Entire home/apt,100,8,0.7,108
43174,Meike,2,Entire home/apt,120,15,0.41,135
43175,Derrick,1,Private room,105,9,6.71,114
43176,Kieu,2,Private room,72,316,4.74,388
43177,Kieu,2,Private room,79,351,4.17,430
43179,Noel,3,Private room,49,1,5.62,50
43180,Ellen,1,Entire home/apt,134,2,1.0,136
43181,Aaron,1,Private room,160,77,6.8,237
43182,Amy,1,Entire home/apt,140,27,2.88,167
43184,Rhonda,2,Private room,50,358,0.94,408
43185,Raquel,1,Private room,120,147,4.88,267
43186,Linda,2,Entire home/apt,155,270,4.92,425
43187,Jaime,1,Entire home/apt,260,139,4.47,399
43188,Connie,2,Entire home/apt,130,19,2.55,149
43190,Medena,1,Private room,89,54,3.51,143
43191,Modupe,3,Private room,42,352,3.09,394
43192,Stephen,1,Entire home/apt,159,152,5.11,311
43193,James Cem,1,Private room,70,1,1.65,71
43194,Dennis/Norma,4,Private room,50,350,0.81,400
43195,Neil,5,Entire home/apt,99,326,2.31,425
43198,Shahrath,3,Entire home/apt,99,236,2.93,335
43199,Bidhya,3,Private room,60,333,1.94,393
43200,Emilie,2,Private room,90,71,0.76,161
43202,Lori,1,Entire home/apt,106,3,0.94,109
43203,Jessica,3,Entire home/apt,115,311,0.77,426
43204,Linda,3,Private room,38,36,2.34,74
43206,Lidu,3,Private room,65,31,1.96,96
43207,Ronni,2,Private room,75,111,3.23,186
43209,Javier,1,Entire home/apt,275,123,0.7,398
43210,Yien,5,Entire home/apt,249,241,2.58,490
43211,Devin,1,Entire home/apt,799,247,2.38,1046
43214,Marion,2,Entire home/apt,90,7,1.18,97
43216,Adeola,3,Entire home/apt,600,332,1.58,932
43218,Vitória,2,Private room,58,213,2.47,271
43220,Noel,3,Private room,39,210,2.58,249
43221,Sophia,1,Entire home/apt,235,34,1.25,269
43222,Dee,1,Entire home/apt,182,19,5.0,201
43223,Eric,1,Entire home/apt,150,25,2.31,175
43224,Francesco,1,Entire home/apt,120,0,1.94,120
43225,Lisa,2,Entire home/apt,100,96,4.0,196
43227,Giovanina,3,Entire home/apt,90,0,2.66,90
43228,Sonder (NYC),1,Entire home/apt,194,303,1.27,497
43229,Josephine,2,Entire home/apt,145,45,0.86,190
43230,Sonder (NYC),1,Entire home/apt,470,272,1.88,742
43231,Sonder (NYC),1,Entire home/apt,247,272,3.42,519
43232,Adham,3,Private room,50,5,4.53,55
43234,Kelvin,2,Private room,80,0,0.65,80
43238,Leonora,1,Private room,80,15,0.31,95
43239,Carlton,1,Private room,62,172,2.21,234
43240,Rocco,2,Entire home/apt,171,48,3.0,219
43243,Janio,1,Entire home/apt,395,247,3.63,642
43244,Melissa,2,Private room,72,364,0.7,436
43245,Hanine,3,Private room,70,76,1.0,146
43246,Anthony,2,Private room,55,0,6.0,55
43247,Victoria,2,Entire home/apt,225,178,2.61,403
43248,Marcelo Y Lucio,3,Private room,57,156,6.32,213
43249,Jackie,1,Private room,99,191,4.74,290
43250,W. Jesse,4,Shared room,35,0,0.94,35
43251,Jackie,1,Private room,89,166,5.0,255
43252,Rubens,1,Private room,135,278,5.9,413
43253,Northern Star Realty,3,Entire home/apt,85,150,2.82,235
43254,Northern Star Realty,3,Entire home/apt,85,156,2.08,241
43255,John,3,Private room,60,264,1.15,324
43256,Bianca,2,Entire home/apt,60,0,1.53,60
43257,Toli,1,Entire home/apt,219,133,6.52,352
43258,Anne & Gary,1,Entire home/apt,442,253,4.5,695
43259,Inez,2,Entire home/apt,250,117,1.5,367
43260,Bharat,3,Entire home/apt,160,7,0.38,167
43261,Shelley,2,Entire home/apt,240,7,0.42,247
43266,Yullya,1,Entire home/apt,949,270,2.02,1219
43267,Jarrod,2,Private room,60,330,7.88,390
43268,Angeline,1,Entire home/apt,180,77,0.41,257
43269,Lùis,2,Private room,59,56,2.73,115
43270,Alex,1,Entire home/apt,300,306,4.52,606
43271,Juan,2,Entire home/apt,120,155,0.51,275
43272,Danny,2,Private room,39,58,4.5,97
43273,Syeda,3,Private room,50,358,4.53,408
43274,Pat,1,Private room,150,90,0.62,240
43275,Marcelo Y Lucio,3,Private room,51,180,3.96,231
43276,William,1,Private room,100,55,4.29,155
43277,German,2,Private room,60,0,0.81,60
43278,Jessi,2,Entire home/apt,250,10,1.85,260
43279,Marilyn,2,Private room,68,15,1.76,83
43280,Somaya,1,Entire home/apt,100,33,0.41,133
43282,Regina,3,Entire home/apt,98,292,0.31,390
43283,Artem,1,Entire home/apt,400,307,2.33,707
43284,Chuck,2,Entire home/apt,110,108,2.0,218
43285,Rafael,3,Private room,49,192,3.04,241
43286,Javanshir,1,Entire home/apt,300,313,3.91,613
43289,Eunice,2,Entire home/apt,113,101,2.55,214
43290,Sheila,2,Entire home/apt,55,232,2.21,287
43291,Khero,1,Entire home/apt,100,4,8.24,104
43292,Kyle,1,Entire home/apt,285,365,0.98,650
43293,Jewel,2,Private room,45,95,0.32,140
43294,Joyce,2,Entire home/apt,195,347,2.83,542
43295,Moncef,2,Entire home/apt,78,279,1.0,357
43296,Delsy,4,Private room,42,332,1.82,374
43298,Andrew,1,Private room,99,90,0.77,189
43299,Olga,2,Private room,47,323,0.45,370
43300,Marcelo Y Lucio,3,Private room,51,365,6.38,416
43301,Minnie,1,Entire home/apt,170,39,1.09,209
43303,James,1,Private room,125,0,0.67,125
43304,Julie Ann,5,Entire home/apt,115,339,1.0,454
43309,Leandro And Julia,2,Private room,50,23,1.0,73
43310,Leandro And Julia,2,Private room,57,9,3.81,66
43311,Albeiro Y Katalina,3,Shared room,43,91,0.33,134
43314,Bernard,2,Entire home/apt,160,162,2.0,322
43315,Pete,3,Entire home/apt,130,0,1.43,130
43316,Sonder (NYC),1,Entire home/apt,505,263,3.58,768
43318,Walker Hotel Greenwich Village,1,Private room,425,359,1.52,784
43319,Michaelle,2,Entire home/apt,150,30,7.27,180
43320,Wendy,2,Private room,50,9,9.07,59
43321,Haffro,1,Private room,62,284,4.84,346
43322,Thibault,1,Private room,380,24,0.38,404
43323,Mei,2,Private room,49,347,1.05,396
43324,Yaacov,1,Entire home/apt,206,311,1.0,517
43325,Omar,1,Entire home/apt,123,96,0.77,219
43326,Jia,1,Entire home/apt,145,7,2.5,152
43328,Candace,2,Private room,75,365,3.19,440
43329,Shannan,2,Entire home/apt,350,82,2.63,432
43330,Guy,2,Private room,76,5,1.89,81
43331,Samuel & Toluwani,3,Entire home/apt,200,145,6.0,345
43332,Kenneth,4,Private room,35,0,3.18,35
43333,Mohamad,5,Private room,49,342,2.53,391
43334,Javier,3,Entire home/apt,150,69,6.92,219
43335,Frances,3,Entire home/apt,150,176,2.28,326
43336,Eric,1,Entire home/apt,195,14,5.08,209
43337,Jenna,1,Entire home/apt,140,3,3.93,143
43338,Antony,2,Private room,35,0,2.44,35
43339,Cebile,2,Private room,65,348,1.83,413
43340,Cebile,2,Private room,65,359,2.26,424
43341,Cebile,2,Private room,65,352,2.63,417
43342,Tapashi,3,Entire home/apt,50,304,6.0,354
43343,Cebile,2,Shared room,40,358,2.55,398
43344,Cebile,2,Shared room,40,343,1.14,383
43345,Luis,2,Entire home/apt,180,119,2.86,299
43346,Jen,1,Private room,115,113,1.11,228
43347,Omar,1,Private room,69,14,2.19,83
43348,Ulrika,4,Private room,40,59,1.76,99
43349,Viviana,3,Private room,39,358,3.04,397
43350,Jp,1,Private room,99,13,3.53,112
43352,Jenny,1,Shared room,40,12,1.0,52
43353,Marcelo Y Lucio,3,Private room,38,365,8.94,403
43355,Yana,1,Private room,64,86,0.34,150
43356,Julia,2,Entire home/apt,100,3,1.23,103
43357,Jen,1,Private room,110,108,3.49,218
43358,Sean,2,Entire home/apt,245,257,0.47,502
43359,Faye,1,Entire home/apt,135,15,1.05,150
43360,Mona,1,Entire home/apt,299,59,5.45,358
43364,Steve,1,Entire home/apt,299,165,1.06,464
43365,Iris,3,Entire home/apt,110,54,1.23,164
43366,Victor,4,Private room,60,34,1.96,94
43368,Janei,2,Private room,65,179,4.29,244
43369,Candace,2,Private room,90,365,3.75,455
43370,Fé,1,Entire home/apt,174,85,3.55,259
43371,Bernarda,1,Entire home/apt,260,33,1.43,293
43373,Ann,2,Private room,50,246,0.77,296
43374,Antony,2,Shared room,24,0,0.74,24
43376,Salome J,3,Private room,70,59,0.49,129
43377,Kita,1,Private room,110,158,2.08,268
43379,T+Y+K+M,2,Entire home/apt,95,292,10.77,387
43380,Yehudis,2,Entire home/apt,425,59,2.0,484
43381,Yehudis,2,Entire home/apt,150,148,2.5,298
43382,Jasmine,1,Private room,119,23,2.44,142
43383,Sydney,2,Private room,45,159,1.07,204
43388,Brian,1,Private room,50,48,3.14,98
43390,Albeiro Y Katalina,3,Shared room,34,123,0.7,157
43391,Arline,2,Private room,175,43,1.52,218
43392,Andi,2,Private room,109,97,1.07,206
43393,Odaine,2,Entire home/apt,140,157,2.63,297
43394,Svetlana,2,Shared room,26,0,1.83,26
43395,Arline,2,Private room,175,43,2.18,218
43396,Wendy,1,Entire home/apt,299,61,2.89,360
43397,Sonder (NYC),1,Entire home/apt,234,309,2.66,543
43398,Sonder (NYC),1,Entire home/apt,230,327,2.28,557
43399,Sonder (NYC),1,Entire home/apt,230,319,1.5,549
43401,Sonder (NYC),1,Entire home/apt,217,337,0.75,554
43403,Sonder (NYC),1,Entire home/apt,152,193,0.6,345
43404,Lucy,3,Entire home/apt,125,362,12.0,487
43407,Jasmine,1,Entire home/apt,289,133,1.5,422
43408,Antonio,1,Entire home/apt,330,132,3.65,462
43410,Nour,1,Entire home/apt,289,146,4.89,435
43411,Andres,2,Entire home/apt,150,206,3.57,356
43413,Syeda,3,Private room,40,360,2.12,400
43414,Sonder (NYC),1,Entire home/apt,228,317,3.33,545
43415,Sonder (NYC),1,Entire home/apt,203,322,0.67,525
43416,Lakshmee,3,Private room,49,0,0.8,49
43418,Fab,1,Entire home/apt,800,276,3.46,1076
43419,Bronislaw,1,Private room,50,35,1.56,85
43420,Robert,1,Entire home/apt,149,151,4.29,300
43421,Kateryna And Tim,3,Private room,55,319,3.75,374
43422,Grace,1,Private room,108,175,3.71,283
43423,Matt,1,Private room,160,61,1.13,221
43425,Rachel,1,Private room,52,0,0.4,52
43427,Grace,1,Private room,89,153,5.2,242
43428,Jay,2,Private room,57,170,3.18,227
43429,Jay,2,Private room,57,164,2.47,221
43430,Maria,2,Private room,40,344,0.45,384
43431,Jay,2,Private room,55,138,2.76,193
43432,Izi,1,Entire home/apt,290,283,0.57,573
43433,Teya,4,Private room,45,352,4.92,397
43434,Gregory,2,Entire home/apt,150,292,3.49,442
43435,Eli,2,Private room,50,304,2.5,354
43437,Pavel-Alexey,5,Entire home/apt,68,65,1.97,133
43438,Henry,1,Entire home/apt,195,12,2.9,207
43439,Arthur,3,Private room,45,360,1.2,405
43440,思铨,1,Private room,66,17,0.34,83
43446,Jess,2,Private room,125,0,4.38,125
43447,Barblin,2,Entire home/apt,130,262,5.36,392
43448,Syeda,3,Private room,50,342,3.79,392
43449,Ifeoluwa,4,Private room,51,271,4.76,322
43450,Jabari,2,Entire home/apt,82,19,2.27,101
43453,Nadine,3,Entire home/apt,360,206,3.85,566
43455,Phoenix,3,Private room,45,54,2.26,99
43456,Grace,1,Private room,89,164,4.43,253
43458,H,4,Entire home/apt,75,360,0.82,435
43460,Shiko,1,Private room,105,20,3.79,125
43461,Ana Maria,3,Private room,90,0,2.47,90
43462,Milly,1,Private room,75,53,0.39,128
43463,Syeda,3,Shared room,30,361,4.05,391
43465,Dalia & Marina,3,Entire home/apt,250,152,2.88,402
43466,Antony,2,Shared room,24,0,1.0,24
43467,Jacob,2,Private room,79,364,1.0,443
43468,Danny,1,Entire home/apt,280,215,8.31,495
43469,Kimi,2,Private room,75,154,4.83,229
43470,Alex,3,Shared room,58,180,4.14,238
43471,Katie,3,Private room,55,83,1.94,138
43472,Joyce,2,Private room,65,354,0.53,419
43473,Joyce,2,Private room,65,349,1.0,414
43474,Regine,3,Private room,63,0,1.0,63
43475,Jane,1,Entire home/apt,250,8,0.74,258
43476,David,2,Entire home/apt,200,0,0.7,200
43477,Lily,2,Entire home/apt,104,2,3.33,106
43478,Leandro,3,Entire home/apt,65,280,0.44,345
43481,David,2,Entire home/apt,65,19,0.8,84
43483,Luke,1,Private room,215,345,1.84,560
43484,Roman,1,Entire home/apt,419,343,0.79,762
43485,Luke,1,Private room,215,335,2.73,550
43486,Susan,1,Entire home/apt,195,117,0.7,312
43487,Carly,2,Entire home/apt,225,0,1.0,225
43489,Paris,1,Entire home/apt,306,320,1.3,626
43490,Hannah,2,Private room,90,47,1.17,137
43491,Anna + Fred,1,Entire home/apt,700,249,4.18,949
43492,Denis,2,Entire home/apt,200,13,0.59,213
43493,Keshet,1,Entire home/apt,230,87,0.65,317
43494,Scott,2,Entire home/apt,150,160,0.42,310
43495,Katarzyna,2,Private room,55,47,7.33,102
43497,Ollie,2,Private room,68,251,0.43,319
43498,Michael,2,Private room,70,98,3.28,168
43499,Anthony,2,Private room,79,96,2.43,175
43500,Shawn,2,Entire home/apt,175,264,1.9,439
43503,Mohamad,5,Private room,37,310,2.66,347
43505,Lawanne,2,Private room,75,361,4.12,436
43506,Lawanne,2,Private room,50,356,2.0,406
43509,Sam,1,Entire home/apt,225,44,0.77,269
43511,Carter,2,Private room,105,0,0.76,105
43512,Francesca,3,Entire home/apt,85,77,1.0,162
43513,Erik,1,Shared room,69,347,2.7,416
43514,Erik,1,Shared room,60,349,4.62,409
43515,Erik,1,Shared room,85,337,6.21,422
43516,Erik,1,Shared room,60,348,6.82,408
43517,Helena,2,Shared room,41,0,1.64,41
43518,Francesco,2,Entire home/apt,130,28,2.5,158
43519,Harvy Jake,1,Entire home/apt,149,163,2.63,312
43523,Sonder (NYC),1,Entire home/apt,244,363,0.88,607
43525,Sonder (NYC),1,Entire home/apt,472,262,3.43,734
43526,Sonder (NYC),1,Entire home/apt,474,263,4.22,737
43527,Sonder (NYC),1,Entire home/apt,214,319,1.0,533
43528,Sonder (NYC),1,Entire home/apt,235,333,1.76,568
43529,Sonder (NYC),1,Entire home/apt,244,315,0.98,559
43530,Sonder (NYC),1,Entire home/apt,495,265,2.5,760
43533,Katherine,1,Entire home/apt,260,10,1.03,270
43534,Mike,2,Entire home/apt,230,169,3.57,399
43535,Cashmira,3,Entire home/apt,95,35,2.2,130
43536,Sonder (NYC),1,Entire home/apt,229,338,1.5,567
43537,Nicholas,3,Private room,90,104,4.04,194
43538,Sonder (NYC),1,Entire home/apt,240,323,1.7,563
43540,Sonder (NYC),1,Entire home/apt,236,319,3.7,555
43541,Sonder (NYC),1,Entire home/apt,229,341,4.52,570
43542,Donal,2,Entire home/apt,160,5,1.0,165
43543,Sonder (NYC),1,Entire home/apt,229,327,2.8,556
43545,Lari,1,Entire home/apt,200,1,2.28,201
43546,Fernando,3,Shared room,35,332,1.0,367
43547,Angela,2,Private room,169,72,3.56,241
43548,Kimi,2,Private room,75,134,5.27,209
43549,Noah,2,Entire home/apt,240,0,1.18,240
43550,Kimi,2,Private room,75,361,2.88,436
43551,Mary,3,Private room,50,164,2.43,214
43552,Manuel Alex,1,Private room,95,0,1.43,95
43553,Mona,2,Private room,120,18,4.83,138
43554,Eduardo,1,Private room,60,216,5.78,276
43555,Sonder (NYC),1,Entire home/apt,229,340,1.55,569
43556,Alexandra,1,Entire home/apt,130,5,2.84,135
43557,Sam,2,Entire home/apt,100,37,6.52,137
43559,Cedar,1,Entire home/apt,150,213,2.67,363
43560,Josh,1,Entire home/apt,355,365,1.11,720
43561,Sonder (NYC),1,Entire home/apt,150,220,1.02,370
43562,Carol,1,Private room,89,52,3.42,141
43564,Imperial,4,Private room,45,24,2.28,69
43565,Mikey,1,Entire home/apt,395,279,2.35,674
43566,Adi & Naor,1,Private room,70,0,2.0,70
43567,Vanessa,2,Entire home/apt,134,245,4.0,379
43568,Kimberley,1,Entire home/apt,200,228,1.0,428
43569,Andrey,2,Entire home/apt,215,18,1.9,233
43570,Megumi & Nathan,1,Private room,85,77,0.42,162
43573,Jason,2,Private room,65,23,6.59,88
43575,Rachel,2,Entire home/apt,125,24,3.18,149
43576,Violetta,1,Private room,70,163,2.0,233
43577,Gaia&Pietro,1,Entire home/apt,250,255,2.24,505
43578,Lisa,2,Entire home/apt,159,127,5.39,286
43579,Larissa,1,Entire home/apt,155,6,2.44,161
43582,Laura + John,1,Entire home/apt,300,54,3.33,354
43585,Imma,2,Private room,75,0,2.34,75
43586,Keith,1,Private room,51,0,4.34,51
43587,Victoria,3,Private room,80,0,1.22,80
43588,Nate,3,Private room,700,125,0.47,825
43589,Maraliz,2,Private room,90,174,1.18,264
43590,Leslie,2,Private room,64,90,0.68,154
43592,Shosh,1,Entire home/apt,549,207,2.66,756
43593,Brandon,2,Entire home/apt,100,11,1.52,111
43596,Miguel,2,Entire home/apt,550,215,4.0,765
43597,Jiali,3,Private room,65,126,3.79,191
43598,Erin,1,Private room,99,168,1.5,267
43599,Erin,1,Private room,199,160,0.58,359
43601,Adrienne,1,Entire home/apt,154,19,1.14,173
43603,Syeda,3,Private room,50,357,3.37,407
43604,Jonathan,4,Private room,70,364,1.76,434
43605,Vicente,1,Private room,60,305,6.07,365
43606,Jean,3,Shared room,26,90,1.65,116
43607,Joyce,2,Private room,65,352,0.52,417
43608,Timothy And Natalia,1,Entire home/apt,250,161,2.44,411
43609,David,2,Private room,70,205,6.67,275
43610,Kethy,2,Entire home/apt,65,42,0.95,107
43611,Jess & Ana,3,Shared room,25,344,3.45,369
43612,Ikrame,3,Entire home/apt,115,188,0.42,303
43613,James,1,Entire home/apt,325,131,2.84,456
43614,Huston,2,Private room,75,109,3.53,184
43615,David,3,Private room,50,165,8.03,215
43616,Evan,2,Private room,65,0,0.36,65
43617,Viktor,5,Entire home/apt,70,55,1.0,125
43618,Basia,2,Private room,39,11,3.7,50
43620,Maja,1,Entire home/apt,170,5,1.36,175
43621,Marguerite,2,Entire home/apt,80,132,1.02,212
43622,Laksmi,2,Private room,71,182,2.88,253
43624,Alex,3,Entire home/apt,100,326,5.84,426
43625,Sophia,1,Private room,70,73,2.59,143
43627,Hubert & Val,1,Entire home/apt,274,34,3.55,308
43628,Dd,2,Entire home/apt,140,77,0.97,217
43629,Raashi,1,Entire home/apt,130,27,2.81,157
43630,Sharon,3,Private room,49,0,0.37,49
43631,Roy,3,Entire home/apt,100,353,4.23,453
43632,Erik,1,Shared room,85,349,4.09,434
43633,Ian,2,Private room,65,364,0.8,429
43634,Sue,1,Entire home/apt,150,118,1.38,268
43637,Princess,1,Entire home/apt,139,139,1.52,278
43638,Seong,1,Entire home/apt,110,0,2.31,110
43639,Capucine,1,Entire home/apt,180,32,1.0,212
43640,Benjamin,1,Private room,300,364,0.35,664
43641,Dee,1,Entire home/apt,300,180,0.55,480
43642,Marie-Claire,3,Entire home/apt,200,95,2.35,295
43644,Victor,2,Private room,69,36,1.0,105
43645,Aramis,3,Private room,45,80,5.42,125
43646,Sommy,1,Private room,119,297,2.69,416
43647,Pavel,3,Entire home/apt,125,328,4.72,453
43648,Chris,1,Entire home/apt,145,304,0.77,449
43650,Mark & Christopher,3,Entire home/apt,225,23,1.23,248
43651,Greg,2,Entire home/apt,125,180,1.0,305
43652,Olman,2,Entire home/apt,100,0,2.54,100
43653,Zoie + Chris,1,Entire home/apt,800,84,4.59,884
43654,Leila,1,Shared room,53,58,2.92,111
43655,Glen,2,Private room,100,365,1.14,465
43658,Mary,3,Private room,53,161,8.73,214
43659,Ryan,2,Private room,89,44,1.0,133
43660,Jesus,3,Private room,90,341,3.14,431
43661,Jianren,2,Private room,66,159,3.08,225
43662,Hamza,4,Entire home/apt,115,6,4.46,121
43663,Taina,1,Entire home/apt,120,10,2.05,130
43664,Vaz,1,Entire home/apt,165,27,5.11,192
43666,Hamza,4,Entire home/apt,115,124,3.97,239
43667,Leela,3,Private room,120,16,4.62,136
43668,Demacoy,3,Entire home/apt,137,273,2.18,410
43669,Becca,3,Entire home/apt,150,103,3.33,253
43676,Al,1,Entire home/apt,199,179,0.38,378
43677,Sommy,1,Private room,100,314,1.82,414
43678,Carlyn,3,Entire home/apt,115,360,2.0,475
43679,Jalen,1,Entire home/apt,349,220,1.95,569
43680,David,1,Private room,110,270,3.53,380
43681,Michele,2,Private room,75,313,2.03,388
43682,Pharohl,2,Entire home/apt,60,17,7.0,77
43683,May,1,Entire home/apt,170,235,2.57,405
43684,Meezy,4,Private room,56,70,3.24,126
43687,Janice,5,Entire home/apt,85,66,3.33,151
43688,Elizabeth,1,Private room,100,0,1.3,100
43689,Ume,1,Shared room,117,139,2.03,256
43691,Vijay,1,Entire home/apt,120,87,5.88,207
43693,Abie,2,Private room,100,179,3.0,279
43694,Helena,2,Shared room,31,73,1.62,104
43696,David,1,Shared room,78,365,0.63,443
43698,Erik,1,Shared room,85,161,4.44,246
43699,Leanne,1,Entire home/apt,160,0,1.38,160
43700,Sam,1,Entire home/apt,290,254,4.29,544
43701,Lana,3,Private room,50,319,1.88,369
43702,Anchor,2,Shared room,35,77,1.11,112
43703,Ode,3,Private room,67,365,4.74,432
43704,Jun,2,Entire home/apt,265,86,3.8,351
43705,Ashley,2,Entire home/apt,180,98,0.83,278
43706,John,2,Entire home/apt,180,10,0.38,190
43708,Joe,1,Private room,55,76,1.94,131
43710,Jackson,1,Entire home/apt,250,155,2.76,405
43711,Eyal,1,Private room,60,314,1.0,374
43714,Nikolett,2,Private room,65,46,3.38,111
43715,Eyal,1,Private room,60,335,0.79,395
43717,Stanley,1,Entire home/apt,420,137,5.06,557
43718,Lana,3,Private room,60,305,2.63,365
43719,Tom & Reina,2,Entire home/apt,155,71,2.47,226
43722,Amber,1,Private room,100,0,2.0,100
43727,Sonder (NYC),1,Entire home/apt,255,215,1.62,470
43728,Sonder (NYC),1,Entire home/apt,229,350,1.92,579
43729,Sonder (NYC),1,Entire home/apt,235,340,1.11,575
43730,Riya,2,Entire home/apt,175,4,1.14,179
43733,Mohammed,2,Private room,40,346,0.81,386
43734,Yasmine,3,Shared room,60,0,1.11,60
43735,Paola,2,Private room,50,74,9.4,124
43736,Andrey,2,Private room,60,20,5.25,80
43737,Sonder (NYC),1,Entire home/apt,390,243,3.04,633
43738,Ceive,1,Entire home/apt,140,0,4.36,140
43739,Sonder (NYC),1,Entire home/apt,475,253,3.23,728
43740,Beatrix,1,Private room,150,97,0.43,247
43741,Sonder (NYC),1,Entire home/apt,228,357,0.68,585
43742,Michael H.Y.,2,Private room,70,142,6.67,212
43743,Holden,2,Private room,54,0,3.75,54
43745,Andrey,2,Private room,55,15,5.92,70
43746,Amy,1,Private room,79,31,4.53,110
43748,Ollie,2,Private room,64,94,1.0,158
43749,Ollie,2,Private room,65,237,0.45,302
43750,Glen,2,Private room,90,360,2.25,450
43754,Sergey,1,Entire home/apt,162,66,2.2,228
43755,Ryan,1,Private room,105,0,0.37,105
43756,Jacob And Michelle,1,Entire home/apt,420,130,4.48,550
43759,Moises,1,Private room,45,180,2.0,225
43760,Moji,1,Private room,119,2,1.32,121
43761,David,1,Private room,90,174,3.08,264
43762,Chaya,2,Entire home/apt,120,10,3.38,130
43763,Anastasia,2,Entire home/apt,160,102,0.42,262
43764,Quisquella,4,Entire home/apt,65,29,1.0,94
43765,Braulio,1,Private room,100,23,0.39,123
43766,Aman,1,Private room,35,5,3.0,40
43767,Andrey,2,Private room,55,20,5.49,75
43768,Paul,4,Entire home/apt,85,349,1.0,434
43769,Eric And Tansey,2,Private room,88,24,2.73,112
43770,Clemente,1,Private room,160,81,2.47,241
43771,Ariel,2,Private room,70,61,3.08,131
43772,Tj,2,Entire home/apt,76,285,4.29,361
43773,Elena,2,Private room,90,323,0.94,413
43774,Gardea,1,Entire home/apt,200,252,3.56,452
43775,Anastasia,1,Private room,59,74,4.62,133
43780,Mishael,1,Entire home/apt,99,165,1.45,264
43781,Allan,1,Private room,65,0,1.25,65
43783,Jeff,2,Entire home/apt,150,1,1.71,151
43784,Casha,2,Private room,185,123,5.45,308
43785,Stefanie,1,Entire home/apt,165,1,2.5,166
43786,Anderson,2,Private room,125,29,4.58,154
43787,Jiangbin,1,Entire home/apt,150,39,1.05,189
43789,Mary,3,Private room,88,180,1.5,268
43790,Laurin,2,Private room,99,1,10.17,100
43791,Freda,1,Entire home/apt,151,42,11.25,193
43792,Joslin,2,Entire home/apt,105,286,2.25,391
43793,Iskender Turgay,1,Entire home/apt,345,179,0.36,524
43794,Ariel,1,Entire home/apt,150,102,0.87,252
43795,Dwayne,2,Private room,57,51,4.93,108
43798,Marie,2,Private room,65,17,0.67,82
43799,William,1,Entire home/apt,200,127,5.63,327
43800,Gen,1,Private room,47,272,1.58,319
43801,Chanel,2,Private room,100,163,1.33,263
43802,Julie Anne,1,Entire home/apt,129,167,2.8,296
43803,Dolores & David,2,Entire home/apt,150,251,3.0,401
43805,Hok Thu,2,Private room,66,147,4.23,213
43806,Louise,4,Private room,35,48,8.0,83
43807,Long,2,Private room,63,127,3.85,190
43808,Alexis,2,Private room,65,0,0.94,65
43812,Jacqueline,2,Entire home/apt,150,241,2.0,391
43814,Jiaming,1,Entire home/apt,360,251,4.94,611
43815,J,2,Shared room,28,41,3.2,69
43816,Ashley,2,Entire home/apt,170,43,2.31,213
43817,Carolina,1,Private room,61,84,1.76,145
43818,Bela & Gui,2,Private room,79,136,3.33,215
43819,Anthony,1,Entire home/apt,325,65,2.03,390
43820,J,2,Shared room,28,53,1.71,81
43821,Eugenio,1,Private room,100,0,2.56,100
43822,Zabi,3,Entire home/apt,199,175,2.81,374
43823,Allie,1,Entire home/apt,200,0,1.76,200
43824,Aaron,1,Entire home/apt,300,13,1.33,313
43826,Bela & Gui,2,Private room,81,121,4.17,202
43827,Bela & Gui,2,Private room,81,164,4.87,245
43828,Bela & Gui,2,Private room,81,105,3.8,186
43829,Bela & Gui,2,Private room,81,128,3.91,209
43830,Brigit,2,Entire home/apt,100,150,2.34,250
43832,Chy,2,Entire home/apt,165,201,4.03,366
43833,Pamela,2,Private room,75,0,1.2,75
43834,Josephine,1,Private room,92,187,0.71,279
43835,The,3,Private room,70,0,1.67,70
43837,Emma,3,Shared room,65,89,3.04,154
43839,Sharon & Erika,4,Private room,60,343,7.59,403
43840,Yuval,3,Private room,34,281,0.68,315
43841,Olga,1,Entire home/apt,140,18,2.46,158
43842,Monica,2,Entire home/apt,95,120,2.09,215
43846,David,2,Entire home/apt,120,298,5.6,418
43847,Jean-Yves,2,Entire home/apt,130,283,1.0,413
43848,John & Jennifer,2,Private room,35,53,0.52,88
43849,Navin,2,Entire home/apt,189,349,3.66,538
43850,Valentina,3,Private room,44,331,7.67,375
43851,Jean-Yves,2,Entire home/apt,135,285,1.5,420
43852,Jessica,1,Private room,55,0,2.54,55
43853,Victoria,1,Private room,199,350,0.42,549
43854,Dan,2,Entire home/apt,400,362,0.82,762
43855,Rafu,3,Entire home/apt,129,95,1.7,224
43856,Maggie,2,Entire home/apt,225,38,4.17,263
43857,Adriana,1,Private room,75,58,0.42,133
43858,John & Jennifer,2,Private room,35,53,1.0,88
43860,Cristina,1,Entire home/apt,159,157,3.42,316
43861,Rochelle,2,Private room,36,192,3.69,228
43862,Monica,2,Entire home/apt,190,171,5.91,361
43863,Mihail,2,Private room,70,78,5.32,148
43865,Ofier,2,Entire home/apt,150,89,1.64,239
43866,Karina,1,Private room,75,227,3.75,302
43867,Amy,2,Entire home/apt,75,103,1.85,178
43868,Judi,1,Private room,45,4,2.31,49
43869,Mihail,2,Private room,68,55,3.42,123
43870,Mohsin,5,Entire home/apt,135,36,0.86,171
43871,Ryan,1,Private room,103,19,5.83,122
43872,Erik,1,Shared room,85,365,3.25,450
43873,Ana,1,Entire home/apt,200,173,0.95,373
43874,Makis,1,Private room,95,256,4.58,351
43876,Cheryl,3,Private room,90,57,5.14,147
43877,Nikolett,2,Private room,60,46,2.25,106
43878,Jess & Ana,3,Shared room,24,346,1.52,370
43879,Constance,2,Private room,45,10,2.26,55
43880,Peter,1,Private room,44,0,0.55,44
43881,Maarouf,2,Entire home/apt,120,0,0.48,120
43882,Michael,1,Entire home/apt,450,43,2.55,493
43883,Jess & Ana,3,Shared room,24,332,1.11,356
43886,Maggie,1,Private room,98,4,0.97,102
43891,Mah,2,Entire home/apt,195,0,0.47,195
43893,Jason,2,Private room,62,21,0.78,83
43895,Yuval,3,Private room,34,325,1.0,359
43899,Gil,4,Entire home/apt,75,86,5.0,161
43900,Shai,1,Private room,95,8,1.1,103
43902,Levi,2,Shared room,25,167,0.71,192
43903,Michael,1,Private room,130,132,3.0,262
43906,Corinna,1,Private room,150,6,1.82,156
43907,Joel,2,Entire home/apt,220,251,2.03,471
43908,Antonio,3,Private room,85,67,6.0,152
43909,Maria,1,Private room,135,93,4.05,228
43910,Mohammed,2,Private room,42,120,2.55,162
43911,Anthony,2,Private room,75,6,2.27,81
43912,Loretta,1,Private room,85,193,1.14,278
43913,Gustav,1,Entire home/apt,140,56,1.0,196
43914,M,1,Private room,99,359,0.42,458
43915,Em,2,Entire home/apt,140,316,1.8,456
43916,Anna,3,Entire home/apt,250,76,5.49,326
43917,Karim,1,Entire home/apt,190,0,1.4,190
43918,Shai,1,Entire home/apt,175,103,0.45,278
43919,Mihail,2,Private room,65,66,3.38,131
43920,Mihail,2,Private room,65,61,2.63,126
43921,Michael,1,Entire home/apt,339,86,7.89,425
43923,Robert,1,Entire home/apt,700,263,3.08,963
43924,Jose,1,Private room,65,180,3.75,245
43926,David,2,Entire home/apt,249,177,1.97,426
43928,Rachel,1,Private room,500,90,0.49,590
43929,Jerick,1,Entire home/apt,149,219,1.92,368
43931,Yulia,2,Private room,79,5,1.02,84
43932,Daniel,1,Entire home/apt,225,33,0.83,258
43933,Sandra,1,Entire home/apt,160,2,1.88,162
43934,Brenda,2,Private room,54,81,5.32,135
43935,Brenda,2,Private room,53,77,5.56,130
43936,Yeshe,2,Private room,90,63,3.53,153
43937,Deborah,3,Private room,65,139,1.0,204
43939,Jeffrey,1,Private room,55,157,0.37,212
43940,Shai,2,Entire home/apt,250,90,1.0,340
43941,Barbara,1,Entire home/apt,130,0,2.25,130
43942,Namaya,1,Private room,90,146,1.54,236
43944,Mohammed,2,Private room,40,172,1.0,212
43945,Mohammed,2,Private room,40,151,0.81,191
43948,Mohammed,2,Private room,40,114,0.91,154
43949,Carena,2,Entire home/apt,80,225,3.8,305
43951,Radilena,3,Private room,69,35,3.42,104
43953,Mickey,1,Entire home/apt,200,38,2.45,238
43954,Shanice,2,Entire home/apt,110,26,2.57,136
43955,Brenda,2,Private room,54,62,4.12,116
43956,Brenda,2,Private room,54,70,4.35,124
43957,Eugenia,4,Entire home/apt,50,34,3.04,84
43958,Amy,2,Private room,49,316,0.42,365
43960,Charvii,3,Private room,60,1,6.71,61
43961,Christina,3,Private room,60,51,0.73,111
43962,Nathan,2,Entire home/apt,100,0,0.79,100
43963,Paul,1,Private room,55,175,7.41,230
43966,George,2,Entire home/apt,180,352,2.63,532
43967,Yolander,3,Entire home/apt,350,358,3.42,708
43968,Dan,2,Private room,66,281,0.37,347
43969,Kira,2,Entire home/apt,120,3,1.13,123
43970,Erik,1,Shared room,69,364,1.48,433
43971,Daniel,3,Private room,70,288,2.86,358
43972,Saar,1,Entire home/apt,350,243,3.29,593
43973,Richard,1,Entire home/apt,179,0,1.52,179
43975,Petra,1,Private room,90,0,2.0,90
43976,Meela,3,Private room,65,300,4.58,365
43977,Meela,3,Private room,50,318,1.34,368
43978,Meela,3,Private room,45,342,2.31,387
43979,Sharon,3,Private room,100,350,1.73,450
43980,Kevin,1,Private room,83,15,0.73,98
43982,Rafaelo,1,Private room,98,321,1.22,419
43984,Gaia&Pietro,1,Entire home/apt,250,265,0.88,515
43987,Laura,1,Entire home/apt,250,0,1.0,250
43988,Naiomi,3,Private room,150,0,0.4,150
43990,Yao & Rain,1,Private room,120,339,0.39,459
43993,Jordan,1,Entire home/apt,120,0,1.7,120
43994,Patrola,1,Private room,49,180,5.5,229
43995,Barbara,2,Entire home/apt,149,0,1.0,149
43996,Ollie,2,Private room,68,226,0.92,294
43997,Tamiris,2,Private room,75,62,3.85,137
43998,Raphael,2,Private room,90,0,0.75,90
43999,Sophie,2,Entire home/apt,150,173,6.55,323
44000,Idemudia,2,Entire home/apt,89,13,4.58,102
44001,Sonder (NYC),1,Entire home/apt,228,347,1.9,575
44002,Sonder (NYC),1,Entire home/apt,256,292,2.79,548
44003,Sonder (NYC),1,Entire home/apt,188,329,2.65,517
44004,Sonder (NYC),1,Entire home/apt,240,340,2.69,580
44005,Sonder (NYC),1,Entire home/apt,255,237,2.57,492
44006,Shahzad,2,Entire home/apt,199,21,2.4,220
44007,Sonder (NYC),1,Entire home/apt,228,349,3.0,577
44009,Alexandre,1,Private room,99,30,3.42,129
44011,Alexandre,1,Private room,99,0,1.9,99
44012,Young,2,Entire home/apt,150,0,0.92,150
44014,David,1,Entire home/apt,790,298,1.82,1088
44015,Devin T.,1,Entire home/apt,161,294,4.87,455
44016,Maria,1,Private room,123,146,4.47,269
44017,Drew,1,Entire home/apt,299,16,3.18,315
44018,Jorge,4,Shared room,49,358,0.94,407
44019,Kimberly,2,Entire home/apt,125,122,1.0,247
44020,Maria,1,Private room,123,0,4.35,123
44023,Felicia,1,Entire home/apt,190,78,3.28,268
44024,Paige,3,Entire home/apt,225,109,9.58,334
44025,Maria,2,Private room,50,292,3.38,342
44027,Jessie,1,Private room,59,10,1.74,69
44028,Arya,1,Entire home/apt,250,144,2.35,394
44029,Miguelina,3,Private room,65,180,1.69,245
44030,Sonder (NYC),1,Private room,616,255,2.46,871
44031,Sonder (NYC),1,Entire home/apt,408,273,0.95,681
44032,Benjamin,1,Entire home/apt,100,2,3.0,102
44033,Sonder (NYC),1,Private room,264,348,0.83,612
44035,Jean Paul,2,Private room,75,82,0.37,157
44036,Meela,3,Private room,50,336,2.88,386
44037,Meela,3,Private room,60,355,1.52,415
44038,Kristi,2,Entire home/apt,80,33,0.48,113
44039,Patricia,3,Private room,49,72,6.36,121
44044,Ashley,3,Entire home/apt,199,249,6.36,448
44046,Roxanne,1,Entire home/apt,239,176,1.76,415
44047,Edyta,2,Entire home/apt,118,30,0.7,148
44048,Taio,1,Private room,90,354,0.83,444
44049,Lisa,2,Entire home/apt,91,9,2.0,100
44050,Dimitri,2,Private room,90,0,1.18,90
44055,Jeanette,2,Private room,69,131,3.75,200
44056,Mohammad,4,Entire home/apt,92,48,4.82,140
44057,Michael,1,Private room,59,24,1.17,83
44058,Sheryl,1,Entire home/apt,149,135,1.85,284
44059,Sonder (NYC),1,Entire home/apt,396,328,3.0,724
44060,Sonder (NYC),1,Entire home/apt,215,346,1.0,561
44063,Nicholas,2,Entire home/apt,99,97,3.0,196
44064,Amy,2,Private room,100,169,1.85,269
44065,Emma,1,Entire home/apt,180,83,0.42,263
44066,Ollie,2,Private room,68,246,2.0,314
44067,Elise,1,Entire home/apt,169,50,7.27,219
44068,Ollie,2,Private room,66,223,1.0,289
44071,Ollie,2,Private room,68,226,0.6,294
44072,Vita,2,Private room,70,153,2.67,223
44073,Vernon,2,Entire home/apt,40,178,0.54,218
44074,Laura,1,Private room,90,34,2.0,124
44075,Jhunior,1,Entire home/apt,90,51,1.88,141
44076,Leonard,1,Private room,99,356,2.92,455
44077,Parrish,2,Shared room,50,365,3.0,415
44078,Melissa,2,Private room,57,35,2.84,92
44079,Ella,2,Entire home/apt,200,173,0.37,373
44081,Andrew,1,Entire home/apt,130,26,4.34,156
44082,Leonard,1,Private room,119,360,2.88,479
44084,Aleksey,1,Private room,500,0,0.5,500
44085,Aleksey,1,Private room,500,0,0.82,500
44086,Shane,3,Private room,125,90,2.34,215
44088,John,2,Private room,65,365,0.95,430
44090,Irina,1,Entire home/apt,150,33,0.47,183
44091,Alena,2,Private room,60,341,1.85,401
44092,Florent,2,Private room,75,324,1.58,399
44095,Lee,1,Entire home/apt,130,115,1.0,245
44097,Ilona,2,Private room,100,61,1.0,161
44098,Gus,2,Entire home/apt,100,66,3.0,166
44099,Ash,1,Entire home/apt,200,216,2.07,416
44101,Claire,1,Private room,130,180,1.73,310
44103,John,2,Entire home/apt,95,4,1.88,99
44104,Soledad,3,Entire home/apt,111,223,3.7,334
44105,Sophia,2,Entire home/apt,200,161,2.42,361
44107,Roger,1,Entire home/apt,149,0,0.59,149
44108,Hank,1,Private room,140,350,1.88,490
44109,Hank,1,Private room,140,336,2.0,476
44111,Leanna,3,Private room,60,364,1.76,424
44112,Evan,1,Private room,49,2,0.45,51
44113,Jack,1,Entire home/apt,195,41,4.36,236
44114,Waly,1,Private room,78,89,0.46,167
44115,Olivia,2,Entire home/apt,140,328,3.97,468
44118,Jodi,2,Entire home/apt,140,130,2.22,270
44119,Lynn L,3,Private room,45,360,1.43,405
44122,Jeff,2,Private room,70,78,1.0,148
44125,David,1,Private room,90,175,2.43,265
44128,Jarrod,2,Entire home/apt,170,188,2.55,358
44130,Majsan,1,Private room,59,293,1.64,352
44133,Marika,1,Entire home/apt,365,127,1.02,492
44135,Maya,1,Entire home/apt,208,9,2.11,217
44137,Anna,2,Private room,75,100,1.0,175
44138,Adolfo,1,Entire home/apt,150,138,1.0,288
44139,Ellen,1,Entire home/apt,135,1,2.37,136
44140,Yoz,1,Entire home/apt,210,284,0.49,494
44141,Sasan,3,Private room,44,192,1.0,236
44143,Marta,2,Private room,79,9,2.93,88
44144,Clark,1,Private room,60,93,2.42,153
44145,Denise,2,Private room,75,317,3.75,392
44146,Johnnie,2,Private room,75,138,1.0,213
44147,Isa & Bruno,3,Private room,75,88,4.52,163
44149,Isa & Bruno,3,Private room,75,68,4.65,143
44150,Isa & Bruno,3,Private room,75,88,5.83,163
44154,Alisa,2,Private room,60,5,1.25,65
44155,Yorick,1,Entire home/apt,250,263,1.73,513
44156,Kim,1,Entire home/apt,149,148,0.9,297
44158,Tiffany,2,Private room,130,159,3.95,289
44159,Bassema,1,Entire home/apt,190,10,2.08,200
44160,Rosa,2,Entire home/apt,90,27,2.11,117
44161,Christopher,3,Private room,69,179,3.1,248
44162,Oleg,1,Entire home/apt,945,292,0.94,1237
44163,Matt,1,Private room,155,50,1.23,205
44164,Mike,1,Entire home/apt,450,123,4.29,573
44165,Jamie,1,Entire home/apt,178,0,3.23,178
44166,Mohammed,2,Private room,40,106,0.58,146
44167,David,1,Entire home/apt,690,287,1.87,977
44169,Gretchen,2,Entire home/apt,250,175,1.34,425
44170,Mohammed,2,Private room,35,131,0.98,166
44171,Mohammed,2,Private room,35,152,2.11,187
44172,Forest,1,Private room,45,0,2.38,45
44173,Matt,2,Entire home/apt,295,0,0.81,295
44174,Sonder (NYC),1,Entire home/apt,244,260,0.83,504
44175,Sonder (NYC),1,Entire home/apt,409,325,1.29,734
44176,Sonder (NYC),1,Entire home/apt,185,291,1.28,476
44178,Sonder (NYC),1,Entire home/apt,230,285,2.5,515
44181,Balwinder,3,Private room,78,356,5.83,434
44182,Theo,2,Entire home/apt,105,51,5.0,156
44183,Amber,1,Private room,165,90,3.7,255
44185,Angela,2,Private room,28,49,5.49,77
44186,Michael,1,Entire home/apt,225,240,1.0,465
44187,Linda,2,Private room,54,27,2.46,81
44189,Kseniya,2,Entire home/apt,275,56,1.0,331
44190,Mike,3,Private room,55,17,6.0,72
44191,Ramon,1,Entire home/apt,250,61,4.07,311
44193,Tracy,3,Private room,135,0,0.63,135
44194,Cassa Times Square Hotel,1,Private room,370,290,1.55,660
44195,Cassa Times Square Hotel,1,Private room,430,287,1.97,717
44196,Cassa Times Square Hotel,1,Private room,159,292,1.0,451
44197,Cassa Times Square Hotel,1,Private room,390,299,10.86,689
44198,Cassa Times Square Hotel,1,Private room,410,294,0.5,704
44199,Patrick,1,Entire home/apt,265,164,2.42,429
44200,Christos,2,Entire home/apt,150,0,2.14,150
44202,Corey,2,Entire home/apt,101,167,0.57,268
44204,Sidrah,2,Entire home/apt,150,0,0.92,150
44205,Helen!,1,Entire home/apt,225,49,4.29,274
44207,Zabi,3,Entire home/apt,199,170,3.28,369
44208,Janelle,1,Entire home/apt,200,11,2.31,211
44209,Haylee,1,Private room,59,5,2.61,64
44210,Giovanny,1,Private room,75,0,1.9,75
44211,Jose,3,Shared room,28,354,2.11,382
44213,Sonder (NYC),1,Entire home/apt,210,302,3.0,512
44215,Jessie,1,Entire home/apt,120,9,1.36,129
44218,Wendy,2,Private room,78,5,2.0,83
44220,Ashley At Bedly,1,Private room,38,44,0.77,82
44221,Sonder (NYC),1,Entire home/apt,256,293,2.67,549
44223,Sonder (NYC),1,Entire home/apt,229,348,2.09,577
44224,Yuliya,1,Entire home/apt,1000,286,3.09,1286
44225,Ruby,2,Entire home/apt,89,21,1.56,110
44226,Karen,2,Entire home/apt,150,142,5.16,292
44227,Vaughn,1,Entire home/apt,500,82,2.31,582
44228,Eddy,3,Entire home/apt,74,351,7.16,425
44229,Sonder (NYC),1,Entire home/apt,217,272,1.79,489
44230,Sonder (NYC),1,Entire home/apt,203,328,3.13,531
44231,Russell,2,Entire home/apt,305,296,6.46,601
44232,Beverly,2,Private room,65,88,1.0,153
44233,Xinting,1,Entire home/apt,127,192,1.74,319
44234,Shauna,2,Entire home/apt,99,1,0.57,100
44235,Ashley At Bedly,1,Private room,37,76,1.0,113
44236,Kisha,3,Private room,50,364,2.34,414
44237,William,2,Entire home/apt,195,330,3.46,525
44239,Sandra And Katharina,1,Private room,120,34,3.69,154
44240,Lynne,1,Private room,120,311,2.0,431
44241,Stephen,1,Entire home/apt,499,1,2.09,500
44242,Florentino,1,Shared room,35,358,3.86,393
44243,Kazuya,3,Private room,67,1,0.57,68
44245,Jeremy,1,Private room,75,33,6.34,108
44246,Noah,1,Private room,63,18,0.55,81
44247,Kledi,1,Entire home/apt,189,36,5.56,225
44250,Jenny,2,Private room,65,35,0.39,100
44251,Kazuya,3,Private room,59,260,1.0,319
44252,Carol,1,Shared room,50,363,0.48,413
44253,H Ai,3,Private room,55,75,2.81,130
44259,Timothy,2,Private room,63,130,1.0,193
44260,Alex,1,Private room,95,0,4.55,95
44261,Damien,4,Private room,45,318,1.71,363
44265,Shara,1,Private room,50,14,1.0,64
44269,Vanessa,2,Private room,63,22,3.28,85
44270,Nancy,3,Shared room,27,355,2.73,382
44271,Ori,2,Private room,125,252,4.58,377
44272,Sonder (NYC),1,Entire home/apt,470,237,1.55,707
44274,Sonder (NYC),1,Entire home/apt,229,331,0.82,560
44275,Sonder (NYC),1,Entire home/apt,470,242,2.5,712
44276,Sonder (NYC),1,Entire home/apt,228,353,0.46,581
44277,Leslie,1,Entire home/apt,239,319,2.5,558
44280,Scott,1,Entire home/apt,150,178,1.22,328
44281,Stephanie,2,Entire home/apt,99,77,13.33,176
44283,Plamen,1,Entire home/apt,380,296,0.71,676
44285,Mono,2,Private room,50,51,1.0,101
44286,Dave,1,Entire home/apt,300,252,2.5,552
44287,Leslie,2,Entire home/apt,100,0,5.0,100
44288,Jalal,2,Entire home/apt,200,0,1.0,200
44289,Katrin,1,Entire home/apt,320,299,0.97,619
44290,Annabella,2,Private room,52,0,4.77,52
44291,Anna,1,Entire home/apt,304,127,4.66,431
44292,Pinki,1,Entire home/apt,239,335,3.46,574
44293,Ben,2,Private room,65,75,1.43,140
44294,Brian,1,Entire home/apt,300,0,0.59,300
44295,Carlos,1,Private room,60,212,2.81,272
44297,Maria,5,Private room,50,80,1.85,130
44299,Elsen,1,Entire home/apt,539,233,7.36,772
44300,Evelyn,1,Entire home/apt,249,131,4.8,380
44301,Francesco,1,Entire home/apt,250,297,2.0,547
44302,Paola,1,Entire home/apt,249,29,7.22,278
44303,Noel,3,Private room,49,207,2.14,256
44304,Dani,1,Entire home/apt,499,216,1.0,715
44305,Manny,4,Entire home/apt,87,298,5.0,385
44306,B.,1,Entire home/apt,250,92,1.0,342
44307,B.,1,Entire home/apt,250,58,1.0,308
44309,Bruno,3,Private room,50,266,1.88,316
44310,Mark & Olivia,1,Entire home/apt,350,191,1.87,541
44312,Bruno,3,Private room,50,257,4.76,307
44313,Jordan,2,Entire home/apt,101,75,1.88,176
44314,Ronnie,1,Private room,60,352,6.28,412
44316,Andrea,1,Entire home/apt,250,310,3.69,560
44317,Melissa,1,Private room,250,178,1.18,428
44318,Petr,1,Entire home/apt,168,4,1.13,172
44325,Sofia,2,Private room,48,236,9.85,284
44327,Gabriel,1,Entire home/apt,249,364,2.0,613
44328,S,1,Entire home/apt,577,273,1.3,850
44329,Broque,1,Private room,46,143,3.28,189
44330,Diego,2,Private room,50,102,1.22,152
44332,Lakshmee,3,Private room,39,0,6.25,39
44335,Bah,2,Private room,75,60,5.37,135
44336,Mo,1,Entire home/apt,499,194,6.38,693
44338,Errol,2,Private room,65,126,2.09,191
44341,Seira,1,Private room,145,287,4.09,432
44343,Bessi,1,Entire home/apt,299,61,3.13,360
44344,Ally,1,Private room,53,74,0.86,127
44346,Sonder (NYC),1,Entire home/apt,247,232,2.35,479
44347,Kismet,1,Entire home/apt,311,220,6.21,531
44348,Dane,3,Entire home/apt,99,333,0.77,432
44349,Mohammed,1,Private room,60,29,2.25,89
44350,Linda,1,Entire home/apt,299,93,4.44,392
44351,Angie,3,Entire home/apt,250,346,1.0,596
44352,Yuri,1,Entire home/apt,150,40,4.65,190
44354,Piyawan,1,Entire home/apt,195,267,6.14,462
44355,Elias,2,Private room,85,6,2.2,91
44356,Amy,2,Private room,93,23,1.4,116
44359,Missy,2,Private room,120,57,6.96,177
44360,Mimi,3,Entire home/apt,189,62,4.23,251
44361,Erin,1,Private room,129,358,1.48,487
44362,Fred,1,Entire home/apt,280,182,5.89,462
44363,Ashley At Bedly,1,Private room,38,43,0.79,81
44364,Raine & Andrew,2,Entire home/apt,150,0,1.0,150
44365,Elijah,1,Entire home/apt,145,0,3.62,145
44366,Tyler,2,Entire home/apt,95,362,0.91,457
44368,Linda,2,Private room,65,12,2.35,77
44369,Sarah,2,Entire home/apt,220,44,1.97,264
44372,Jamie,1,Entire home/apt,500,256,1.36,756
44374,Sara And Ronald,1,Entire home/apt,180,17,0.61,197
44378,Vangelis,1,Entire home/apt,176,339,1.0,515
44379,Arthur,1,Entire home/apt,500,62,2.94,562
44382,Mark,2,Entire home/apt,86,20,9.09,106
44386,Ben,2,Private room,155,365,0.7,520
44387,Erin,1,Private room,199,352,1.15,551
44389,"Coleen, Felipe And Victoria",2,Entire home/apt,270,0,1.0,270
44392,Erin,1,Private room,199,365,0.81,564
44394,Erin,1,Private room,199,363,0.57,562
44404,Erin,1,Private room,219,356,1.82,575
44407,Andy,2,Entire home/apt,275,298,5.17,573
44408,Ossama,3,Entire home/apt,113,0,1.85,113
44410,Luigi,1,Entire home/apt,249,116,3.27,365
44413,Jameson,2,Entire home/apt,595,322,2.79,917
44414,Max,2,Private room,68,55,1.71,123
44415,David,3,Private room,50,218,4.48,268
44416,Claudio,1,Private room,135,224,2.5,359
44417,Maxinne,1,Entire home/apt,120,284,1.76,404
44418,Minami & Takuya,2,Private room,65,19,3.93,84
44420,Eden,2,Entire home/apt,90,34,0.94,124
44428,Joao,2,Private room,60,52,5.14,112
44432,Marian,2,Private room,50,8,0.9,58
44433,Andrew,2,Entire home/apt,335,365,1.0,700
44435,Mila,2,Private room,89,160,10.56,249
44436,Jiali,3,Private room,70,326,3.18,396
44437,Ruby,1,Shared room,65,353,1.0,418
44438,Collin,1,Entire home/apt,225,152,5.08,377
44439,Antony,2,Shared room,18,0,1.0,18
44441,Jackie,3,Entire home/apt,199,283,7.06,482
44444,Jin Sen,2,Private room,70,262,4.22,332
44445,Liz,1,Entire home/apt,155,0,3.38,155
44446,Kevin,2,Entire home/apt,95,106,9.0,201
44447,John,3,Private room,72,25,4.0,97
44449,Denise,2,Private room,75,245,1.54,320
44450,Marsha,2,Private room,40,0,4.29,40
44451,William,1,Entire home/apt,450,164,2.24,614
44452,Elena,1,Entire home/apt,150,315,1.9,465
44454,Chrissy,1,Entire home/apt,300,235,1.85,535
44455,Claudio,1,Private room,135,247,2.86,382
44456,Claudio,1,Private room,135,320,0.64,455
44457,Stanislav,1,Entire home/apt,300,231,2.42,531
44458,Danilo,3,Private room,30,11,2.31,41
44459,Judy,2,Entire home/apt,100,179,5.69,279
44460,Claudia,1,Private room,48,0,0.5,48
44461,Alcira,2,Private room,40,0,1.74,40
44463,Cecilia,2,Entire home/apt,150,130,2.73,280
44466,Diego,3,Private room,56,179,5.37,235
44467,Noreen,3,Entire home/apt,199,316,3.46,515
44468,Nikolas,1,Entire home/apt,120,0,1.82,120
44470,Artie,2,Entire home/apt,95,38,1.62,133
44471,Junyi,1,Private room,50,15,0.42,65
44472,Gen,1,Private room,70,97,4.93,167
44473,Taylor,1,Private room,110,331,1.76,441
44474,Benny,1,Entire home/apt,259,32,5.45,291
44475,Matt,1,Entire home/apt,190,144,2.14,334
44477,Ben,2,Private room,100,365,2.03,465
44478,Nicholas,2,Entire home/apt,200,229,2.0,429
44481,Angel,1,Entire home/apt,249,88,5.29,337
44482,Sophia,2,Entire home/apt,300,25,1.84,325
44484,Clint,1,Entire home/apt,128,236,4.66,364
44485,Joanna,2,Private room,120,180,2.0,300
44486,Nawar,1,Entire home/apt,134,13,2.65,147
44487,Gary,1,Entire home/apt,389,0,1.0,389
44489,Luke,1,Private room,70,71,2.57,141
44490,Zara,1,Entire home/apt,380,321,1.8,701
44491,Kia,2,Private room,75,0,7.12,75
44492,Marina,5,Entire home/apt,115,231,2.0,346
44493,Rovena,1,Entire home/apt,239,140,4.53,379
44494,Brisa,2,Entire home/apt,140,200,3.86,340
44495,Monica,1,Entire home/apt,180,22,2.4,202
44496,Yiwei,1,Private room,45,2,2.05,47
44498,Basil Walker,4,Private room,27,60,3.5,87
44500,Terly,3,Entire home/apt,210,142,1.13,352
44501,Renee & Roscoe,1,Entire home/apt,499,194,2.73,693
44503,Yu,1,Private room,129,128,4.03,257
44504,Owen,1,Shared room,60,90,2.31,150
44505,Alissandra,1,Entire home/apt,299,170,5.0,469
44506,Suzen,2,Entire home/apt,150,14,1.2,164
44508,Andrea,2,Entire home/apt,94,0,0.57,94
44509,Christian,2,Entire home/apt,300,0,2.07,300
44510,Adelaide,1,Entire home/apt,160,21,2.45,181
44511,Laura,1,Entire home/apt,200,298,2.94,498
44512,Robert,2,Entire home/apt,132,191,0.94,323
44516,Rj,1,Entire home/apt,139,1,0.92,140
44517,Saf,2,Entire home/apt,129,167,3.0,296
44518,Andres,2,Entire home/apt,100,5,4.09,105
44519,Alex,2,Private room,65,65,6.92,130
44524,Valentina,3,Private room,50,81,7.06,131
44525,Daria,2,Private room,55,50,6.0,105
44526,Susan,2,Private room,89,188,1.0,277
44527,Nam,3,Private room,60,180,2.81,240
44528,Stephanie,2,Entire home/apt,175,35,0.63,210
44529,Jk,1,Private room,85,9,5.79,94
44531,Hugo,1,Private room,60,0,4.58,60
44534,Sonder (NYC),1,Entire home/apt,100,358,0.88,458
44535,Carol,4,Entire home/apt,120,45,2.5,165
44539,Victor,1,Entire home/apt,129,5,8.38,134
44540,Fanny,2,Private room,70,179,2.54,249
44542,Danielle,1,Entire home/apt,250,18,0.79,268
44543,Patrice,3,Private room,60,365,4.41,425
44544,Fanny,2,Private room,50,160,1.88,210
44546,Nick,2,Shared room,24,14,3.33,38
44547,Soffia,2,Private room,79,83,1.0,162
44549,Jesse,1,Entire home/apt,359,193,3.33,552
44551,Ellen,1,Entire home/apt,135,333,2.2,468
44555,Mila,2,Private room,70,349,5.54,419
44556,Polina,1,Entire home/apt,250,162,3.27,412
44557,Avery,1,Entire home/apt,499,132,3.46,631
44558,Tim,1,Entire home/apt,300,231,3.89,531
44559,Joanne,3,Entire home/apt,64,37,3.05,101
44561,Mila,2,Private room,59,347,10.31,406
44562,Virginia,2,Private room,69,4,1.46,73
44563,Ron,2,Entire home/apt,120,64,2.5,184
44564,Jordi,1,Entire home/apt,349,41,5.0,390
44566,Joseph Luis,1,Entire home/apt,589,109,4.0,698
44567,Dane,1,Entire home/apt,325,157,2.79,482
44568,Penelope,2,Private room,63,0,0.7,63
44572,Julie,2,Entire home/apt,175,14,1.15,189
44575,Ofer,1,Entire home/apt,200,4,1.97,204
44576,Lia And Patrick,1,Entire home/apt,449,222,3.26,671
44577,Zana,1,Entire home/apt,200,190,4.58,390
44581,Jose,3,Private room,60,88,6.46,148
44583,Eileen,5,Private room,65,179,1.0,244
44584,Fernando,3,Private room,55,35,0.5,90
44588,Kevin And Karen,2,Entire home/apt,279,112,5.69,391
44589,Carol,4,Entire home/apt,120,45,1.0,165
44591,Matt,1,Entire home/apt,350,12,0.81,362
44593,Michael,1,Private room,112,1,3.39,113
44594,Yehudit,2,Entire home/apt,120,177,1.29,297
44599,Nick,1,Entire home/apt,438,136,3.1,574
44600,Monica,2,Private room,49,16,1.4,65
44601,Kennedy,2,Private room,99,365,1.34,464
44604,Dennis,1,Entire home/apt,650,126,1.58,776
44605,David,2,Entire home/apt,247,346,3.53,593
44607,Diana,2,Private room,125,5,0.45,130
44610,Chioma,2,Private room,35,158,3.62,193
44611,Juanit,1,Entire home/apt,380,123,2.05,503
44613,Jess,2,Private room,70,55,3.62,125
44624,Adam,2,Private room,90,1,0.6,91
44625,Paul,2,Entire home/apt,200,0,1.0,200
44628,Annette,1,Entire home/apt,399,135,3.0,534
44630,Kiarash,1,Entire home/apt,200,0,0.54,200
44631,Ben,2,Entire home/apt,90,0,1.0,90
44632,Carol,4,Entire home/apt,145,48,0.64,193
44633,Shanae,1,Entire home/apt,190,299,2.95,489
44634,Diego,3,Private room,58,179,5.45,237
44635,Gabby,1,Entire home/apt,341,274,2.31,615
44638,Diego,3,Private room,58,176,2.73,234
44639,Pauline,3,Private room,150,356,2.26,506
44640,Alida,2,Private room,90,0,1.8,90
44641,Diego,3,Private room,53,180,5.37,233
44642,Monica,1,Entire home/apt,299,4,0.91,303
44643,Diego,3,Private room,53,176,4.93,229
44644,Emily,1,Entire home/apt,190,322,1.36,512
44645,Rina,3,Entire home/apt,179,23,2.59,202
44648,Leul,2,Private room,49,158,0.75,207
44649,Lee And Teri,2,Entire home/apt,85,113,5.0,198
44650,Emily,1,Entire home/apt,190,189,0.53,379
44651,Tim & Cecilia,1,Private room,49,16,4.07,65
44652,Meital,2,Private room,50,124,3.82,174
44654,Diego,3,Private room,80,179,5.0,259
44655,Sam,1,Private room,85,69,0.48,154
44656,Ameera,1,Private room,94,77,1.3,171
44657,Xavier,1,Private room,95,94,4.58,189
44658,Yuvraj,3,Private room,42,292,2.77,334
44659,Mathieu,1,Entire home/apt,250,0,1.88,250
44660,Michelle,1,Private room,145,365,0.63,510
44661,Jackie,3,Private room,79,281,1.05,360
44662,Jayelle,1,Entire home/apt,389,65,2.26,454
44663,Moolchand,3,Private room,50,89,3.0,139
44664,Kay,3,Entire home/apt,150,25,3.18,175
44666,Moolchand,3,Private room,50,89,1.76,139
44667,Teddy,1,Entire home/apt,159,1,2.93,160
44669,Greem,2,Private room,61,138,3.06,199
44670,Sonder (NYC),1,Entire home/apt,179,339,1.0,518
44672,Maria,1,Private room,120,357,4.76,477
44673,David,1,Entire home/apt,195,2,2.77,197
44674,Gregory,2,Private room,70,0,1.2,70
44676,Errol,2,Private room,75,158,2.0,233
44677,Thomas,2,Private room,75,22,1.84,97
44678,Jian F,2,Private room,76,102,6.23,178
44679,Renee,2,Private room,50,365,0.88,415
44681,David,2,Entire home/apt,100,7,1.0,107
44686,Giovanni,1,Entire home/apt,240,19,1.0,259
44687,Rene,1,Private room,100,359,3.87,459
44691,Kayser,1,Private room,55,86,2.0,141
44692,Adriana,2,Private room,55,11,0.51,66
44693,Rina,3,Entire home/apt,150,56,2.07,206
44696,Nachi,1,Entire home/apt,230,0,0.5,230
44697,Rina,3,Entire home/apt,179,76,2.54,255
44699,Geraldine,2,Entire home/apt,180,5,2.09,185
44700,Rina,3,Entire home/apt,179,75,2.22,254
44701,Dipika,1,Entire home/apt,150,93,1.0,243
44702,Egle,2,Entire home/apt,240,0,1.4,240
44703,Eileen,5,Entire home/apt,130,363,1.0,493
44704,Jack,1,Private room,89,168,6.67,257
44705,Dennis,1,Private room,150,50,4.21,200
44707,Jordon,1,Entire home/apt,165,0,1.55,165
44708,Ruby,1,Entire home/apt,160,4,1.0,164
44709,Alex,1,Entire home/apt,379,219,3.06,598
44710,Roukayatou,4,Private room,36,97,4.09,133
44711,Patricia,3,Private room,32,302,5.68,334
44712,Dennis,1,Private room,200,51,2.42,251
44713,Rafaelo,1,Private room,98,1,0.94,99
44714,Fernando,5,Private room,99,176,2.0,275
44715,Thomas,2,Private room,65,31,0.5,96
44719,LaTasha,2,Entire home/apt,100,120,1.73,220
44721,Sky,1,Entire home/apt,230,43,0.65,273
44723,Jessica,2,Private room,75,0,1.64,75
44724,Yaz,2,Private room,85,83,1.53,168
44725,Yves,1,Entire home/apt,449,132,1.0,581
44726,Misael,1,Entire home/apt,399,93,2.5,492
44727,Dave,1,Private room,85,90,3.0,175
44728,Crystal,2,Entire home/apt,100,26,2.22,126
44729,Nicholas,2,Entire home/apt,82,0,1.11,82
44730,Miata,1,Private room,65,56,1.8,121
44731,Windy,1,Private room,100,51,0.46,151
44732,Aamito,1,Private room,85,76,1.9,161
44734,Naomi,1,Entire home/apt,290,23,2.45,313
44735,Gabriella,2,Entire home/apt,190,0,1.43,190
44736,Joe,1,Entire home/apt,120,305,1.9,425
44737,Jeanne,1,Entire home/apt,161,317,4.15,478
44742,Gus,1,Entire home/apt,595,39,2.35,634
44743,Natalia,1,Entire home/apt,250,61,0.88,311
44744,Asher,1,Entire home/apt,299,119,1.91,418
44745,Adam,2,Private room,69,0,0.52,69
44747,Nikoulas & Julie,1,Entire home/apt,199,164,4.66,363
44748,Fabio & Angie,1,Entire home/apt,399,182,3.27,581
44749,Afrah,2,Private room,50,328,0.45,378
44750,Sofia,2,Private room,48,249,6.36,297
44751,Francisco,1,Entire home/apt,365,101,1.33,466
44752,Gus,1,Private room,75,84,5.19,159
44753,Gus,1,Private room,150,160,2.31,310
44754,Akil,5,Private room,50,179,5.0,229
44755,Gus,1,Private room,150,185,5.12,335
44757,Ariel,1,Entire home/apt,250,100,3.56,350
44758,Gus,1,Private room,150,188,5.19,338
44760,Erick,1,Private room,350,143,2.67,493
44761,Allan,1,Entire home/apt,335,221,3.19,556
44762,Roukayatou,4,Private room,40,121,5.08,161
44763,Peter & Giulia,1,Entire home/apt,399,145,3.81,544
44764,Alina,2,Private room,100,20,14.0,120
44765,Egon,1,Entire home/apt,320,189,4.2,509
44766,Jacob,1,Entire home/apt,150,101,2.55,251
44767,Irina,1,Entire home/apt,120,340,1.0,460
44768,Frank,3,Entire home/apt,69,36,1.5,105
44769,Ethan,2,Entire home/apt,250,92,5.29,342
44770,April G,2,Private room,64,178,0.63,242
44771,Baktiar,1,Entire home/apt,340,302,1.0,642
44774,Lizbeth,3,Private room,49,70,0.79,119
44775,Fanny + Matthew,2,Entire home/apt,119,45,4.86,164
44777,Eileen,5,Private room,65,364,1.0,429
44779,Dennis,1,Private room,325,67,3.21,392
44780,Dmitriy & Amy,1,Entire home/apt,485,240,1.46,725
44781,Kyle,2,Entire home/apt,110,252,4.0,362
44782,Yana,1,Private room,115,59,1.0,174
44783,Rufina,2,Private room,55,360,3.44,415
44784,Jacob,3,Entire home/apt,99,152,5.26,251
44785,Marissa,1,Entire home/apt,148,8,1.0,156
44786,Maja,1,Entire home/apt,95,25,0.77,120
44787,Robert,1,Entire home/apt,300,180,3.4,480
44788,Souadou,4,Private room,95,325,2.35,420
44789,Joseph,3,Private room,70,69,1.76,139
44790,David And Annette,2,Private room,50,361,0.45,411
44791,David And Annette,2,Private room,40,350,1.82,390
44792,Zhen Zhen,3,Entire home/apt,145,38,1.22,183
44794,Candice,1,Entire home/apt,149,0,0.71,149
44795,Mike,2,Private room,42,64,4.91,106
44796,Nathan,1,Entire home/apt,89,186,0.57,275
44797,Ramon,1,Entire home/apt,300,61,6.92,361
44798,Nelly,2,Private room,43,343,2.0,386
44800,Jess & Ana,3,Shared room,25,351,6.0,376
44801,Abby,2,Shared room,25,129,0.75,154
44803,Tyler,1,Entire home/apt,349,93,2.67,442
44804,Grace,3,Entire home/apt,150,24,2.38,174
44807,Alwin,1,Entire home/apt,160,8,2.0,168
44808,Hugo & Amelia,1,Entire home/apt,479,159,2.68,638
44810,Michael H.Y.,2,Private room,69,318,8.18,387
44812,Leyland,4,Private room,35,27,4.0,62
44813,Cha,2,Private room,60,147,4.35,207
44814,Vitória,2,Private room,58,168,2.35,226
44816,Vitória,2,Private room,58,167,1.48,225
44817,Santi,3,Entire home/apt,299,341,1.62,640
44818,Santi,3,Entire home/apt,299,357,2.05,656
44819,Vitória,2,Private room,58,164,2.14,222
44820,Vitória,2,Private room,58,171,6.67,229
44821,Santi,3,Private room,99,360,4.15,459
44822,Evgen,2,Private room,100,31,3.44,131
44823,Santi,3,Private room,79,348,7.26,427
44824,Joseph,1,Entire home/apt,299,158,4.36,457
44825,Arantza,1,Entire home/apt,200,5,1.36,205
44827,Rafu,3,Entire home/apt,149,298,1.11,447
44828,Nubia,2,Private room,58,122,3.05,180
44829,Santi,3,Private room,89,357,4.5,446
44830,Santi,3,Private room,99,352,3.44,451
44831,Santi,3,Private room,79,360,4.14,439
44832,Santi,3,Private room,89,358,6.28,447
44833,Stefan,3,Entire home/apt,155,59,1.0,214
44834,Yaron,2,Private room,99,180,2.26,279
44835,Jacquelyn,3,Private room,65,104,4.04,169
44836,Santi,3,Private room,79,350,7.14,429
44837,Roberto,1,Entire home/apt,399,105,2.59,504
44840,Greg,1,Entire home/apt,600,0,0.68,600
44841,Anastasiia,2,Private room,90,58,5.59,148
44842,Jenn And Mike,4,Entire home/apt,100,51,4.71,151
44843,Shem,2,Entire home/apt,125,145,1.64,270
44844,Marcelo,2,Private room,60,9,1.05,69
44846,Charlie,1,Private room,130,24,5.0,154
44849,Arlene,4,Private room,29,18,1.43,47
44851,Jay,1,Private room,125,335,1.0,460
44852,Malik,3,Entire home/apt,119,311,2.35,430
44854,Dennis,1,Entire home/apt,360,243,2.05,603
44855,Kamila,1,Shared room,43,358,1.43,401
44856,Simon,1,Entire home/apt,280,192,3.53,472
44857,Víctor,2,Private room,60,322,2.31,382
44858,Angel,4,Entire home/apt,309,173,5.56,482
44859,Arturo,1,Entire home/apt,215,45,0.97,260
44861,Gpa,2,Private room,49,325,2.0,374
44862,Angel,1,Entire home/apt,115,279,3.0,394
44864,David,1,Entire home/apt,500,0,0.7,500
44866,Uta,1,Private room,69,30,1.71,99
44867,Rosa,2,Private room,70,105,0.53,175
44869,Samuel,2,Private room,40,340,1.0,380
44870,Annette,5,Entire home/apt,135,0,1.0,135
44871,Heather,3,Entire home/apt,90,354,7.92,444
44872,Rem,4,Shared room,28,64,2.07,92
44873,Jose,4,Private room,37,315,6.21,352
44874,Mariana,2,Entire home/apt,150,4,4.12,154
44875,Daria,1,Entire home/apt,170,0,1.0,170
44876,Clement,1,Entire home/apt,750,263,2.22,1013
44877,Chantal,1,Private room,85,67,1.0,152
44878,Kimberly,3,Entire home/apt,254,24,1.46,278
44879,Patrick,2,Private room,50,0,5.0,50
44880,Rem,4,Shared room,28,71,2.03,99
44881,Warren,1,Private room,140,87,3.75,227
44882,June And Eunice,1,Entire home/apt,367,229,1.0,596
44884,Morad,1,Entire home/apt,165,346,1.33,511
44885,Bertin,1,Private room,55,330,4.44,385
44886,Hunter,2,Private room,45,0,2.73,45
44887,Patricia,3,Entire home/apt,96,157,4.44,253
44888,Thomas,2,Private room,70,20,2.9,90
44890,Rock,2,Private room,60,167,3.91,227
44891,Steven,1,Entire home/apt,150,67,4.36,217
44892,Luzia,1,Entire home/apt,345,212,1.67,557
44893,Hotel Mela,1,Private room,100,296,4.04,396
44897,Hotel Mela,1,Private room,100,300,2.0,400
44898,Hotel Mela,1,Private room,100,298,1.36,398
44900,Shawana,2,Private room,65,3,3.87,68
44902,Yoel,2,Entire home/apt,259,202,6.0,461
44903,Tom,1,Private room,100,116,3.4,216
44904,Josh,2,Entire home/apt,78,14,2.0,92
44905,Marion,1,Entire home/apt,178,52,1.36,230
44906,Talia,2,Entire home/apt,135,43,3.0,178
44907,Nilbia,2,Private room,45,0,1.58,45
44908,Monica,2,Private room,70,361,1.3,431
44909,Charles,1,Entire home/apt,265,45,2.26,310
44910,Gladwyn,2,Entire home/apt,140,365,4.41,505
44911,Marshall,2,Entire home/apt,130,90,0.65,220
44912,Bar,2,Entire home/apt,175,71,2.0,246
44917,Kevin,1,Entire home/apt,341,245,1.76,586
44919,Lasse,1,Entire home/apt,320,212,3.26,532
44920,Emile,1,Entire home/apt,549,155,4.29,704
44922,Stephen,1,Entire home/apt,290,8,1.13,298
44923,Karl Andrei,1,Entire home/apt,149,182,0.77,331
44924,Lorraine,2,Entire home/apt,150,345,2.43,495
44929,Diana,2,Private room,130,136,1.53,266
44930,Aminul,2,Private room,38,258,1.2,296
44933,Juliette,2,Private room,95,66,1.76,161
44935,Michel,1,Entire home/apt,599,135,4.0,734
44936,John,1,Entire home/apt,160,43,5.22,203
44937,Aminul,2,Private room,38,296,1.7,334
44938,Kelly,2,Entire home/apt,200,50,2.45,250
44940,Aminul,2,Private room,38,282,2.35,320
44941,Aminul,2,Private room,38,239,1.61,277
44943,Me,1,Entire home/apt,243,97,1.0,340
44944,Kristina,3,Entire home/apt,100,2,4.04,102
44947,Park Lane,1,Private room,350,365,2.0,715
44951,Park Lane,1,Private room,450,365,2.43,815
44952,Park Lane,1,Private room,375,349,1.0,724
44955,Park Lane,1,Private room,425,357,1.0,782
44958,Park Lane,1,Private room,425,340,1.0,765
44960,The James New York - SoHo,1,Private room,100,328,1.0,428
44961,The James New York - SoHo,1,Private room,100,270,1.0,370
44963,The James New York - SoHo,1,Private room,100,292,1.0,392
44976,Royalton,1,Private room,100,317,0.94,417
44977,Royalton,1,Private room,100,309,3.0,409
44978,Royalton,1,Private room,100,318,3.0,418
44979,Royalton,1,Private room,100,317,1.0,417
44986,Manhattan At Times Square,1,Private room,100,349,2.0,449
44987,Pau,1,Entire home/apt,211,63,2.5,274
44988,Manhattan At Times Square,1,Private room,300,304,5.0,604
44993,Manhattan At Times Square,1,Private room,100,351,1.0,451
45012,Manhattan At Times Square,1,Private room,100,359,2.0,459
45013,Manhattan At Times Square,1,Private room,100,359,4.0,459
45015,The Michelangelo,1,Private room,100,0,2.0,100
45016,The Michelangelo,1,Private room,100,320,1.0,420
45022,Sondre,1,Entire home/apt,290,268,6.11,558
45023,Ranjit,3,Entire home/apt,400,281,0.86,681
45024,Steven,1,Entire home/apt,250,342,1.0,592
45025,John,2,Private room,60,87,4.82,147
45026,Corey,1,Entire home/apt,150,15,4.9,165
45030,Matt,1,Entire home/apt,275,15,1.76,290
45031,Inieta,1,Entire home/apt,945,264,7.02,1209
45032,Laura,4,Private room,47,236,1.36,283
45033,Frank,3,Entire home/apt,79,336,4.36,415
45034,David,1,Entire home/apt,179,260,2.26,439
45035,Magda,1,Entire home/apt,150,3,1.36,153
45036,Samantha,2,Entire home/apt,154,0,1.4,154
45037,Michele,1,Private room,65,33,3.0,98
45038,Talia,2,Entire home/apt,109,5,0.98,114
45040,Horacio,2,Private room,60,27,5.9,87
45041,Andrew,2,Entire home/apt,100,35,1.73,135
45042,Shamsur,2,Entire home/apt,500,363,2.0,863
45043,David,2,Entire home/apt,149,268,3.0,417
45044,Shelesa,1,Entire home/apt,620,169,2.22,789
45045,Nadezhda,1,Private room,210,0,2.83,210
45047,Victoria,2,Entire home/apt,98,4,3.33,102
45048,Michael,3,Private room,65,0,2.0,65
45049,Gabriella,1,Entire home/apt,200,280,5.08,480
45050,Sharon,2,Entire home/apt,115,133,2.35,248
45051,Amanda,1,Entire home/apt,285,179,1.0,464
45052,Mark,3,Entire home/apt,140,254,5.0,394
45054,Maco,2,Private room,54,339,4.21,393
45055,Michael,3,Private room,90,90,1.25,180
45057,Kathleen,1,Entire home/apt,215,14,0.98,229
45058,Edgar,3,Entire home/apt,86,125,1.0,211
45059,Andrew,2,Entire home/apt,305,179,1.0,484
45060,Anna,3,Entire home/apt,99,139,1.18,238
45064,Zahira,2,Entire home/apt,125,74,1.0,199
45066,Afrah,2,Private room,50,62,1.8,112
45067,Yankee,4,Private room,70,89,2.95,159
45068,Veronica,3,Private room,100,342,0.79,442
45069,Sunny,1,Entire home/apt,350,86,2.79,436
45070,Lester,1,Private room,115,179,2.05,294
45072,Lester,1,Private room,105,180,2.4,285
45077,The Wagner Hotel,1,Private room,100,339,1.0,439
45079,Lester,1,Private room,105,180,1.61,285
45080,Mike,2,Private room,100,63,2.67,163
45082,Lucy,2,Private room,73,36,1.18,109
45092,Evelyn,3,Entire home/apt,150,23,0.81,173
45096,Samantha,3,Entire home/apt,185,41,1.36,226
45098,Stephen,1,Private room,140,85,1.25,225
45099,Doreen,2,Private room,85,319,4.58,404
45101,Rock,2,Private room,60,174,4.66,234
45102,Gladwyn,2,Private room,120,365,1.76,485
45103,Johan,3,Entire home/apt,150,146,3.0,296
45104,Jean,2,Entire home/apt,150,159,3.57,309
45107,James & Shannon,1,Entire home/apt,400,125,6.23,525
45108,Todd,2,Private room,50,39,1.71,89
45109,Gladwyn,2,Private room,100,365,1.0,465
45111,Ben,2,Private room,125,89,1.0,214
45116,Jessica,1,Entire home/apt,583,334,1.0,917
45118,Lyric At 70 Pine,1,Entire home/apt,299,312,8.0,611
45122,Wj,5,Private room,55,10,1.0,65
45123,Enoch,2,Entire home/apt,200,72,3.08,272
45124,Jay,2,Entire home/apt,140,81,0.52,221
45126,Denise,1,Entire home/apt,250,254,1.76,504
45127,Dave,1,Private room,85,90,3.0,175
45128,Myriah,2,Entire home/apt,275,27,2.67,302
45129,Maria,1,Private room,55,10,0.59,65
45131,Dominique,2,Entire home/apt,94,1,3.13,95
45132,Jahziel,2,Private room,70,282,1.0,352
45135,Imperial,4,Private room,45,365,3.5,410
45136,Dan,1,Entire home/apt,390,79,5.0,469
45137,Chris,3,Entire home/apt,129,361,0.53,490
45138,Jane,1,Entire home/apt,310,101,3.13,411
45139,Windy,1,Private room,78,41,1.73,119
45140,Vlasta,2,Private room,200,0,4.21,200
45143,Alena Devi,1,Entire home/apt,170,9,1.62,179
45144,Robert And Carrie,1,Entire home/apt,349,52,4.0,401
45145,Maco,2,Private room,48,96,2.22,144
45146,Mark,1,Private room,97,117,4.17,214
45148,Sonder (NYC),1,Entire home/apt,222,315,0.73,537
45149,Saba,3,Private room,48,264,6.1,312
45150,Nelly,2,Private room,43,341,0.79,384
45151,Ika,1,Entire home/apt,150,146,2.0,296
45152,Damien,2,Entire home/apt,94,9,1.8,103
45153,Sharlene,4,Private room,55,310,5.26,365
45154,Saba,3,Private room,48,258,10.17,306
45155,Zach,1,Entire home/apt,285,229,5.09,514
45156,Andy,3,Entire home/apt,95,348,3.46,443
45166,Sonder (NYC),1,Entire home/apt,130,361,1.0,491
45169,Dean,1,Entire home/apt,224,16,2.0,240
45170,Gabriel,1,Private room,999,348,4.17,1347
45171,Jean,3,Shared room,35,90,0.57,125
45172,Safia,1,Entire home/apt,160,288,2.14,448
45174,Jess,3,Entire home/apt,220,45,1.55,265
45175,Carrie,3,Entire home/apt,189,8,5.0,197
45176,Earl,2,Private room,120,88,1.58,208
45180,David,2,Entire home/apt,249,161,1.3,410
45182,Luke,1,Private room,75,340,0.57,415
45183,Bobby,1,Entire home/apt,300,0,0.6,300
45184,Haneef,3,Entire home/apt,200,0,1.2,200
45185,Cheryl,2,Entire home/apt,2500,168,0.94,2668
45190,Nc,1,Entire home/apt,299,194,5.79,493
45193,Jermaine,2,Entire home/apt,150,354,7.89,504
45194,Bríet,2,Private room,85,19,1.25,104
45195,Zarrar,1,Entire home/apt,180,0,0.59,180
45196,Alex,1,Entire home/apt,420,144,3.1,564
45197,Kam,1,Entire home/apt,299,347,4.12,646
45198,Holly,1,Entire home/apt,245,152,2.55,397
45201,Melinda,2,Private room,65,145,3.67,210
45202,Young,3,Entire home/apt,146,89,5.0,235
45203,Eve,2,Entire home/apt,125,155,4.0,280
45204,Tom,1,Entire home/apt,400,3,2.5,403
45205,Sandra,2,Entire home/apt,175,329,2.0,504
45206,John Ghaddie,1,Entire home/apt,159,244,2.45,403
45207,Kay,1,Private room,49,23,0.7,72
45208,Abby,2,Shared room,20,342,0.77,362
45209,Regan,3,Entire home/apt,125,13,0.65,138
45210,Javier,2,Private room,64,0,2.65,64
45212,Amy,2,Private room,88,0,0.59,88
45214,Sammy,1,Entire home/apt,199,85,2.83,284
45215,Oscar,3,Entire home/apt,115,80,1.18,195
45216,Michaela,3,Private room,36,4,1.96,40
45217,Zack,3,Entire home/apt,99,164,5.4,263
45219,Luis,1,Entire home/apt,99,0,2.88,99
45220,Lyuba,1,Entire home/apt,150,21,2.88,171
45222,Rolando,1,Entire home/apt,199,176,0.67,375
45224,Jimmo And Ames,2,Entire home/apt,240,85,2.0,325
45225,Maureen,1,Entire home/apt,175,1,4.29,176
45226,Lynn L,3,Private room,45,176,1.4,221
45228,Sylvia,2,Private room,70,189,1.05,259
45229,Roger,2,Entire home/apt,180,330,5.4,510
45230,Alexa,2,Entire home/apt,149,6,2.0,155
45231,Qing,3,Entire home/apt,69,46,7.63,115
45233,Shasha,2,Private room,35,364,4.04,399
45235,Shasha,2,Private room,75,360,1.0,435
45236,Shasha,2,Private room,75,151,1.07,226
45237,David,2,Entire home/apt,125,18,2.4,143
45238,Sammy,2,Private room,60,77,3.53,137
45239,Karuna,2,Private room,35,1,1.4,36
45242,Florentino,1,Shared room,75,365,0.58,440
45243,Pelin,2,Private room,62,66,2.73,128
45244,Mike,2,Private room,100,365,3.6,465
45245,Evelyn,3,Entire home/apt,150,34,2.0,184
45246,Gina,3,Entire home/apt,130,350,5.0,480
45247,Noah,3,Entire home/apt,299,155,3.6,454
45250,Alex,4,Entire home/apt,70,96,4.62,166
45252,Jennifer,2,Private room,60,97,1.0,157
45253,Zankhana,2,Private room,100,45,3.96,145
45257,Clara,1,Entire home/apt,290,161,2.0,451
45258,Andriy,1,Entire home/apt,200,69,7.96,269
45259,Lila,1,Private room,94,61,1.0,155
45260,Chantal,4,Private room,50,88,6.73,138
45262,Catherine,4,Private room,60,180,1.71,240
45263,Jenny-Lynne,1,Entire home/apt,250,171,2.0,421
45264,Victor,1,Entire home/apt,210,52,1.7,262
45265,Javier,2,Entire home/apt,400,308,1.71,708
45266,Catherine,4,Private room,60,179,3.75,239
45267,Carmen,2,Entire home/apt,300,355,1.88,655
45268,Bani,1,Entire home/apt,300,59,3.33,359
45269,Luis Enrique,2,Private room,36,343,0.52,379
45271,Kate,2,Entire home/apt,300,355,1.4,655
45272,Dennis,1,Private room,91,63,3.49,154
45273,Beth,3,Entire home/apt,200,11,0.79,211
45275,Dennis,1,Private room,150,52,4.62,202
45276,Allison,2,Entire home/apt,350,22,2.0,372
45279,Amanda,1,Entire home/apt,150,103,1.0,253
45282,Spice,2,Entire home/apt,240,154,2.0,394
45283,Vivian,1,Entire home/apt,255,188,1.4,443
45285,Andy,1,Entire home/apt,180,19,1.58,199
45286,Valentina,1,Private room,55,325,2.0,380
45287,Cc,2,Private room,75,76,2.35,151
45288,Valentina,1,Private room,60,268,0.56,328
45290,Rosie,2,Entire home/apt,100,80,4.19,180
45291,Bubby,2,Private room,70,4,0.77,74
45293,Jenni,2,Private room,99,8,1.0,107
45294,Cristina,1,Entire home/apt,210,138,1.62,348
45295,Bilhal,4,Private room,55,351,3.33,406
45296,Carlos,3,Entire home/apt,169,155,2.79,324
45298,Sampson,3,Shared room,40,89,2.68,129
45299,Satish,2,Private room,40,250,2.14,290
45303,Paola,1,Entire home/apt,333,365,2.35,698
45305,Mark,3,Entire home/apt,199,338,1.2,537
45308,Erin,1,Entire home/apt,200,13,2.05,213
45310,Ramie,2,Entire home/apt,100,329,4.44,429
45311,Keymi,1,Private room,60,326,1.18,386
45312,Darry,3,Shared room,30,365,1.0,395
45315,Alexis,1,Entire home/apt,255,12,1.36,267
45317,Jacqueline,3,Private room,50,356,12.11,406
45318,Yus,2,Private room,43,249,1.09,292
45319,Elissa,2,Private room,85,67,2.31,152
45320,Deb,1,Entire home/apt,250,173,0.54,423
45321,Nyelli,1,Entire home/apt,100,32,1.67,132
45322,Alex,1,Entire home/apt,449,346,3.21,795
45323,Eli,2,Entire home/apt,150,22,1.0,172
45324,DeAnn,2,Private room,200,87,2.05,287
45326,Emiliano,2,Entire home/apt,500,347,2.25,847
45328,Cherry,1,Private room,85,55,2.73,140
45330,Paul,2,Entire home/apt,120,14,1.0,134
45331,Nathalie + Nick,1,Entire home/apt,300,258,2.61,558
45333,Joel,1,Entire home/apt,585,139,0.54,724
45334,Paola,1,Private room,73,24,4.0,97
45337,Sherley,2,Entire home/apt,349,365,0.58,714
45338,Janko,1,Private room,80,42,5.51,122
45340,Andrew,1,Entire home/apt,200,0,1.0,200
45341,Meeks,2,Private room,85,81,11.84,166
45343,Sally,2,Private room,55,28,0.79,83
45344,Kosta,3,Private room,100,67,6.82,167
45345,David,1,Entire home/apt,350,85,1.22,435
45346,Salome,1,Private room,125,81,1.0,206
45347,Kathryn,2,Private room,35,18,3.16,53
45348,Michelle,3,Private room,75,8,4.0,83
45349,David,3,Private room,35,234,4.44,269
45351,Sylvia,3,Entire home/apt,83,16,0.86,99
45352,Veronica,1,Private room,130,74,2.0,204
45353,Brenda,2,Entire home/apt,275,339,4.04,614
45354,John,2,Private room,54,365,0.59,419
45355,Jungyen,3,Private room,99,90,2.0,189
45356,Jordan,2,Entire home/apt,225,359,4.38,584
45359,Jungyen,3,Private room,59,362,4.82,421
45361,H Ai,3,Private room,45,83,1.0,128
45362,Iris,3,Entire home/apt,90,50,1.0,140
45364,Desiree,2,Entire home/apt,100,0,1.18,100
45366,Paola,1,Private room,80,194,0.79,274
45367,Eliana,1,Entire home/apt,250,34,0.88,284
45368,Kori,2,Entire home/apt,300,57,2.94,357
45369,Gabi,1,Private room,65,104,2.35,169
45370,Torrey,2,Shared room,38,179,1.0,217
45372,Ben,1,Entire home/apt,350,231,5.11,581
45373,Stephanie,2,Entire home/apt,250,2,1.0,252
45374,Luiggi,1,Entire home/apt,269,252,5.45,521
45375,Karina,2,Private room,85,54,0.57,139
45380,Michael,1,Shared room,70,55,4.0,125
45381,Patrick,1,Entire home/apt,139,10,2.0,149
45382,Stacey & Patrice,2,Entire home/apt,149,299,4.2,448
45385,Nyma,1,Private room,100,269,3.0,369
45387,Fernanda,2,Private room,90,56,1.0,146
45388,Sophia,2,Entire home/apt,200,179,1.0,379
45389,Orit,4,Shared room,28,60,2.94,88
45391,Yves,1,Entire home/apt,499,189,3.19,688
45392,Anastasiia,2,Private room,92,16,3.4,108
45393,Orit,4,Shared room,28,73,0.67,101
45394,Carlos,3,Private room,59,24,0.68,83
45395,Shantell,3,Entire home/apt,99,15,4.86,114
45399,Orit,4,Shared room,28,365,1.15,393
45400,Eri,1,Private room,180,342,1.0,522
45401,Orit,4,Shared room,28,363,1.7,391
45402,David,1,Entire home/apt,460,287,1.33,747
45403,Douglas,3,Private room,50,35,2.0,85
45404,Rosine,4,Private room,75,363,1.0,438
45405,Ariana,1,Entire home/apt,109,233,5.11,342
45406,Ing,1,Private room,65,188,1.0,253
45407,Jack,1,Private room,89,182,2.86,271
45408,Pete,3,Entire home/apt,199,145,3.13,344
45409,Li,3,Private room,42,331,0.57,373
45411,H Ai,3,Private room,42,207,5.0,249
45412,Anika,2,Private room,65,0,1.22,65
45413,Jungyen,3,Private room,69,365,4.91,434
45416,Michelle,1,Entire home/apt,195,358,1.0,553
45417,Medina,3,Entire home/apt,320,54,5.0,374
45418,Nyma,1,Private room,100,287,7.66,387
45419,Nyma,1,Private room,100,268,11.14,368
45420,Eric,1,Entire home/apt,172,4,3.19,176
45421,Elizabeth,1,Entire home/apt,220,58,3.0,278
45422,Yahan,3,Private room,55,59,6.43,114
45424,Gregory,1,Entire home/apt,200,234,1.0,434
45425,Lee And Teri,2,Entire home/apt,85,86,3.0,171
45426,Sammy,2,Private room,50,83,3.91,133
45429,Sherley,2,Private room,95,354,0.68,449
45430,Lewis,1,Private room,57,34,1.0,91
45431,Jimmy,2,Entire home/apt,120,152,4.09,272
45432,Omwattie,2,Entire home/apt,115,123,5.83,238
45433,Rick,2,Entire home/apt,278,328,4.12,606
45434,Yasmeen,2,Entire home/apt,190,365,1.8,555
45438,Britt & Greg,2,Entire home/apt,140,143,11.16,283
45439,Adriana,4,Entire home/apt,100,330,2.79,430
45441,Samantha,2,Private room,80,314,0.79,394
45443,Julia,1,Private room,98,158,1.0,256
45444,Nyma,1,Private room,100,236,6.67,336
45445,Karmelle,2,Private room,80,83,2.88,163
45446,Christian,2,Private room,50,97,2.0,147
45447,Li,3,Private room,32,285,1.76,317
45448,Home,1,Private room,110,83,3.46,193
45449,James,2,Private room,51,71,2.31,122
45450,Yankee,4,Private room,80,89,3.0,169
45454,Imanuelly,3,Private room,90,337,1.58,427
45456,Aaron,1,Entire home/apt,212,0,1.0,212
45458,Will AND Kelly,1,Entire home/apt,500,257,1.0,757
45459,Leo,1,Private room,65,2,1.36,67
45460,Keira,2,Private room,60,0,0.61,60
45461,Jungyen,3,Private room,99,365,5.77,464
45463,Margarita,2,Entire home/apt,90,22,5.0,112
45464,Brandon,2,Private room,51,0,2.86,51
45465,Brandon,2,Private room,56,1,3.06,57
45466,Ozzie,2,Entire home/apt,265,3,1.0,268
45467,Brandon,2,Private room,56,0,1.58,56
45468,John,1,Entire home/apt,219,316,4.2,535
45469,Rebecca,2,Private room,68,36,6.32,104
45471,Carlos,2,Entire home/apt,160,120,7.96,280
45472,Marie,1,Entire home/apt,250,188,4.47,438
45473,Fabio,2,Private room,125,172,0.94,297
45475,Lisa And Julian,2,Private room,68,0,1.28,68
45478,Orit,4,Shared room,28,362,2.65,390
45479,Trey,1,Entire home/apt,175,341,4.88,516
45480,Britt,1,Entire home/apt,123,327,3.95,450
45481,Wenfei,1,Entire home/apt,140,9,0.68,149
45482,Cherry,1,Private room,90,39,1.0,129
45484,Daniel,2,Private room,250,365,0.59,615
45485,Vitalika,1,Entire home/apt,250,98,2.0,348
45486,Victoria,2,Private room,29,0,0.75,29
45487,Thelma,1,Private room,50,0,0.57,50
45488,Manvi,1,Entire home/apt,479,286,2.73,765
45489,Giulio,2,Private room,75,0,4.2,75
45490,Suping,3,Private room,50,89,1.62,139
45493,Na'ama,1,Private room,60,316,7.5,376
45494,Estrella Y.,1,Private room,110,12,1.36,122
45496,Andrew,1,Entire home/apt,175,0,2.0,175
45497,Gabriel,1,Entire home/apt,500,318,6.73,818
45498,Abdulla,1,Private room,79,42,5.0,121
45499,Allison,1,Entire home/apt,490,248,3.33,738
45500,Adelaida,1,Private room,94,47,5.0,141
45501,Artie,2,Entire home/apt,140,73,1.0,213
45502,Orit,4,Shared room,28,351,6.82,379
45503,Samantha,2,Private room,80,74,0.68,154
45504,Jany,3,Private room,40,346,1.82,386
45505,Tara,1,Entire home/apt,109,197,1.43,306
45506,Kuzey,1,Shared room,75,363,4.04,438
45507,Dion,3,Private room,115,304,1.15,419
45508,Joanne,2,Entire home/apt,328,19,2.81,347
45509,Rene,2,Entire home/apt,114,284,2.79,398
45511,Rick,1,Entire home/apt,166,75,2.79,241
45512,Nina,1,Entire home/apt,325,126,8.24,451
45513,Bruno,1,Entire home/apt,200,233,4.0,433
45514,Jasmina,3,Private room,80,54,3.0,134
45515,Israel,1,Entire home/apt,499,176,4.86,675
45516,Isra,1,Entire home/apt,499,199,4.05,698
45518,Imani,2,Entire home/apt,100,43,2.65,143
45519,Athena,2,Entire home/apt,120,181,3.33,301
45521,Edmea Valeria,3,Private room,50,219,3.64,269
45522,Klara,3,Private room,52,22,5.33,74
45524,Amy,1,Entire home/apt,90,12,0.83,102
45525,Nancy,1,Entire home/apt,89,173,5.88,262
45526,Daniel,1,Entire home/apt,217,235,1.67,452
45527,Alfie,1,Entire home/apt,150,66,1.96,216
45528,Kuzey,1,Shared room,76,365,3.46,441
45529,Sofi,1,Private room,70,346,3.0,416
45530,Kuzey,1,Shared room,75,365,4.62,440
45531,Angeline,2,Entire home/apt,650,352,1.0,1002
45532,Kuzey,1,Shared room,75,365,2.35,440
45533,Yaron,2,Private room,99,179,1.67,278
45534,Ro,1,Entire home/apt,249,336,2.55,585
45535,Kuzey,1,Shared room,75,365,1.76,440
45537,Kuzey,1,Shared room,75,365,2.2,440
45538,Nancy,1,Entire home/apt,85,170,3.53,255
45539,Marcia,3,Private room,75,144,2.35,219
45543,Miguel,1,Entire home/apt,195,33,7.5,228
45544,Jessica,1,Entire home/apt,300,357,8.82,657
45545,David,1,Entire home/apt,500,151,1.46,651
45546,Nick,1,Entire home/apt,199,102,3.46,301
45549,Sharon,3,Private room,77,355,0.73,432
45551,Rose,2,Entire home/apt,90,3,7.17,93
45552,Alfonso,4,Entire home/apt,100,336,1.0,436
45554,Sandra,2,Private room,60,179,1.58,239
45557,Rob,2,Private room,50,311,4.74,361
45558,Allen,2,Entire home/apt,395,22,1.0,417
45559,Candace,2,Private room,99,365,0.59,464
45563,Ash,1,Entire home/apt,200,289,1.0,489
45567,Ash,1,Entire home/apt,190,302,1.0,492
45569,Ash,1,Entire home/apt,300,333,1.0,633
45573,Samantha,2,Private room,70,27,3.0,97
45575,Jay,2,Entire home/apt,659,334,3.0,993
45576,Jason,2,Entire home/apt,650,359,3.64,1009
45577,Melissa,2,Entire home/apt,650,346,2.0,996
45578,Che,1,Entire home/apt,260,235,3.41,495
45580,Nadine,2,Entire home/apt,399,41,1.0,440
45581,Alaa,2,Private room,55,44,9.17,99
45584,Philip,2,Entire home/apt,475,219,2.0,694
45585,Mia,2,Entire home/apt,200,46,1.0,246
45586,Alaa,2,Private room,55,22,6.49,77
45587,Malik,3,Entire home/apt,99,357,3.0,456
45588,Alex,1,Entire home/apt,289,309,3.0,598
45589,Javier,1,Entire home/apt,499,361,4.62,860
45594,Diana,2,Shared room,25,313,0.67,338
45599,Paola,1,Entire home/apt,299,118,1.0,417
45601,Gordy,1,Entire home/apt,125,0,2.55,125
45603,Alexandra,1,Entire home/apt,95,0,1.33,95
45604,Zyad,1,Entire home/apt,250,3,1.0,253
45605,Tiffany,2,Entire home/apt,200,50,0.73,250
45607,Daniel,3,Entire home/apt,93,361,0.81,454
45608,Genevieve,2,Entire home/apt,225,273,3.83,498
45610,Jennifer,1,Entire home/apt,1000,231,5.29,1231
45611,Roddison,2,Entire home/apt,90,73,2.73,163
45614,Ashley,4,Private room,75,365,0.68,440
45615,Dimitri,1,Private room,75,90,2.55,165
45617,Michael,1,Entire home/apt,249,118,2.73,367
45618,Vin,2,Private room,44,74,5.11,118
45619,David,3,Private room,50,233,9.47,283
45622,Matthew,2,Entire home/apt,150,10,2.0,160
45623,Dolev,1,Entire home/apt,110,0,2.0,110
45624,Janet,1,Entire home/apt,93,0,2.0,93
45625,Philip,2,Entire home/apt,370,220,1.8,590
45630,Kristin Page,2,Private room,90,1,2.0,91
45631,Ieong,1,Entire home/apt,440,2,0.61,442
45634,Wu,2,Private room,40,89,5.45,129
45636,Rajeev,1,Entire home/apt,489,320,1.67,809
45639,Bill,2,Entire home/apt,203,254,3.53,457
45641,Cam,2,Entire home/apt,154,269,4.05,423
45642,睿,2,Private room,27,0,1.0,27
45646,Raquel,5,Shared room,13,8,5.51,21
45647,Layla,1,Entire home/apt,200,233,1.5,433
45648,Dennis,1,Private room,300,50,7.83,350
45649,John,2,Private room,89,97,3.49,186
45652,Dora,5,Entire home/apt,70,128,1.0,198
45653,Miguel Angel,2,Entire home/apt,399,358,5.25,757
45656,Kita,1,Entire home/apt,289,125,3.0,414
45657,Lidiya,1,Entire home/apt,117,233,2.43,350
45666,Sandra,2,Private room,7500,179,6.15,7679
45668,Indira,3,Entire home/apt,120,356,5.0,476
45673,Yoon,2,Entire home/apt,188,101,3.33,289
45674,Shradha,1,Shared room,150,67,1.25,217
45676,Brady,2,Entire home/apt,375,43,3.0,418
45677,Fmny,3,Private room,85,106,1.0,191
45679,Farah,1,Entire home/apt,175,83,1.0,258
45680,Timothy,2,Private room,65,139,1.71,204
45681,Alex,1,Entire home/apt,275,12,2.05,287
45682,Jada,4,Entire home/apt,75,355,3.95,430
45683,Fmny,3,Private room,85,112,3.0,197
45684,Heidi,2,Entire home/apt,150,1,3.64,151
45685,Fmny,3,Private room,68,136,1.0,204
45687,Malik,2,Entire home/apt,150,113,2.0,263
45689,Marina,2,Entire home/apt,90,18,4.0,108
45690,Erica,2,Private room,42,53,9.47,95
45692,M. Elizabeth,1,Entire home/apt,106,5,6.0,111
45693,Lynne,1,Entire home/apt,125,321,1.4,446
45695,Marissa,1,Entire home/apt,199,148,4.57,347
45696,Ailee,2,Entire home/apt,155,0,1.0,155
45697,Duncan,2,Entire home/apt,175,0,2.25,175
45700,Sharmila,2,Entire home/apt,135,37,2.09,172
45701,Fernando,3,Entire home/apt,101,110,2.79,211
45702,Olimpia,1,Entire home/apt,299,178,2.09,477
45703,Olimpia,1,Entire home/apt,268,178,1.0,446
45706,Andrea,2,Entire home/apt,150,74,0.81,224
45707,Michael,1,Private room,55,53,3.19,108
45708,Matt & Crutch,2,Entire home/apt,85,43,2.05,128
45709,Wu,2,Private room,45,50,4.77,95
45713,Guido,1,Entire home/apt,194,44,2.0,238
45714,Ed,1,Private room,140,85,3.0,225
45715,Jaclyn,1,Private room,89,296,5.0,385
45717,Sally,2,Entire home/apt,151,14,0.81,165
45721,Alea,2,Private room,50,0,2.73,50
45724,Fmny,3,Private room,70,127,2.0,197
45726,Fmny,3,Private room,65,134,1.87,199
45727,Jessica,2,Entire home/apt,120,272,6.86,392
45729,Felix,2,Entire home/apt,90,118,0.83,208
45734,Ernesto Arauz & Flory Lopez,3,Private room,75,359,0.79,434
45736,Orlando Benjamin,2,Private room,40,2,4.0,42
45737,Chris,1,Entire home/apt,250,311,3.49,561
45738,Matthew,1,Entire home/apt,200,0,1.0,200
45739,Maher,1,Entire home/apt,180,188,1.0,368
45741,Jay,2,Entire home/apt,200,357,1.0,557
45743,Joanna,2,Entire home/apt,245,255,2.0,500
45745,Grant,1,Entire home/apt,459,354,4.29,813
45746,David,1,Entire home/apt,350,333,3.83,683
45747,Fmny,3,Private room,55,120,2.57,175
45751,Charles,2,Entire home/apt,350,26,1.36,376
45752,Helen,3,Entire home/apt,275,266,1.0,541
45753,Madison,1,Private room,78,1,5.38,79
45755,Caritas,2,Private room,60,171,1.25,231
45756,Alina,2,Private room,149,0,0.68,149
45757,Isaac,4,Private room,35,62,3.13,97
45758,Amoyiem,4,Private room,36,81,2.0,117
45759,Amoyiem,4,Private room,38,90,1.0,128
45761,Jenn And Dan,1,Private room,50,29,5.0,79
45764,Salomé,2,Entire home/apt,150,66,3.16,216
45766,Tela,1,Entire home/apt,850,341,3.0,1191
45769,Shir,1,Private room,175,203,4.0,378
45772,Dila,1,Entire home/apt,169,7,2.65,176
45773,Sofia,1,Private room,85,126,3.0,211
45774,David,5,Entire home/apt,68,4,5.33,72
45775,Ashley,2,Private room,80,84,3.0,164
45776,Vanessa,2,Private room,65,79,4.77,144
45778,Jack,1,Entire home/apt,699,301,4.0,1000
45779,Alex,2,Private room,79,22,0.77,101
45781,Jonathan,3,Entire home/apt,80,49,5.45,129
45782,Kathleen,1,Entire home/apt,130,4,1.0,134
45785,Stanley,2,Private room,58,360,0.68,418
45786,Eliza,1,Entire home/apt,135,2,1.0,137
45787,Jisoo,3,Entire home/apt,150,155,1.91,305
45789,Yekta,2,Private room,40,11,1.0,51
45790,Arlene,2,Entire home/apt,300,113,1.0,413
45791,Daniela,1,Entire home/apt,245,257,4.57,502
45792,Xun,2,Private room,35,20,2.0,55
45794,June,1,Entire home/apt,600,343,4.5,943
45796,Irina,1,Private room,245,179,2.0,424
45797,Robert,1,Entire home/apt,145,100,1.0,245
45798,Darko,1,Entire home/apt,145,70,2.0,215
45799,Melissa,1,Entire home/apt,145,94,1.0,239
45800,Preeti,1,Entire home/apt,145,37,2.0,182
45801,Rachael,1,Entire home/apt,158,8,0.7,166
45802,Ann,1,Entire home/apt,145,110,1.0,255
45803,Dayne,1,Shared room,50,81,1.0,131
45805,Laura,3,Entire home/apt,174,5,1.0,179
45806,Igor,1,Entire home/apt,150,83,2.0,233
45807,Nikki,1,Entire home/apt,239,22,7.0,261
45808,Lili,1,Entire home/apt,150,164,3.0,314
45809,Sophie,2,Private room,80,62,0.7,142
45810,Iris,3,Entire home/apt,200,9,1.0,209
45811,Dylon,1,Private room,100,55,1.62,155
45813,Bozo,1,Entire home/apt,150,78,2.81,228
45815,Joel And Marie,1,Entire home/apt,499,299,4.62,798
45816,Laura,1,Entire home/apt,300,150,0.65,450
45817,Joseph,2,Private room,55,322,1.0,377
45827,Alex,1,Entire home/apt,250,213,8.48,463
45828,Pete And Chloe,2,Private room,79,0,6.0,79
45829,Juan,1,Entire home/apt,200,157,2.43,357
45831,Richard,3,Entire home/apt,200,57,4.0,257
45833,Christian,1,Entire home/apt,120,67,1.36,187
45835,Almog,2,Entire home/apt,299,339,2.25,638
45836,David,3,Entire home/apt,48,305,6.32,353
45839,Emmanuelle,2,Private room,68,16,3.13,84
45840,Lisa,1,Entire home/apt,173,120,4.0,293
45842,Sebastian,2,Private room,50,60,6.43,110
45844,Conny,1,Private room,85,29,7.3,114
45845,Melissa,2,Entire home/apt,175,3,5.45,178
45847,Liz,1,Entire home/apt,118,17,2.0,135
45848,Shir,2,Entire home/apt,399,131,4.55,530
45849,Zeyna,3,Entire home/apt,108,5,2.0,113
45851,Nurul,3,Entire home/apt,248,354,1.3,602
45853,Ines,1,Entire home/apt,190,165,1.0,355
45855,Brenda,2,Entire home/apt,225,136,3.0,361
45856,Vin,1,Entire home/apt,175,27,1.3,202
45858,Swanny,2,Private room,130,47,2.0,177
45859,Safain,3,Entire home/apt,60,170,3.43,230
45860,Milton,1,Private room,102,353,1.0,455
45862,Jason,1,Entire home/apt,131,1,0.64,132
45863,Natalie,2,Private room,80,0,2.14,80
45865,Angie,3,Entire home/apt,200,365,2.0,565
45868,Lawrence,2,Entire home/apt,80,12,6.0,92
45869,Frederick,2,Entire home/apt,895,28,1.0,923
45875,Beatriz,1,Entire home/apt,499,177,1.5,676
45877,Beatriz,1,Entire home/apt,447,157,2.05,604
45879,Beatriz,1,Entire home/apt,447,179,2.2,626
45880,Justin,1,Entire home/apt,600,315,2.25,915
45882,Jackie,1,Entire home/apt,255,233,1.0,488
45883,Grace,1,Entire home/apt,320,0,3.0,320
45884,Joshua,2,Entire home/apt,795,298,1.0,1093
45887,Bunmi,2,Private room,56,282,2.55,338
45888,Richard,2,Entire home/apt,695,282,1.0,977
45892,Richard,2,Entire home/apt,295,298,2.0,593
45893,Bunmi,2,Private room,56,365,5.45,421
45896,Hanna,1,Private room,119,10,1.0,129
45899,Alex,1,Entire home/apt,195,6,7.83,201
45903,Joshua,2,Entire home/apt,295,321,1.0,616
45907,Walid,1,Entire home/apt,600,167,4.69,767
45909,Felipe,1,Entire home/apt,450,345,3.08,795
45912,Maria,1,Entire home/apt,399,149,1.0,548
45914,Neh,1,Entire home/apt,300,179,1.0,479
45916,Anthony,2,Entire home/apt,495,341,1.0,836
45922,Emmanuelle,2,Private room,75,0,2.0,75
45923,Jacinta,2,Entire home/apt,160,23,2.0,183
45924,Alison,2,Private room,85,35,1.0,120
45927,Jenny & Jose,2,Entire home/apt,88,31,3.53,119
45928,Nacho,1,Private room,150,73,2.0,223
45930,Cebile,2,Shared room,30,28,1.43,58
45931,Maria,3,Entire home/apt,75,14,0.91,89
45936,Samm,1,Entire home/apt,400,275,2.37,675
45940,Tasmia,3,Entire home/apt,189,212,2.0,401
45943,Emmanuelle,2,Entire home/apt,92,21,6.59,113
45954,Chloe,1,Entire home/apt,550,320,3.85,870
45960,Judy,1,Entire home/apt,180,7,5.0,187
45961,Alex,1,Entire home/apt,149,121,9.78,270
45962,Kwenhi,3,Private room,50,180,2.73,230
45963,Elnadiv,2,Entire home/apt,295,318,1.0,613
45964,Grace,2,Private room,70,75,1.0,145
45965,Elnadiv,2,Entire home/apt,295,337,1.0,632
45967,Matt,1,Entire home/apt,1099,193,2.31,1292
45968,Sal,2,Entire home/apt,129,86,6.0,215
45969,Jennifer,1,Entire home/apt,400,278,1.0,678
45971,Marcela,1,Entire home/apt,428,244,1.0,672
45972,Sophie,2,Entire home/apt,123,1,2.0,124
45973,Vivi,3,Private room,88,336,1.0,424
45975,Bella,2,Entire home/apt,89,305,5.58,394
45977,Yongqiu,3,Private room,80,359,1.76,439
45979,Abbott,1,Entire home/apt,111,12,3.33,123
45980,Mia,2,Private room,90,133,5.12,223
45981,Chuck,1,Entire home/apt,109,6,6.0,115
45982,Willie,3,Entire home/apt,68,95,3.95,163
45983,Jojo,2,Private room,38,88,0.7,126
45985,Manuel,1,Entire home/apt,360,89,2.0,449
45986,Diana,3,Entire home/apt,145,14,5.68,159
45987,Joe,3,Entire home/apt,120,336,2.0,456
45990,Jay,1,Entire home/apt,599,199,4.74,798
45993,Brian,1,Private room,100,0,3.0,100
45994,Jason,1,Entire home/apt,330,325,3.85,655
45996,Nadia,1,Entire home/apt,179,128,3.0,307
45997,Anna,1,Entire home/apt,185,107,6.56,292
45998,Daniel,1,Entire home/apt,200,303,3.95,503
46001,Kyeng Tae,1,Entire home/apt,180,259,3.0,439
46002,Ahmet,1,Shared room,75,362,1.82,437
46005,Zach,2,Entire home/apt,220,82,2.0,302
46006,Werner,1,Entire home/apt,180,262,4.0,442
46007,Ayla Silvia,2,Private room,60,1,1.67,61
46008,Hannah,3,Private room,75,167,4.17,242
46009,Alex,1,Entire home/apt,155,163,7.33,318
46010,Doil,1,Entire home/apt,180,254,2.0,434
46011,Olivia,1,Entire home/apt,180,249,7.0,429
46012,Ara,1,Entire home/apt,180,260,3.41,440
46013,Anslo,1,Entire home/apt,400,327,3.75,727
46014,Moises,1,Private room,60,211,3.24,271
46015,Maria,1,Private room,135,29,4.0,164
46016,Ahmet,1,Shared room,79,365,1.58,444
46018,Ahmet,1,Shared room,77,362,1.62,439
46019,Michelle,4,Entire home/apt,59,0,2.0,59
46020,Ahmet,1,Shared room,77,365,2.0,442
46022,Ted,1,Private room,100,67,1.0,167
46023,Ahmet,1,Shared room,69,357,6.32,426
46024,Ahmet,1,Private room,120,352,3.33,472
46025,Jorge,4,Private room,69,359,3.0,428
46026,Ahmet,1,Private room,120,198,1.0,318
46027,Zack,1,Private room,180,31,0.77,211
46028,Moises,1,Private room,60,209,4.0,269
46029,Peter,2,Private room,200,334,1.4,534
46030,Madea And Julian,2,Entire home/apt,549,333,3.33,882
46031,Charlotte,2,Private room,50,0,4.0,50
46034,Maria,1,Private room,125,123,8.0,248
46035,Jean,3,Entire home/apt,295,302,4.0,597
46036,Lidia,1,Entire home/apt,385,311,3.0,696
46037,Jeremy,1,Entire home/apt,479,120,3.0,599
46038,Maria,1,Shared room,99,15,7.5,114
46039,Studioplus,1,Entire home/apt,260,292,2.0,552
46040,Alin,3,Private room,45,64,2.14,109
46041,Paul,1,Entire home/apt,235,129,4.0,364
46043,Sara,2,Entire home/apt,198,159,3.33,357
46044,Alex,1,Entire home/apt,275,189,8.86,464
46045,Saud,1,Entire home/apt,134,26,2.0,160
46046,Regina,1,Entire home/apt,199,67,3.0,266
46047,Avelino,3,Private room,59,349,1.54,408
46048,Sara,2,Entire home/apt,198,114,2.65,312
46050,Yuriy,5,Entire home/apt,80,140,4.0,220
46051,Nan,3,Private room,50,74,5.45,124
46052,Joyann,3,Entire home/apt,150,365,1.0,515
46054,Juan,1,Entire home/apt,181,167,2.0,348
46055,Mats,1,Entire home/apt,395,65,4.55,460
46056,Tj,2,Private room,45,257,4.29,302
46057,Aisling,3,Private room,65,157,13.42,222
46058,Moises,1,Private room,57,249,3.0,306
46059,Dina,2,Private room,65,80,0.79,145
46061,Az,3,Entire home/apt,325,124,4.0,449
46062,Cecilia,4,Entire home/apt,99,120,3.0,219
46063,Ajmol,3,Private room,90,73,5.38,163
46065,Ajmol,3,Private room,70,88,9.07,158
46066,Ajmol,3,Private room,60,89,10.23,149
46067,Damiso,2,Entire home/apt,100,167,7.5,267
46069,Roza,1,Entire home/apt,255,11,2.0,266
46070,Benoit,2,Entire home/apt,350,46,2.0,396
46074,Phyllis,1,Entire home/apt,180,308,2.37,488
46077,Sonny,1,Entire home/apt,190,300,1.67,490
46079,Nathaniel,2,Private room,50,336,3.08,386
46080,SamariSankofa,1,Entire home/apt,150,352,4.09,502
46081,Riki,1,Entire home/apt,160,55,2.0,215
46083,Simon,1,Private room,150,34,2.0,184
46084,Nikita,2,Entire home/apt,140,0,1.0,140
46085,Lucio,3,Private room,75,365,4.05,440
46086,Sandra,2,Entire home/apt,279,23,1.0,302
46088,Juka,3,Private room,395,333,1.0,728
46089,Neal,3,Private room,80,90,1.0,170
46092,Simranjeet,5,Shared room,30,68,0.77,98
46093,Jesus A,4,Shared room,22,11,0.83,33
46094,Valeria,1,Entire home/apt,390,43,2.57,433
46095,Alex,1,Entire home/apt,500,180,7.86,680
46096,Alex,1,Entire home/apt,500,185,5.12,685
46098,Brad,2,Entire home/apt,97,92,2.0,189
46100,Nicole,1,Entire home/apt,125,1,1.0,126
46102,Raquel,1,Entire home/apt,294,64,4.41,358
46103,Siobhan,1,Entire home/apt,165,21,1.62,186
46104,David,3,Private room,50,273,10.0,323
46105,Stef,1,Entire home/apt,295,169,2.73,464
46106,Natasha,2,Private room,100,270,1.0,370
46108,Meng,1,Entire home/apt,89,70,4.74,159
46111,Ethan,2,Entire home/apt,110,1,1.0,111
46112,Eric,2,Entire home/apt,250,0,4.0,250
46113,Gershon,3,Private room,70,0,0.68,70
46114,Geralde,3,Entire home/apt,99,167,7.94,266
46116,Hyunsung,3,Entire home/apt,90,104,3.0,194
46119,John,1,Entire home/apt,150,4,2.0,154
46120,Rufina,2,Private room,55,174,3.0,229
46121,William,2,Entire home/apt,200,163,3.57,363
46123,Yaren,3,Private room,50,0,4.0,50
46124,Ajmol,3,Private room,60,87,8.18,147
46125,Ajmol,3,Private room,70,78,7.5,148
46127,Steven,3,Private room,50,333,3.16,383
46128,Neal,1,Entire home/apt,350,304,2.0,654
46130,Steve & Stephanie,2,Entire home/apt,130,74,2.43,204
46131,Gabriel&Anais,1,Entire home/apt,151,11,2.0,162
46132,Hank,2,Entire home/apt,75,149,5.58,224
46133,Jess,2,Private room,65,180,5.45,245
46134,Stéphen,2,Private room,100,40,1.0,140
46135,Paul,3,Entire home/apt,150,45,2.0,195
46136,Alessandra,1,Private room,68,22,1.0,90
46137,Sam,1,Entire home/apt,650,84,1.71,734
46138,Sindre,1,Entire home/apt,425,54,3.0,479
46139,Ethan,1,Entire home/apt,445,60,1.0,505
46141,Louis,1,Entire home/apt,225,68,2.5,293
46144,Ian,2,Private room,98,55,2.0,153
46145,Jordania,1,Private room,210,86,1.0,296
46146,Petra,1,Entire home/apt,140,0,1.0,140
46148,Matías,2,Private room,52,68,3.0,120
46149,Sebastian,1,Entire home/apt,295,204,4.29,499
46150,Sandra,1,Entire home/apt,339,304,4.0,643
46151,Andy,1,Entire home/apt,87,13,1.0,100
46154,Brahmadutta,3,Entire home/apt,250,164,1.0,414
46156,Lisa,1,Entire home/apt,135,0,1.0,135
46157,James,2,Entire home/apt,300,77,2.0,377
46158,K,2,Entire home/apt,94,7,0.88,101
46159,Kaito,1,Entire home/apt,390,5,1.0,395
46161,Andre,1,Entire home/apt,450,226,6.0,676
46162,Jack,1,Entire home/apt,289,129,2.0,418
46164,Diane,1,Entire home/apt,300,325,3.0,625
46166,Leidi,2,Shared room,30,342,4.0,372
46167,Pedro & Jeff,2,Private room,49,30,1.62,79
46168,Nick,1,Entire home/apt,210,136,3.0,346
46169,Kervin,2,Entire home/apt,150,15,4.0,165
46170,Abe,3,Private room,40,55,3.64,95
46171,Robert,1,Entire home/apt,191,10,2.0,201
46172,Inbar,2,Entire home/apt,550,43,1.0,593
46173,Paul,2,Entire home/apt,110,0,2.0,110
46175,Jeffrey,2,Entire home/apt,250,13,1.0,263
46176,John,2,Entire home/apt,225,177,4.86,402
46178,Michael And Aaron,1,Entire home/apt,235,171,4.0,406
46179,Zlatan,4,Entire home/apt,109,192,1.0,301
46182,Luis,1,Entire home/apt,171,0,5.29,171
46183,Sito,1,Entire home/apt,249,225,6.0,474
46184,Mina,3,Private room,65,295,11.71,360
46185,Mina,3,Private room,49,329,2.14,378
46187,Cesar,3,Entire home/apt,96,9,4.0,105
46188,Sissy,1,Entire home/apt,585,97,1.0,682
46189,Lue,2,Private room,40,0,2.31,40
46190,Jess & Ana,3,Shared room,25,346,1.0,371
46191,Jess & Ana,3,Shared room,29,343,1.0,372
46195,Jess & Ana,3,Shared room,25,351,2.0,376
46196,Misha,2,Private room,75,72,4.69,147
46197,Alex,1,Entire home/apt,350,135,3.64,485
46198,Josie,1,Entire home/apt,179,138,4.0,317
46199,Rosie,2,Private room,50,5,2.5,55
46200,Oscar,3,Entire home/apt,160,151,4.17,311
46201,Luke,1,Entire home/apt,150,15,1.0,165
46205,The Manhattan Club,1,Private room,399,0,3.0,399
46206,Catarina,1,Entire home/apt,425,0,5.0,425
46207,Harold Huengue,1,Entire home/apt,250,212,3.0,462
46208,The Manhattan Club,1,Private room,399,356,2.0,755
46209,The Manhattan Club,1,Private room,399,346,1.0,745
46210,The Manhattan Club,1,Private room,399,346,6.0,745
46211,Vanessa,2,Entire home/apt,500,353,2.37,853
46212,Melissa,1,Entire home/apt,179,164,5.0,343
46216,Leslie,1,Entire home/apt,420,270,2.0,690
46219,Johselyn,1,Entire home/apt,279,138,5.0,417
46221,Traylor,2,Private room,125,87,1.0,212
46224,Doug,1,Entire home/apt,150,2,7.0,152
46226,Justen,1,Entire home/apt,229,150,3.0,379
46228,Gulshan,2,Entire home/apt,99,145,1.58,244
46229,Kamara,2,Entire home/apt,86,360,1.58,446
46230,Kristina,3,Private room,90,365,1.0,455
46232,Soner,1,Entire home/apt,140,79,3.64,219
46234,Eduardo,1,Entire home/apt,499,115,1.0,614
46235,Haffro,1,Private room,125,338,1.0,463
46237,Gary,2,Private room,60,0,2.0,60
46238,Princess,2,Entire home/apt,110,227,2.65,337
46240,Shelley,2,Private room,66,0,1.0,66
46241,Emily,3,Entire home/apt,130,26,2.0,156
46242,Mara,1,Private room,365,342,1.0,707
46243,Emiliano,1,Entire home/apt,319,163,1.0,482
46244,Peter,1,Private room,57,54,1.71,111
46246,Kinga,5,Entire home/apt,195,119,1.0,314
46249,Kate And Jason,1,Entire home/apt,500,313,4.0,813
46250,Arian,4,Private room,70,90,1.0,160
46251,Wada,1,Private room,55,182,2.81,237
46252,Ej,1,Entire home/apt,600,80,2.0,680
46253,Danny,3,Entire home/apt,150,78,1.0,228
46255,Juliana,1,Private room,120,332,1.54,452
46256,Vineet,1,Entire home/apt,229,356,1.62,585
46258,Juliana,1,Private room,125,70,0.79,195
46260,David,3,Private room,55,0,9.73,55
46261,Alexey,1,Entire home/apt,209,177,3.43,386
46263,Dianne,3,Private room,75,90,2.0,165
46265,Orit,4,Shared room,28,88,2.0,116
46273,Rachel,1,Entire home/apt,210,73,1.58,283
46274,Lauren,1,Entire home/apt,170,88,1.0,258
46276,Susan,2,Entire home/apt,450,302,3.0,752
46277,Camille-Bettina,2,Private room,51,0,1.0,51
46280,Tom,4,Entire home/apt,88,241,3.0,329
46282,Susan,2,Entire home/apt,165,346,2.0,511
46283,David,2,Private room,100,365,6.0,465
46284,Abshan,1,Private room,140,21,1.0,161
46286,Eleanor,2,Entire home/apt,195,345,4.0,540
46288,Jenna,4,Entire home/apt,140,358,4.0,498
46289,Adriana,1,Entire home/apt,131,11,2.0,142
46290,Mike,1,Entire home/apt,163,155,3.0,318
46291,Anya,1,Entire home/apt,995,344,3.0,1339
46292,Bryan,2,Entire home/apt,275,351,3.0,626
46294,Joanne,2,Private room,70,163,3.0,233
46295,Rachel,1,Entire home/apt,348,26,4.41,374
46296,Alyssa,2,Private room,60,0,1.67,60
46297,Jenny,2,Private room,60,178,3.0,238
46299,Jenny,2,Private room,70,172,2.0,242
46300,Ian,2,Entire home/apt,159,341,1.0,500
46303,Ed,1,Entire home/apt,200,81,2.0,281
46305,Yonaton,2,Entire home/apt,395,301,1.0,696
46307,Valentin,1,Entire home/apt,150,16,4.0,166
46311,Margaret,1,Entire home/apt,198,154,1.58,352
46312,Moun,1,Entire home/apt,165,0,2.0,165
46313,Anthony,1,Entire home/apt,500,328,3.0,828
46316,Sherwin,1,Entire home/apt,500,138,5.62,638
46319,Merche,1,Entire home/apt,319,138,1.87,457
46320,Rawan,1,Entire home/apt,150,61,2.0,211
46321,Alexis,1,Entire home/apt,300,365,3.0,665
46322,Alan,1,Entire home/apt,295,123,1.0,418
46323,Frances,1,Entire home/apt,150,69,2.0,219
46324,Ben,2,Entire home/apt,369,29,1.0,398
46325,Peter,1,Private room,59,61,1.0,120
46326,Robert,3,Entire home/apt,95,65,5.0,160
46329,Zach,2,Entire home/apt,329,63,1.0,392
46330,Lovlee,3,Entire home/apt,100,78,4.0,178
46331,Marilena,2,Private room,100,90,2.0,190
46332,Maria & Sam,1,Entire home/apt,444,325,2.0,769
46333,Brian,1,Entire home/apt,250,32,2.0,282
46334,Mo,3,Entire home/apt,150,19,4.0,169
46336,Lucy,2,Entire home/apt,550,81,2.0,631
46338,Mehmet,2,Private room,50,349,3.75,399
46341,Jonathan,1,Entire home/apt,200,151,5.45,351
46342,Maggie,1,Entire home/apt,250,44,3.75,294
46344,David,1,Entire home/apt,375,45,1.0,420
46345,Ignacio,1,Entire home/apt,395,102,3.0,497
46347,Elena,1,Entire home/apt,280,199,3.0,479
46349,Caroline,2,Entire home/apt,300,282,1.0,582
46350,Carol & Ashley,1,Entire home/apt,225,344,2.0,569
46352,Peter,1,Private room,59,41,2.0,100
46353,Fiona,2,Private room,45,3,2.0,48
46354,Northern Star Realty,3,Entire home/apt,96,159,10.91,255
46355,Yehoshua,2,Entire home/apt,275,356,2.0,631
46356,Liz,1,Entire home/apt,305,44,4.0,349
46357,Pauline,2,Private room,71,20,1.0,91
46358,Florian,1,Private room,90,0,7.11,90
46359,Imelda,3,Private room,45,3,4.0,48
46360,Harun,2,Entire home/apt,50,152,2.0,202
46361,Salma,1,Entire home/apt,114,104,2.0,218
46365,Gladwyn,2,Private room,110,365,4.0,475
46366,Kailyn,1,Entire home/apt,175,8,1.0,183
46367,Albert,2,Entire home/apt,260,343,1.0,603
46368,Harrison,2,Entire home/apt,209,79,2.37,288
46369,Crystal,5,Entire home/apt,125,44,1.0,169
46370,Mendy,1,Entire home/apt,249,127,3.0,376
46371,Any,3,Private room,55,302,0.81,357
46373,Hanya,2,Entire home/apt,490,1,1.0,491
46374,Lizzie,2,Private room,45,1,1.0,46
46377,Maria Rosario,1,Entire home/apt,900,57,1.0,957
46378,Seymur,2,Entire home/apt,225,71,2.0,296
46379,Darlene & Richard,1,Entire home/apt,205,349,0.81,554
46381,Marietta,1,Entire home/apt,360,94,4.29,454
46384,Ralph,1,Entire home/apt,320,57,1.0,377
46385,Erik,1,Shared room,85,175,5.62,260
46386,Melissa,2,Private room,55,18,2.0,73
46387,Denis,1,Entire home/apt,189,156,4.0,345
46389,Jessica,1,Entire home/apt,500,365,1.0,865
46390,Austin,1,Entire home/apt,225,221,1.0,446
46391,Nazarena,1,Entire home/apt,400,261,2.81,661
46392,Julie & Brian,1,Entire home/apt,900,360,2.0,1260
46394,Guillard,2,Private room,89,27,1.0,116
46395,Ani,1,Entire home/apt,170,26,5.0,196
46396,Joy,3,Private room,65,49,1.0,114
46401,Thiago,3,Entire home/apt,275,339,3.0,614
46404,Noor,2,Entire home/apt,295,356,3.0,651
46405,Roberta,3,Private room,50,341,2.0,391
46407,Lucas,2,Private room,75,0,2.65,75
46408,Rafael,3,Private room,49,0,3.0,49
46410,Lauren,1,Private room,90,5,1.0,95
46411,Lenny,1,Entire home/apt,350,2,1.0,352
46412,Angela,2,Entire home/apt,599,39,2.0,638
46413,Masum,3,Private room,36,62,1.76,98
46414,Angelica,2,Private room,70,301,4.17,371
46415,Masum,3,Private room,36,337,3.85,373
46416,Carlos,3,Private room,70,315,1.58,385
46420,Zara,2,Entire home/apt,230,15,1.0,245
46423,Tomer,1,Private room,100,365,0.81,465
46424,Dani,2,Private room,95,97,1.0,192
46427,Austin,1,Entire home/apt,179,187,3.0,366
46428,Alex,1,Entire home/apt,330,164,10.54,494
46430,Noe,1,Entire home/apt,349,186,2.0,535
46431,Kurt,4,Entire home/apt,75,253,2.0,328
46435,Lina,3,Entire home/apt,140,82,1.0,222
46437,Sam,3,Entire home/apt,200,152,2.0,352
46442,Ken,3,Private room,60,179,2.0,239
46445,Benat,1,Private room,50,267,5.83,317
46447,Milica,1,Entire home/apt,255,55,2.0,310
46448,Frankie,1,Private room,100,31,2.43,131
46449,Dem,2,Entire home/apt,170,237,5.0,407
46451,Ula,2,Private room,59,15,1.0,74
46454,Ignacio,1,Entire home/apt,249,86,4.0,335
46456,Shihui,3,Entire home/apt,80,0,1.0,80
46457,Irma,1,Private room,99,34,1.0,133
46458,Alesh,2,Entire home/apt,245,326,1.0,571
46460,Omar,2,Entire home/apt,67,0,1.0,67
46461,Héctor,1,Private room,66,130,4.69,196
46462,Alesh,2,Entire home/apt,250,309,5.0,559
46466,Mark,4,Private room,50,8,3.0,58
46467,George,1,Private room,109,148,4.29,257
46469,George,1,Private room,109,143,10.0,252
46471,Leila,3,Private room,80,87,1.0,167
46472,Carlos,1,Private room,50,0,3.33,50
46473,Gregory,2,Entire home/apt,289,77,5.0,366
46475,Helen,1,Entire home/apt,210,331,1.0,541
46476,Hyunsung,3,Shared room,75,349,1.0,424
46477,Carena,2,Entire home/apt,125,321,1.0,446
46480,Luna,3,Private room,70,266,1.87,336
46492,Julie,2,Entire home/apt,120,10,1.0,130
46497,Luke,3,Private room,75,5,2.0,80
46498,Mutaz,1,Private room,79,16,1.87,95
46505,Ken,3,Private room,50,365,2.0,415
46506,Brandon And Emily,1,Entire home/apt,250,335,8.33,585
46507,Danielle,2,Entire home/apt,160,86,1.0,246
46508,Kevin,1,Private room,80,356,2.0,436
46509,Joseph,3,Entire home/apt,235,321,8.33,556
46513,Lorand,3,Private room,42,0,2.65,42
46514,Sonydelane,3,Entire home/apt,250,353,1.0,603
46516,Mark,3,Entire home/apt,149,341,5.83,490
46520,Diego,3,Shared room,60,365,4.0,425
46523,Daniel,2,Private room,95,28,2.0,123
46524,Michael,3,Entire home/apt,350,64,7.0,414
46525,Annmarie,3,Entire home/apt,78,129,6.56,207
46527,Carlos,3,Entire home/apt,124,161,1.0,285
46529,Jude,1,Shared room,150,179,1.0,329
46531,Fenny,3,Private room,60,0,2.0,60
46532,Maria,1,Private room,86,0,0.88,86
46533,Viberlyn,1,Entire home/apt,2995,214,1.0,3209
46534,Beka And Strat,2,Private room,69,89,0.91,158
46535,Heather,1,Entire home/apt,145,35,1.0,180
46538,Angie,1,Entire home/apt,125,219,2.0,344
46539,John,1,Entire home/apt,199,36,3.0,235
46540,Sydney,1,Entire home/apt,229,266,1.0,495
46544,Chris,2,Entire home/apt,180,23,1.87,203
46545,Nick,3,Private room,62,43,2.0,105
46546,John Ari,1,Entire home/apt,480,265,3.0,745
46549,Ruby,1,Private room,120,364,1.0,484
46551,Mindy,2,Entire home/apt,249,179,2.0,428
46552,Juan,1,Entire home/apt,300,346,7.0,646
46553,Josh,2,Entire home/apt,198,11,3.0,209
46554,Stanislaw,1,Entire home/apt,250,42,3.0,292
46555,Gabrielle,1,Private room,66,60,2.0,126
46556,Sheryl,1,Entire home/apt,335,144,3.0,479
46557,Ken,3,Private room,95,365,2.0,460
46558,Lucas,3,Entire home/apt,300,320,3.0,620
46559,Christy,1,Entire home/apt,330,281,2.0,611
46560,Billy,2,Entire home/apt,131,137,2.0,268
46563,Ana,1,Entire home/apt,305,242,2.0,547
46565,Kasia,1,Entire home/apt,250,10,1.0,260
46566,Amhalise,2,Entire home/apt,200,5,1.0,205
46568,Darry,2,Shared room,30,333,2.0,363
46569,Arva,1,Entire home/apt,250,70,1.0,320
46571,Wenying,1,Entire home/apt,165,62,1.0,227
46572,Angie,1,Entire home/apt,260,43,1.0,303
46573,Omer,1,Entire home/apt,145,92,2.0,237
46574,Tina,1,Private room,140,42,2.0,182
46575,Ajamu,2,Entire home/apt,150,25,1.0,175
46577,Ken,3,Private room,70,365,4.29,435
46578,Ken,3,Private room,41,365,1.0,406
46579,Katherine,4,Private room,69,86,2.0,155
46580,William,2,Entire home/apt,119,15,2.0,134
46582,Lianne,1,Entire home/apt,185,1,1.0,186
46583,Mariana,2,Entire home/apt,125,0,1.0,125
46584,Janee,1,Entire home/apt,220,334,1.0,554
46585,Michael,1,Entire home/apt,550,147,2.0,697
46586,Peter,2,Entire home/apt,100,11,1.0,111
46588,371,2,Entire home/apt,225,141,7.27,366
46589,Joshua,1,Private room,86,90,1.0,176
46590,Noah,1,Entire home/apt,270,50,1.0,320
46591,Pam And Dali,2,Private room,69,2,3.0,71
46592,Ken,3,Private room,90,365,1.0,455
46593,Nia,2,Private room,63,20,4.0,83
46594,G,1,Entire home/apt,350,17,1.0,367
46595,Holly,2,Entire home/apt,121,6,6.0,127
46596,Incentra,1,Private room,999,321,2.0,1320
46597,Hui,2,Private room,60,147,1.0,207
46598,Hui,2,Private room,60,166,4.0,226
46600,David,2,Private room,80,344,2.0,424
46601,David,2,Private room,80,361,4.69,441
46603,Longfang,2,Private room,60,173,4.0,233
46604,Anne,1,Entire home/apt,180,210,1.0,390
46605,Kenneth,1,Private room,90,138,1.0,228
46608,Alex,2,Entire home/apt,125,241,6.0,366
46609,Kamilla And John,3,Entire home/apt,225,337,4.29,562
46610,Longfang,2,Private room,60,176,3.0,236
46611,Harris,3,Entire home/apt,125,22,2.0,147
46612,Blanca,1,Entire home/apt,279,221,3.0,500
46613,Beckett,1,Entire home/apt,250,27,1.0,277
46615,Emily,1,Entire home/apt,300,90,4.55,390
46618,Александрина,3,Entire home/apt,150,5,1.0,155
46619,Victor,2,Private room,175,87,3.0,262
46620,Musya,1,Entire home/apt,110,3,3.0,113
46622,Sal,2,Entire home/apt,120,103,3.0,223
46623,Mara,1,Private room,358,322,2.0,680
46624,Sandy,1,Entire home/apt,235,196,1.0,431
46625,Té,2,Entire home/apt,200,21,1.0,221
46626,Hupeto,2,Entire home/apt,175,358,1.0,533
46627,Maria,2,Entire home/apt,139,184,3.0,323
46629,Gonzalo,2,Entire home/apt,150,137,6.0,287
46630,Aden,1,Entire home/apt,700,130,2.0,830
46635,JessDoinMe,1,Private room,50,116,1.0,166
46636,Nora,2,Entire home/apt,230,16,1.0,246
46638,Panthea,2,Entire home/apt,140,29,2.0,169
46639,Inna,2,Private room,42,21,0.83,63
46641,Steph,1,Entire home/apt,342,40,2.0,382
46644,Ysabel,1,Entire home/apt,321,65,4.0,386
46645,Rachel,1,Private room,75,246,1.0,321
46647,Rachel,1,Private room,100,260,1.0,360
46648,Charisse,1,Entire home/apt,200,139,4.0,339
46652,Dani,1,Entire home/apt,189,180,4.0,369
46653,Theo,3,Entire home/apt,275,279,2.0,554
46654,Tersila,4,Entire home/apt,75,160,2.0,235
46655,Zach,1,Entire home/apt,189,122,3.0,311
46657,Sandy,1,Entire home/apt,269,238,2.0,507
46660,Antia,2,Entire home/apt,190,303,1.0,493
46662,Carolyn,2,Entire home/apt,250,10,2.73,260
46664,Jose,1,Entire home/apt,347,157,4.0,504
46665,Lawrence,2,Private room,75,260,1.82,335
46667,Rachel,2,Entire home/apt,250,64,1.0,314
46669,Hoover,2,Entire home/apt,82,29,1.0,111
46670,Sandra,3,Private room,45,76,4.0,121
46671,Federica,2,Entire home/apt,140,29,0.86,169
46672,Francisco,3,Entire home/apt,250,338,2.0,588
46673,Amber,1,Entire home/apt,220,214,1.0,434
46674,Fernella,2,Entire home/apt,110,87,2.0,197
46675,Carmen,1,Entire home/apt,275,124,5.0,399
46676,Yvonne,1,Entire home/apt,160,75,3.0,235
46677,Panagiotis,3,Entire home/apt,225,270,1.0,495
46679,Ibrahim Ali,1,Entire home/apt,295,195,2.0,490
46681,Christos,3,Entire home/apt,125,24,5.0,149
46685,Robert,1,Entire home/apt,350,107,3.64,457
46688,Valerie,2,Private room,65,5,1.0,70
46691,Olga,3,Private room,70,89,1.0,159
46692,Kraja,1,Entire home/apt,299,348,4.0,647
46693,Bryan,3,Private room,40,90,1.0,130
46694,Guido,1,Entire home/apt,190,36,4.0,226
46698,Maria,3,Entire home/apt,225,279,1.0,504
46699,Robert,1,Entire home/apt,171,8,5.0,179
46701,Erika,2,Private room,66,36,4.0,102
46702,Nate,1,Private room,77,161,2.0,238
46703,Aaron,1,Entire home/apt,125,18,2.0,143
46704,Luis,3,Entire home/apt,50,178,1.0,228
46705,Bojan,3,Private room,85,42,2.0,127
46706,Endrit,1,Entire home/apt,349,265,4.0,614
46707,Stephanie,1,Private room,400,60,2.0,460
46708,Beverley,2,Entire home/apt,140,87,1.0,227
46709,Rachel,2,Private room,125,365,1.0,490
46713,Dan,1,Entire home/apt,220,176,3.0,396
46714,Alex,1,Entire home/apt,400,57,2.73,457
46718,Robert,1,Private room,94,20,1.0,114
46721,Daniel,2,Private room,30,34,0.88,64
46724,Guillaume,1,Private room,100,191,4.0,291
46727,Elizabeth,1,Entire home/apt,226,163,3.0,389
46728,Dem,2,Entire home/apt,150,312,3.0,462
46729,Brandon,1,Entire home/apt,214,185,1.0,399
46730,Caitlin,2,Private room,45,154,1.0,199
46731,Joseph,2,Entire home/apt,177,32,2.0,209
46732,Molly,1,Entire home/apt,250,183,4.0,433
46733,Anila,1,Entire home/apt,489,259,1.0,748
46734,Sammie,1,Entire home/apt,250,190,3.0,440
46735,Yess,1,Entire home/apt,650,232,3.0,882
46736,Ashley,1,Entire home/apt,250,188,5.0,438
46738,Jose,3,Shared room,30,350,3.0,380
46739,Charlette,1,Entire home/apt,250,160,4.0,410
46742,Katie,2,Entire home/apt,350,363,2.0,713
46744,Wanda,1,Entire home/apt,489,167,4.0,656
46745,Sasha,1,Entire home/apt,78,208,1.0,286
46747,Michael,1,Entire home/apt,450,263,1.0,713
46749,Adriana,2,Entire home/apt,500,332,2.0,832
46751,Karina,2,Entire home/apt,500,357,1.0,857
46752,Vlada,3,Entire home/apt,85,27,1.0,112
46754,Mengyuan,1,Entire home/apt,385,28,1.0,413
46755,Hanna,1,Private room,119,30,1.0,149
46756,NoHo,1,Entire home/apt,189,339,2.0,528
46757,Gillian,2,Entire home/apt,89,88,7.5,177
46758,Linda,3,Private room,100,63,2.0,163
46762,Fuda,1,Entire home/apt,190,29,4.0,219
46764,Mick,2,Entire home/apt,125,7,2.0,132
46766,Emily,1,Entire home/apt,230,6,0.91,236
46768,Liz,1,Entire home/apt,185,267,1.0,452
46770,Charlotte,2,Private room,80,10,1.0,90
46772,Yvette,2,Private room,70,161,2.0,231
46775,Mary,1,Entire home/apt,120,203,2.0,323
46776,Sandra,3,Private room,35,38,6.0,73
46777,Tara,1,Private room,108,113,4.0,221
46781,Katie J,1,Entire home/apt,135,94,7.0,229
46783,Claudio,1,Entire home/apt,223,25,3.0,248
46785,Nikki,1,Entire home/apt,120,23,1.0,143
46786,Folami,1,Entire home/apt,199,324,3.0,523
46787,Tiffany,1,Entire home/apt,300,365,1.0,665
46788,Mila,2,Private room,80,23,1.0,103
46790,Jake&Aden,1,Entire home/apt,450,66,8.0,516
46793,Thom,1,Entire home/apt,185,43,3.0,228
46794,Roman,2,Private room,50,75,7.27,125
46796,Sergii,1,Private room,89,361,2.0,450
46797,Madeline,1,Entire home/apt,300,284,1.0,584
46799,Eddie,2,Entire home/apt,600,351,1.0,951
46802,Mela,3,Entire home/apt,225,261,1.0,486
46804,Alva,2,Shared room,30,46,3.0,76
46806,Sena,3,Entire home/apt,220,63,1.0,283
46808,Marwa,5,Entire home/apt,99,342,1.0,441
46811,Rivka,1,Entire home/apt,220,52,3.0,272
46812,Venessa,2,Entire home/apt,190,269,3.0,459
46815,Pauline,3,Private room,65,357,3.0,422
46816,Carme,1,Entire home/apt,202,215,2.0,417
46817,Israel,2,Private room,60,343,1.0,403
46818,Christopher,1,Entire home/apt,475,157,2.0,632
46819,Margarita,1,Entire home/apt,305,133,2.0,438
46821,Gage,2,Entire home/apt,262,118,5.0,380
46845,Ximena,1,Entire home/apt,249,177,2.0,426
46847,Jesús,3,Shared room,45,84,1.0,129
46848,Ilir,1,Entire home/apt,210,32,1.0,242
46851,Lora,2,Entire home/apt,180,365,2.0,545
46852,Jessie,1,Entire home/apt,300,53,1.0,353
46853,Nat,1,Entire home/apt,400,128,3.0,528
46854,Nelly,2,Private room,38,356,1.0,394
46856,Shane,1,Entire home/apt,140,105,2.0,245
46859,Natalie,4,Private room,35,342,1.0,377
46860,Lenny,1,Entire home/apt,219,173,5.0,392
46863,Shelly,1,Entire home/apt,450,101,3.0,551
46864,Ines,3,Private room,55,308,4.0,363
46865,Michael,3,Private room,99,95,1.0,194
46867,Fred,2,Private room,60,26,1.0,86
46868,Samuel,4,Entire home/apt,99,52,2.0,151
46869,Yan,1,Entire home/apt,300,161,4.0,461
46871,Justin,2,Entire home/apt,264,327,5.0,591
46875,Carlos,3,Private room,100,179,2.0,279
46876,Giovany,2,Entire home/apt,299,195,3.0,494
46877,Maria De La Encarnacion,1,Entire home/apt,299,350,2.0,649
46881,Rohon,3,Private room,44,227,1.0,271
46882,Georgia,1,Entire home/apt,200,265,1.0,465
46883,Emely,3,Private room,49,48,1.0,97
46884,Aponte & Tat,2,Private room,60,72,1.0,132
46886,Mariel,1,Entire home/apt,211,56,4.0,267
46888,Alex,1,Entire home/apt,350,163,10.0,513
46889,Ivo,2,Entire home/apt,100,64,4.0,164
46890,Mutale,2,Entire home/apt,150,107,1.0,257
46891,Alex,1,Entire home/apt,320,189,12.0,509
46893,Elizabeth,2,Shared room,25,299,1.0,324
46894,Elizabeth,2,Shared room,25,334,1.0,359
46897,Javi,1,Entire home/apt,249,146,1.0,395
46898,Francis,2,Entire home/apt,60,21,6.0,81
46899,Gerado,1,Entire home/apt,240,35,2.0,275
46900,Molly,1,Entire home/apt,325,197,4.0,522
46901,Stephanie,4,Entire home/apt,95,84,4.0,179
46902,Matt,1,Entire home/apt,250,14,1.0,264
46905,Lucca & Paula,3,Private room,100,253,9.0,353
46906,Nyc,1,Entire home/apt,200,326,1.0,526
46908,Hyunsung,3,Shared room,69,355,2.0,424
46912,Jordan,1,Private room,34,278,2.0,312
46914,Nawa,4,Private room,45,364,1.0,409
46915,Gonzalo,1,Entire home/apt,119,174,3.0,293
46918,Fiona,1,Entire home/apt,150,222,6.0,372
46919,Iveth,5,Entire home/apt,75,299,1.0,374
46921,Jonathan,2,Entire home/apt,259,345,4.0,604
46923,Neil,1,Entire home/apt,180,17,1.0,197
46925,Jerry,1,Entire home/apt,395,152,2.0,547
46926,Aaron,1,Private room,150,135,7.0,285
46928,Willy,2,Entire home/apt,475,343,3.0,818
46929,Gensing,1,Entire home/apt,250,335,2.0,585
46930,Willy,2,Entire home/apt,200,351,2.0,551
46931,Willy,2,Entire home/apt,650,338,1.0,988
46932,Elay,2,Entire home/apt,184,217,1.0,401
46934,David,1,Entire home/apt,189,69,1.0,258
46935,Puja,2,Entire home/apt,198,11,2.0,209
46937,Sam,1,Entire home/apt,500,45,14.0,545
46939,Aaron,1,Private room,130,79,9.0,209
46941,Segun,4,Entire home/apt,85,362,6.0,447
46943,Sara,1,Private room,105,21,1.0,126
46947,Tony,1,Entire home/apt,290,25,1.0,315
46948,Nicole,1,Entire home/apt,160,243,1.0,403
46949,Corder,1,Entire home/apt,178,22,2.0,200
46950,Eva,2,Entire home/apt,60,94,1.0,154
46951,Dandey,3,Entire home/apt,85,166,8.0,251
46952,Tom,2,Entire home/apt,200,316,2.0,516
46953,Mutale,2,Private room,95,164,2.0,259
46954,Celine,1,Entire home/apt,220,54,2.0,274
46956,Paul,1,Private room,55,35,1.0,90
46957,Jungyen,3,Private room,99,364,4.0,463
46959,Adam,2,Entire home/apt,249,89,1.0,338
46964,Jenny,3,Entire home/apt,200,365,4.0,565
46970,Roman,2,Private room,50,83,6.0,133
46972,Carlos,3,Private room,85,60,1.0,145
46974,Jarmel,2,Private room,50,348,3.0,398
46975,Venessa,2,Entire home/apt,190,311,1.0,501
46977,Eileen,3,Private room,90,90,2.0,180
46980,Walt & Daisy,3,Entire home/apt,200,261,2.0,461
46981,Niki,1,Private room,280,363,1.0,643
46983,Bowen,2,Entire home/apt,130,13,1.0,143
46984,Ralph,2,Private room,65,19,1.0,84
46994,Anna,1,Entire home/apt,350,129,3.0,479
46995,Azuri,2,Private room,65,348,1.0,413
46996,Michael,3,Entire home/apt,50,119,4.0,169
46997,Yael,2,Entire home/apt,250,66,1.0,316
47000,David,3,Private room,50,273,6.0,323
47002,Claudia,2,Entire home/apt,120,9,1.0,129
47003,Victoria,2,Private room,36,46,1.0,82
47004,Fang,3,Private room,49,345,4.0,394
47005,Jonathan,1,Entire home/apt,170,4,1.0,174
47006,Amy,2,Entire home/apt,465,250,3.0,715
47007,Ronny,3,Private room,46,365,1.0,411
47008,Sara,2,Entire home/apt,120,286,1.0,406
47011,Carlos,3,Private room,70,365,2.0,435
47013,Joy,2,Private room,95,360,1.0,455
47014,Jesus,3,Private room,50,330,3.0,380
47016,Ronald,4,Shared room,57,340,4.0,397
47017,Tiyanna,3,Entire home/apt,85,62,5.0,147
47018,London,1,Entire home/apt,300,302,1.0,602
47019,Jessica,3,Private room,40,3,2.0,43
47021,Regine,2,Entire home/apt,89,4,1.0,93
47025,Jungyen,3,Private room,99,365,4.0,464
47027,Mafer,1,Entire home/apt,100,6,3.0,106
47028,Jarmel,2,Private room,50,342,2.0,392
47029,Joseph,2,Entire home/apt,159,28,2.0,187
47030,Juhyun,2,Entire home/apt,250,9,1.0,259
47031,Leslie,1,Entire home/apt,240,75,1.0,315
47032,Silvia,1,Entire home/apt,135,15,1.0,150
47033,Vivi,4,Entire home/apt,60,20,1.0,80
47039,Demir,1,Entire home/apt,165,207,2.0,372
47040,Shameika,2,Entire home/apt,600,323,4.0,923
47041,Anna + Jason,1,Entire home/apt,900,292,1.0,1192
47046,Kate,1,Entire home/apt,600,226,1.0,826
47054,Aaron,1,Private room,60,130,3.0,190
47055,Ebony,2,Entire home/apt,95,84,2.0,179
47056,Zachary And Ashley,1,Entire home/apt,275,308,1.0,583
47057,Jon,2,Entire home/apt,187,256,1.0,443
47063,Ryan & Mary,1,Entire home/apt,843,358,4.0,1201
47065,Jose,4,Entire home/apt,150,65,3.0,215
47069,Nick,2,Private room,46,81,1.0,127
47070,Maria & Tom,1,Entire home/apt,213,336,1.0,549
47071,Jennifer,2,Private room,59,24,1.0,83
47073,Simrit Atma,2,Private room,75,13,3.0,88
47074,Sang,1,Entire home/apt,225,82,1.0,307
47075,Mauricio,1,Shared room,66,70,1.0,136
47076,Adam,1,Entire home/apt,200,43,1.0,243
47077,Chase,1,Entire home/apt,395,296,4.0,691
47079,Tracie,1,Entire home/apt,215,246,4.0,461
47081,Simrit Atma,2,Private room,75,13,1.0,88
47082,Simrit Atma,2,Entire home/apt,145,17,1.0,162
47083,Steven,2,Private room,46,163,1.0,209
47084,Ross,1,Entire home/apt,179,76,3.0,255
47085,Donna,1,Entire home/apt,132,46,2.0,178
47086,Kimesha,2,Private room,79,90,1.0,169
47089,Oli,1,Entire home/apt,450,156,1.0,606
47090,Tim,1,Entire home/apt,210,306,1.0,516
47092,Mamadou,1,Entire home/apt,120,285,4.0,405
47093,Sharoom,1,Entire home/apt,209,68,1.0,277
47097,Alex,1,Entire home/apt,429,152,2.0,581
47098,Jonah,1,Entire home/apt,135,184,2.0,319
47102,Alex,1,Entire home/apt,320,121,7.0,441
47103,Shari,2,Entire home/apt,87,90,1.0,177
47104,Jonathan,1,Entire home/apt,205,45,3.0,250
47105,Angelo,1,Entire home/apt,305,311,3.0,616
47106,Dan,1,Entire home/apt,144,223,1.0,367
47107,Jairo,3,Entire home/apt,167,94,1.0,261
47109,Martin,2,Entire home/apt,168,154,4.0,322
47112,Steven,2,Private room,46,180,2.0,226
47116,Ken,1,Entire home/apt,159,170,5.0,329
47118,George,2,Entire home/apt,185,130,2.0,315
47125,Jey,1,Entire home/apt,170,270,3.0,440
47127,Madison,2,Entire home/apt,99,144,1.0,243
47130,Sonya,2,Shared room,20,353,1.0,373
47139,Annette,2,Entire home/apt,161,288,2.0,449
47142,Stu,1,Private room,80,112,1.0,192
47143,Ramiro,2,Entire home/apt,160,309,3.0,469
47149,Sonia,1,Entire home/apt,190,23,2.0,213
47150,Jill,1,Private room,80,11,2.0,91
47152,Maiya,3,Entire home/apt,130,148,2.0,278
47155,Marc,1,Private room,85,36,1.0,121
47157,Dianne,3,Private room,75,90,3.0,165
47159,Jay,2,Shared room,37,344,4.0,381
47161,Alex,1,Entire home/apt,300,213,8.0,513
47164,Randy,2,Private room,45,188,3.0,233
47166,Leyland,4,Private room,35,59,1.0,94
47167,Gerald,2,Entire home/apt,190,210,7.0,400
47168,Kayla,1,Entire home/apt,220,10,1.0,230
47169,Eady,1,Private room,99,63,2.0,162
47170,Jahni,1,Entire home/apt,200,37,2.0,237
47171,Francoise X,4,Private room,65,364,2.0,429
47174,Karl,2,Private room,41,57,1.0,98
47175,Jason & Kelly,2,Entire home/apt,350,0,1.0,350
47180,Salome,2,Private room,90,5,1.0,95
47181,Kyle,1,Entire home/apt,196,149,1.0,345
47182,Franz,3,Entire home/apt,78,326,5.0,404
47183,Gregg,2,Private room,100,65,1.0,165
47184,Ivana,1,Entire home/apt,320,160,3.0,480
47185,Russell,1,Entire home/apt,129,186,4.0,315
47187,João,3,Private room,85,341,1.0,426
47189,Sanket,1,Entire home/apt,140,5,1.0,145
47192,Amir,5,Entire home/apt,100,201,1.0,301
47193,Chike,1,Private room,180,327,3.0,507
47195,Kenny,2,Private room,65,109,4.0,174
47197,Kimesha,2,Private room,75,349,2.0,424
47198,Negin,2,Entire home/apt,95,5,1.0,100
47199,Carlos,1,Private room,65,76,3.0,141
47203,Alex,3,Private room,90,365,1.0,455
47204,Marjorie,1,Entire home/apt,249,149,1.0,398
47211,Nusrat,3,Entire home/apt,179,321,1.0,500
47215,Jordana,2,Entire home/apt,129,21,1.0,150
47216,Noel,2,Entire home/apt,475,9,1.0,484
47217,Germania,1,Private room,35,359,1.0,394
47218,Julio,2,Private room,10,0,2.0,10
47224,Sasha,1,Entire home/apt,135,3,1.0,138
47225,David,2,Entire home/apt,199,156,1.0,355
47227,Gloria,1,Private room,140,34,1.0,174
47231,Maria,1,Private room,85,261,1.0,346
47232,K,2,Private room,111,6,2.0,117
47233,Kim,2,Entire home/apt,100,243,1.0,343
47234,Jonathan,1,Entire home/apt,265,246,2.0,511
47235,Li,1,Entire home/apt,295,141,1.0,436
47236,Mike And Narimá,1,Entire home/apt,417,219,1.0,636
47237,Carsandra,4,Private room,65,365,1.0,430
47239,Sanket,2,Private room,57,29,3.0,86
47240,Hyunje,1,Private room,75,9,4.0,84
47243,Renee,2,Private room,54,330,2.0,384
47244,Hector,2,Private room,40,96,1.0,136
47246,Jennifer,2,Entire home/apt,230,274,2.0,504
47250,Steven,1,Entire home/apt,239,158,3.0,397
47251,Rafael,1,Private room,51,84,1.0,135
47252,Kathryn,3,Private room,74,160,10.0,234
47253,Angel,3,Private room,40,66,1.0,106
47254,Meya,3,Entire home/apt,120,331,1.0,451
47255,Antia,2,Entire home/apt,200,344,1.0,544
47257,Antina,1,Entire home/apt,200,270,1.0,470
47259,Max,1,Entire home/apt,450,337,1.0,787
47264,Maria,3,Private room,55,293,2.0,348
47265,Alex,1,Private room,210,7,3.0,217
47266,Anna Laura,1,Private room,65,17,1.0,82
47271,Nadiel,1,Entire home/apt,225,225,1.0,450
47279,Lisa,3,Entire home/apt,150,327,3.0,477
47281,Carlos,3,Private room,100,89,1.0,189
47282,Logan,1,Entire home/apt,450,360,1.0,810
47283,Denis,1,Shared room,60,1,5.0,61
47287,Kodi,1,Entire home/apt,120,6,1.0,126
47294,Kimi,2,Private room,99,169,1.0,268
47295,Hirsh,2,Entire home/apt,100,96,1.0,196
47299,Rehana,2,Private room,75,139,2.0,214
47300,Maria,2,Entire home/apt,140,359,4.0,499
47303,Marisa,1,Entire home/apt,251,258,3.0,509
47305,Lawrence,2,Private room,100,27,1.0,127
47307,Dana,2,Entire home/apt,310,5,1.0,315
47308,Noel,2,Private room,69,170,1.0,239
47310,Temo,1,Private room,51,45,1.0,96
47311,Shira,2,Private room,80,179,1.0,259
47315,L,2,Private room,99,264,1.0,363
47318,Kenneth,1,Entire home/apt,249,359,1.0,608
47320,Catherine,1,Entire home/apt,210,354,2.0,564
47321,Ben,1,Entire home/apt,225,289,2.0,514
47322,Baboucarr,3,Private room,59,353,2.0,412
47323,Lulu,3,Private room,35,23,2.0,58
47324,Jerry,2,Entire home/apt,90,329,1.0,419
47328,Sumergida,2,Entire home/apt,200,338,1.0,538
47332,Charles,2,Private room,159,327,1.0,486
47333,Rosaline,1,Entire home/apt,279,244,2.0,523
47338,Angelica,2,Private room,70,331,2.0,401
47339,Renee,2,Private room,52,325,1.0,377
47341,John,2,Entire home/apt,118,101,3.0,219
47345,Sergii,2,Private room,79,297,1.0,376
47347,Baboucarr,3,Shared room,30,354,2.0,384
47348,Sergii,2,Private room,79,365,1.0,444
47349,Noel,2,Private room,59,160,4.0,219
47354,Idara,1,Private room,75,65,1.0,140
47356,Baboucarr,3,Shared room,30,358,1.0,388
47357,Ezequiel,1,Entire home/apt,175,49,3.0,224
47359,Emilio,1,Private room,150,58,2.0,208
47363,Jacqueline,1,Entire home/apt,160,26,1.0,186
47365,Koen,2,Entire home/apt,260,36,1.0,296
47367,Lior,1,Entire home/apt,145,277,1.0,422
47368,Emma,1,Entire home/apt,400,312,3.0,712
47369,Baboucarr,3,Shared room,30,327,2.0,357
47371,Nelson,1,Entire home/apt,250,360,3.0,610
47372,Alexander,3,Private room,48,17,2.0,65
47378,Andrew,1,Entire home/apt,315,160,2.0,475
47381,Zachary,1,Entire home/apt,199,98,6.0,297
47386,Koen,2,Entire home/apt,160,34,2.0,194
47387,Pauline,3,Private room,70,174,3.0,244
47391,A,2,Entire home/apt,1400,17,1.0,1417
47392,Harris,1,Private room,97,1,1.0,98
47397,James,1,Entire home/apt,325,163,1.0,488
47398,DuVall,3,Entire home/apt,44,330,3.0,374
47399,Baboucarr,3,Shared room,30,361,2.0,391
47400,Joe,1,Entire home/apt,750,364,1.0,1114
47403,Nikki,1,Entire home/apt,135,2,2.0,137
47405,Alex,1,Private room,270,30,3.0,300
47410,Diane,4,Private room,80,2,1.0,82
47413,Miguel,1,Entire home/apt,399,179,1.0,578
47414,Baboucarr,3,Shared room,30,345,1.0,375
47415,Baboucarr,3,Shared room,30,350,2.0,380
47417,Sammie,1,Entire home/apt,295,11,1.0,306
47418,Henry,1,Entire home/apt,449,216,1.0,665
47419,Anna/Phillip,1,Entire home/apt,249,125,5.0,374
47420,Ashley,2,Private room,48,334,1.0,382
47423,Francis,2,Entire home/apt,350,347,2.0,697
47426,Pedro,1,Entire home/apt,249,7,1.0,256
47430,Vinette,2,Private room,40,151,1.0,191
47432,Vinette,2,Private room,35,171,3.0,206
47433,John,5,Private room,50,84,4.0,134
47434,Amit,3,Private room,70,342,8.0,412
47438,Davica,2,Private room,48,348,1.0,396
47439,Yogi,3,Entire home/apt,85,52,1.0,137
47440,Ahmad,3,Entire home/apt,75,1,2.0,76
47447,Rehat,3,Private room,50,179,3.0,229
47448,Evelyn,1,Entire home/apt,175,79,2.0,254
47455,Wanderson,2,Entire home/apt,160,347,1.0,507
47461,Monika,2,Entire home/apt,140,222,3.0,362
47462,Shasha,2,Private room,55,358,1.0,413
47463,Gedalia,2,Private room,59,343,3.0,402
47464,Ruijia,3,Private room,65,26,3.0,91
47467,Grace,2,Private room,85,103,2.0,188
47469,Dmitry And Anya,2,Private room,50,364,4.0,414
47470,Dmitry And Anya,2,Private room,50,361,5.0,411
47471,Dmitry And Anya,2,Private room,58,363,2.0,421
47475,Michael,1,Entire home/apt,200,108,1.0,308
47476,The Gallery BnB,2,Private room,175,358,3.0,533
47477,Valeria,1,Private room,150,21,3.0,171
47480,Han,3,Private room,65,347,3.0,412
47482,Eduardo,1,Private room,50,11,1.0,61
47483,Allen,1,Private room,160,52,1.0,212
47486,Matanel,2,Private room,35,50,1.0,85
47490,Alex,1,Entire home/apt,140,3,1.0,143
47491,Vanessa,1,Entire home/apt,299,334,2.0,633
47492,Aditya,1,Private room,62,7,4.0,69
47493,Khady,1,Private room,45,73,1.0,118
47496,Jay,2,Private room,130,345,2.0,475
47498,Juan,1,Private room,75,24,1.0,99
47500,Fran,2,Entire home/apt,195,71,1.0,266
47501,Kate And Alex,2,Private room,60,354,4.0,414
47502,Jennifer,3,Entire home/apt,110,21,2.0,131
47504,Kate And Alex,2,Private room,50,359,5.0,409
47507,Amer,2,Entire home/apt,399,161,2.0,560
47510,Tony,2,Private room,95,67,1.0,162
47513,Yana,1,Private room,85,43,1.0,128
47515,Ana,1,Private room,105,38,1.0,143
47516,Liza,5,Entire home/apt,199,81,1.0,280
47525,Margaret,2,Entire home/apt,130,33,2.0,163
47527,Patrick,1,Private room,150,209,1.0,359
47532,Sara,1,Entire home/apt,275,12,1.0,287
47534,Alec,2,Private room,160,364,1.0,524
47538,Julie,1,Private room,61,268,1.0,329
47540,Ly,2,Private room,70,65,1.0,135
47552,Meezy,4,Private room,36,47,2.0,83
47559,Maria,3,Private room,50,82,4.0,132
47561,Alex,2,Entire home/apt,125,342,1.0,467
47562,Sharon,3,Private room,60,79,2.0,139
47564,Begum,2,Private room,40,1,1.0,41
47566,Michael,3,Shared room,110,21,1.0,131
47568,Joyce,2,Entire home/apt,225,303,1.0,528
47579,Rena,2,Private room,45,68,7.0,113
47580,Chris,2,Private room,65,188,1.0,253
47583,Roman,2,Private room,50,85,5.0,135
47584,Eli,2,Entire home/apt,210,254,1.0,464
47585,Nick,1,Entire home/apt,95,54,7.0,149
47586,Sam,1,Private room,189,8,1.0,197
47587,Tunie,1,Entire home/apt,145,84,3.0,229
47589,Roman,1,Entire home/apt,299,248,2.0,547
47590,Isabel,2,Entire home/apt,399,235,3.0,634
47592,Jim,2,Entire home/apt,75,163,3.0,238
47595,Juhyun,2,Entire home/apt,150,21,1.0,171
47596,John & Leni,3,Entire home/apt,225,277,2.0,502
47597,Javier,1,Entire home/apt,177,125,1.0,302
47599,Ramin,2,Entire home/apt,139,162,5.0,301
47600,Adriana,2,Private room,50,32,1.0,82
47603,Anthony,2,Entire home/apt,295,354,1.0,649
47605,Bobby,2,Entire home/apt,116,156,4.0,272
47606,Matan,1,Entire home/apt,155,300,2.0,455
47608,S,2,Private room,120,97,1.0,217
47614,Mike,1,Entire home/apt,295,0,1.0,295
47615,Thirsa,1,Private room,150,59,1.0,209
47618,Hue,2,Entire home/apt,115,26,1.0,141
47621,Ben,2,Private room,80,22,1.0,102
47622,Graham,1,Entire home/apt,151,8,1.0,159
47624,John,1,Entire home/apt,288,74,2.0,362
47625,Felicia,2,Entire home/apt,188,51,1.0,239
47630,Teri,1,Entire home/apt,99,264,2.0,363
47632,Pierrick,2,Private room,50,18,1.0,68
47634,Sadat,3,Entire home/apt,215,153,2.0,368
47635,Marie,3,Private room,60,326,2.0,386
47640,Janette,1,Entire home/apt,177,86,5.0,263
47642,Brandy,2,Entire home/apt,115,29,1.0,144
47645,Urmat,3,Private room,75,79,3.0,154
47646,Henry,1,Entire home/apt,125,266,1.0,391
47647,Andrea,1,Entire home/apt,115,234,1.0,349
47650,Niko,3,Entire home/apt,125,346,1.0,471
47651,Sam,2,Entire home/apt,189,24,1.0,213
47653,Sam,1,Entire home/apt,500,2,4.0,502
47667,Alex,1,Entire home/apt,323,185,5.0,508
47668,Cristina,2,Entire home/apt,300,58,1.0,358
47669,Gabriel,2,Entire home/apt,170,77,1.0,247
47673,Jan,3,Entire home/apt,350,330,2.0,680
47675,Sharon,3,Entire home/apt,129,348,3.0,477
47676,Kasper,3,Entire home/apt,175,17,1.0,192
47678,Mord,2,Entire home/apt,150,44,2.0,194
47682,Sadie,2,Entire home/apt,99,57,5.0,156
47683,Mailys,2,Private room,80,157,1.0,237
47690,Cecile,2,Entire home/apt,130,43,1.0,173
47699,Jenny,1,Entire home/apt,135,9,1.0,144
47702,Lala,2,Entire home/apt,300,24,1.0,324
47703,Carlos,1,Entire home/apt,269,122,4.0,391
47705,Torrey,2,Entire home/apt,125,325,1.0,450
47708,David,3,Private room,50,288,6.0,338
47710,Bracha,2,Entire home/apt,67,48,1.0,115
47711,Chris,1,Entire home/apt,400,336,2.0,736
47715,Andrea,2,Private room,50,310,1.0,360
47716,Pi & Leo,4,Private room,39,180,1.0,219
47717,Pi & Leo,4,Private room,39,175,1.0,214
47718,Alex,1,Entire home/apt,350,164,4.0,514
47722,Jay,2,Entire home/apt,282,342,1.0,624
47725,Alonzo,1,Private room,110,157,1.0,267
47727,R David,2,Entire home/apt,299,298,2.0,597
47731,Sharon,1,Entire home/apt,495,264,1.0,759
47732,Tanpreet,1,Entire home/apt,100,134,1.0,234
47736,Ek,2,Entire home/apt,595,57,4.0,652
47740,T. & Marnie,2,Private room,70,46,1.0,116
47746,P,1,Entire home/apt,180,291,2.0,471
47747,Michael,2,Private room,45,116,1.0,161
47749,David,3,Private room,50,283,4.0,333
47750,Natalia,2,Entire home/apt,75,32,1.0,107
47755,Aamir,1,Private room,99,256,1.0,355
47756,Anna-Kay,2,Private room,85,167,1.0,252
47759,Raphaël,2,Entire home/apt,89,266,1.0,355
47764,Natalie,1,Private room,50,26,1.0,76
47770,Tatiana,1,Entire home/apt,280,341,2.0,621
47774,Sam,1,Entire home/apt,315,249,2.0,564
47781,Val,2,Private room,35,250,2.0,285
47782,Kirk,1,Entire home/apt,229,150,1.0,379
47788,Nell,3,Entire home/apt,85,54,1.0,139
47790,Pp,4,Private room,40,179,1.0,219
47791,Michael,3,Private room,180,78,2.0,258
47792,Leslie,1,Entire home/apt,299,187,1.0,486
47796,Dean,1,Private room,80,213,1.0,293
47797,Dean,1,Private room,80,242,2.0,322
47799,Ollya,2,Shared room,115,66,1.0,181
47804,Meital,3,Entire home/apt,105,208,4.0,313
47820,Noel,2,Private room,49,7,1.0,56
47823,Nicole/Jason,2,Entire home/apt,110,360,1.0,470
47825,Jane,2,Private room,99,17,3.0,116
47827,Mimi & Elen,2,Private room,45,6,1.0,51
47828,Lalo,2,Entire home/apt,220,25,1.0,245
47831,Marcelia,2,Private room,60,361,1.0,421
47836,Michael,1,Entire home/apt,199,314,1.0,513
47838,James,4,Entire home/apt,79,169,2.0,248
47840,Aidas,1,Entire home/apt,300,349,2.0,649
47842,Alina,2,Entire home/apt,260,245,1.0,505
47843,Jo-Ann,2,Entire home/apt,185,117,1.0,302
47845,Michael,2,Entire home/apt,249,17,1.0,266
47848,Penn,3,Entire home/apt,128,176,5.0,304
47849,Mark,3,Entire home/apt,220,146,2.0,366
47851,Freddy,3,Entire home/apt,90,135,2.0,225
47853,Dianne,3,Private room,79,89,3.0,168
47854,Maggie,1,Private room,100,1,1.0,101
47855,PengYu,3,Private room,66,364,2.0,430
47858,Jessie,1,Entire home/apt,235,326,1.0,561
47861,Nuoya,1,Private room,100,1,1.0,101
47867,Rachel,2,Entire home/apt,125,9,2.0,134
47871,Angie,1,Entire home/apt,200,39,1.0,239
47878,Carlos,1,Private room,60,49,3.0,109
47883,Ari,1,Private room,95,8,1.0,103
47885,Tc,2,Private room,59,74,2.0,133
47887,Carlos,1,Private room,60,33,2.0,93
47888,Vanessa,2,Entire home/apt,150,228,3.0,378
47896,Brett,1,Private room,105,31,1.0,136
47898,Brett,1,Private room,105,31,2.0,136
47900,Zori,2,Entire home/apt,199,68,1.0,267
47905,Andres,2,Entire home/apt,100,296,1.0,396
47906,Daniel,1,Entire home/apt,150,53,1.0,203
47909,Ara,3,Private room,80,188,2.0,268
47910,Tc,2,Private room,57,16,1.0,73
47911,Tc,2,Private room,59,15,2.0,74
47924,Xueming,2,Private room,50,365,1.0,415
47927,Amanda,2,Entire home/apt,599,346,1.0,945
47933,Aaron,1,Private room,75,291,1.0,366
47937,Sonia,4,Entire home/apt,140,175,1.0,315
47944,Matias,2,Private room,50,3,3.0,53
47948,Jucimara,3,Private room,50,1,1.0,51
47950,Alexandra & William,1,Entire home/apt,800,345,1.0,1145
47952,Luz,3,Private room,45,133,1.0,178
47953,Jay,2,Shared room,40,350,3.0,390
47954,Sarah,2,Entire home/apt,150,327,1.0,477
47956,Mehek,1,Private room,70,39,2.0,109
47962,Javier,1,Entire home/apt,125,77,1.0,202
47963,Pearl,2,Entire home/apt,169,53,2.0,222
47967,Dayana,1,Private room,125,142,6.0,267
47970,Tzvetomir,2,Private room,80,42,2.0,122
47976,Sou,2,Private room,90,321,1.0,411
47978,Mario,2,Private room,56,179,1.0,235
47985,Dominique,1,Private room,48,128,1.0,176
47989,Anna,1,Private room,80,86,1.0,166
47990,Abe,2,Entire home/apt,67,49,1.0,116
47994,Danielle,1,Entire home/apt,279,346,2.0,625
47997,Annalisa,2,Private room,48,13,1.0,61
47998,Tristan,3,Entire home/apt,129,362,1.0,491
48002,Robin,1,Entire home/apt,225,76,1.0,301
48004,Sarah,2,Private room,44,40,1.0,84
48005,Aprilene,2,Private room,75,311,1.0,386
48006,Alicia,1,Entire home/apt,180,295,2.0,475
48011,Ira,2,Private room,50,7,1.0,57
48024,Sara,1,Private room,77,321,2.0,398
48025,Sherry,3,Private room,48,166,3.0,214
48028,Sherry,3,Private room,49,168,2.0,217
48029,Pp,4,Private room,40,175,1.0,215
48030,Chooyou,3,Entire home/apt,68,43,2.0,111
48031,Alex And Mila,2,Private room,75,326,7.0,401
48033,Pp,4,Private room,40,174,1.0,214
48034,Amit,3,Private room,50,359,3.0,409
48036,Anna,2,Private room,120,330,2.0,450
48039,Alex,2,Private room,75,353,2.0,428
48041,Ricardo,1,Private room,185,50,1.0,235
48045,Weronika,1,Entire home/apt,99,333,1.0,432
48049,Nikolas,2,Private room,50,15,1.0,65
48053,Paola,2,Private room,50,11,1.0,61
48055,Di,2,Entire home/apt,155,88,2.0,243
48057,Gail,1,Entire home/apt,300,28,1.0,328
48062,Josh,2,Entire home/apt,270,308,1.0,578
48068,Oza,4,Entire home/apt,60,194,2.0,254
48071,Jordania,1,Private room,90,46,1.0,136
48075,James,4,Entire home/apt,79,354,1.0,433
48083,Jack,1,Shared room,65,170,2.0,235
48088,Elias,2,Private room,50,25,1.0,75
48089,Bryan,1,Entire home/apt,165,5,1.0,170
48092,Michael,1,Shared room,70,24,3.0,94
48094,Marie,1,Private room,147,27,1.0,174
48096,Haily,2,Entire home/apt,299,178,2.0,477
48097,Kevin,1,Entire home/apt,164,163,1.0,327
48104,Farhath,1,Private room,80,2,1.0,82
48107,Alina,1,Entire home/apt,170,20,1.0,190
48118,Teufik,1,Entire home/apt,350,345,3.0,695
48121,Mohamed,1,Entire home/apt,175,307,1.0,482
48122,Noel,2,Private room,69,103,1.0,172
48126,Stavros,3,Shared room,25,86,1.0,111
48127,Danica,3,Private room,34,70,3.0,104
48136,Bryant,2,Private room,45,30,1.0,75
48138,Daniel,1,Entire home/apt,149,189,1.0,338
48146,Raiysa,4,Private room,40,68,1.0,108
48158,Neelam,1,Entire home/apt,185,7,1.0,192
48162,Reece,2,Private room,51,23,2.0,74
48164,Jennifer,1,Private room,80,68,1.0,148
48166,Yudis,1,Private room,90,179,1.0,269
48173,Joshua,2,Private room,50,27,1.0,77
48181,Elena,2,Private room,135,353,2.0,488
48186,Carla,1,Private room,200,203,1.0,403
48188,Emily,2,Private room,75,89,2.0,164
48191,Chiara,3,Entire home/apt,180,334,1.0,514
48194,Dennis,1,Entire home/apt,157,169,1.0,326
48203,Dipti,1,Entire home/apt,130,54,1.0,184
48209,Michael,1,Shared room,69,24,1.0,93
48211,Michael,1,Shared room,69,24,1.0,93
48214,Michael,1,Shared room,69,24,1.0,93
48222,Mika,2,Private room,70,7,1.0,77
48228,Diana,3,Entire home/apt,150,79,5.0,229
48230,Erwin,3,Private room,50,359,2.0,409
48235,Jenny,1,Entire home/apt,209,32,1.0,241
48244,Fernando,2,Private room,65,335,1.0,400
48251,Lawanne,2,Entire home/apt,200,357,1.0,557
48252,Asil,1,Entire home/apt,75,98,4.0,173
48267,Amit,3,Private room,55,358,2.0,413
48268,Jasson,1,Entire home/apt,199,349,3.0,548
48281,Elizabeth,3,Entire home/apt,139,171,1.0,310
48283,Saida,2,Private room,95,65,1.0,160
48284,Zoē,2,Entire home/apt,90,14,1.0,104
48290,Vlada,2,Entire home/apt,122,31,1.0,153
48293,Nikky,3,Private room,65,363,2.0,428
48299,Victorine,2,Entire home/apt,110,353,1.0,463
48308,Izzy,1,Private room,195,36,1.0,231
48309,Anthony,1,Private room,70,50,1.0,120
48328,Caritas,2,Private room,45,362,1.0,407
48331,Damion,1,Private room,59,42,1.0,101
48340,Takeshia,4,Entire home/apt,85,14,1.0,99
48344,Biagio,2,Private room,44,55,2.0,99
48351,Robert,2,Entire home/apt,200,356,2.0,556
48362,Lauren,1,Entire home/apt,120,1,1.0,121
48370,Caitlin,1,Entire home/apt,150,130,1.0,280
48373,Timothy,3,Entire home/apt,99,176,1.0,275
48380,Elizabeth,3,Entire home/apt,99,162,1.0,261
48384,Dasi,2,Private room,130,29,1.0,159
48387,Emily,2,Private room,40,16,1.0,56
48391,Melki,2,Entire home/apt,170,340,1.0,510
48392,Jason,1,Private room,138,65,1.0,203
48394,Emanuel,2,Private room,75,82,1.0,157
48401,Marouene,5,Private room,65,179,1.0,244
48404,Ryan,2,Private room,91,344,1.0,435
48409,Lana,2,Private room,50,86,1.0,136
48410,Ap,2,Private room,100,1,1.0,101
48413,Jean-Nicolas,1,Private room,220,15,1.0,235
48453,Thikshan,1,Private room,135,41,1.0,176
48454,Celine,1,Private room,120,358,1.0,478
48457,Schmid,1,Entire home/apt,170,323,1.0,493
48486,Chris,3,Entire home/apt,16,322,1.0,338
48524,Kailey,2,Entire home/apt,150,8,1.0,158
48526,Phoenix,3,Private room,45,90,1.0,135
48532,Alejandro,3,Private room,65,21,1.0,86
48534,Rehana,2,Private room,68,127,1.0,195
48576,Linda Lou,1,Private room,120,7,1.0,127
48601,Farina,1,Entire home/apt,75,181,1.0,256
48615,Prince,3,Private room,150,165,1.0,315
48634,David & Amy,1,Entire home/apt,110,15,2.0,125
48636,Friday,2,Private room,33,87,2.0,120
48701,Angela,2,Private room,45,14,2.0,59
48732,Mike,1,Entire home/apt,150,13,1.0,163
48740,Matt,2,Entire home/apt,550,230,1.0,780
48782,Rusaa,1,Private room,129,147,1.0,276
48790,H Ai,3,Private room,45,339,1.0,384
48799,Ben,5,Private room,235,87,1.0,322
48805,Blaine,4,Entire home/apt,100,40,2.0,140
48852,Christine,2,Private room,30,1,1.0,31
